X,Y,VaccinationDate,VaccineText,Dose1,Dose2,SingleDose,Dose1Cum,Dose2Cum,SingleDoseCum,PartiallyVacc,FullyVacc,PartialPercent,FullyPercent,ObjectId
-7.6926,53.28823,2021/04/17 23:00:00+00,Sun 18 Apr 2021,984,429,0,890932,376635,28,890960,376663,21.0727779047089,8.90874533528035,1
-7.6926,53.28823,2021/08/06 23:00:00+00,Sat 07 Aug 2021,6251,8196,559,3223828,2717289,224109,3447937,2941398,81.5498009230811,69.5692587583674,2
-7.6926,53.28823,2021/04/18 23:00:00+00,Mon 19 Apr 2021,6615,2173,0,897547,378808,28,897575,378836,21.2292343402836,8.96014062394306,3
-7.6926,53.28823,2021/08/07 23:00:00+00,Sun 08 Aug 2021,8546,11786,139,3232374,2729075,224248,3456622,2953323,81.7552165153663,69.8513060741994,4
-7.6926,53.28823,2021/04/19 23:00:00+00,Tue 20 Apr 2021,14913,7217,0,912460,386025,28,912488,386053,21.5819531344977,9.13083542296691,5
-7.6926,53.28823,2021/08/08 23:00:00+00,Mon 09 Aug 2021,5438,22698,583,3237812,2751773,224831,3462643,2976604,81.8976238016241,70.4019428507096,6
-7.6926,53.28823,2021/04/20 23:00:00+00,Wed 21 Apr 2021,26514,9760,0,938974,395785,28,939002,395813,22.209056072189,9.36167666426838,7
-7.6926,53.28823,2021/08/09 23:00:00+00,Tue 10 Aug 2021,9202,25663,685,3247014,2777436,225516,3472530,3002952,82.1314688172745,71.0251195951574,8
-7.6926,53.28823,2021/04/21 23:00:00+00,Thu 22 Apr 2021,31443,12077,0,970417,407862,28,970445,407890,22.9527385670908,9.64731904861242,9
-7.6926,53.28823,2021/08/10 23:00:00+00,Wed 11 Aug 2021,6905,30899,633,3253919,2808335,226149,3480068,3034484,82.3097558333534,71.7709070972802,10
-7.6926,53.28823,2021/04/22 23:00:00+00,Fri 23 Apr 2021,33407,12290,1,1003824,420152,29,1003853,420181,23.7428967832178,9.9380229109932,11
-7.6926,53.28823,2021/08/11 23:00:00+00,Thu 12 Aug 2021,6635,37974,849,3260554,2846309,226998,3487552,3073307,82.4867656540399,72.6891396291498,12
-7.6926,53.28823,2021/04/23 23:00:00+00,Sat 24 Apr 2021,23522,6926,0,1027346,427078,29,1027375,427107,24.299233635461,10.1018350459577,13
-7.6926,53.28823,2021/08/12 23:00:00+00,Fri 13 Aug 2021,10802,27910,843,3271356,2874219,227841,3499197,3102060,82.7621904752444,73.3691988720946,14
-7.6926,53.28823,2021/04/24 23:00:00+00,Sun 25 Apr 2021,9652,240,0,1036998,427318,29,1037027,427347,24.5275204859776,10.1075114699242,15
-7.6926,53.28823,2021/08/13 23:00:00+00,Sat 14 Aug 2021,18041,5642,267,3289397,2879861,228108,3517505,3107969,83.1952070168169,73.5089571605014,16
-7.6926,53.28823,2021/04/25 23:00:00+00,Mon 26 Apr 2021,15429,2938,0,1052427,430256,29,1052456,430285,24.8924435917194,10.1770003599799,17
-7.6926,53.28823,2021/08/14 23:00:00+00,Sun 15 Aug 2021,16955,3604,39,3306352,2883465,228147,3534499,3111612,83.5971451371731,73.5951205459585,18
-7.6926,53.28823,2021/04/26 23:00:00+00,Tue 27 Apr 2021,25736,7709,1,1078163,437965,30,1078193,437995,25.5011691068194,10.3593554799014,19
-7.6926,53.28823,2021/08/15 23:00:00+00,Mon 16 Aug 2021,10100,22870,350,3316452,2906335,228497,3544949,3134832,83.8443060973781,74.1443145647105,20
-7.6926,53.28823,2021/04/27 23:00:00+00,Wed 28 Apr 2021,25872,8490,1,1104035,446455,31,1104066,446486,26.1131112621671,10.5601826294804,21
-7.6926,53.28823,2021/08/16 23:00:00+00,Tue 17 Aug 2021,12770,26612,511,3329222,2932947,229008,3558230,3161955,84.1584252086204,74.7858214282167,22
-7.6926,53.28823,2021/08/17 23:00:00+00,Wed 18 Aug 2021,15139,25515,645,3344361,2958462,229653,3574014,3188115,84.5317446914793,75.4045516405575,23
-7.6926,53.28823,2021/04/28 23:00:00+00,Thu 29 Apr 2021,31528,11227,0,1135563,457682,31,1135594,457713,26.8588041572237,10.8257210122767,24
-7.6926,53.28823,2021/08/18 23:00:00+00,Thu 19 Aug 2021,11291,25453,522,3355652,2983915,230175,3585827,3214090,84.8111430094602,76.0189062760909,25
-7.6926,53.28823,2021/04/29 23:00:00+00,Fri 30 Apr 2021,35920,13436,0,1171483,471118,31,1171514,471149,27.708375610866,11.1435061473306,26
-7.6926,53.28823,2021/08/19 23:00:00+00,Fri 20 Aug 2021,14740,22020,664,3370392,3005935,230839,3601231,3236774,85.1754748210389,76.5554229479846,27
-7.6926,53.28823,2021/04/30 23:00:00+00,Sat 01 May 2021,16380,6588,0,1187863,477706,31,1187894,477737,28.0957915465748,11.2993239852091,28
-7.6926,53.28823,2021/08/20 23:00:00+00,Sat 21 Aug 2021,11802,7813,224,3382194,3013748,231063,3613257,3244811,85.4599109652901,76.7455121955604,29
-7.6926,53.28823,2021/05/01 23:00:00+00,Sun 02 May 2021,12307,859,1,1200170,478565,32,1200202,478597,28.3868974889866,11.3196645044222,30
-7.6926,53.28823,2021/08/21 23:00:00+00,Sun 22 Aug 2021,7984,12159,156,3390178,3025907,231219,3621397,3257126,85.6524363448182,77.0367837003378,31
-7.6926,53.28823,2021/08/22 23:00:00+00,Mon 23 Aug 2021,10795,15146,271,3400973,3041053,231490,3632463,3272543,85.9141667932036,77.4014229848813,32
-7.6926,53.28823,2021/05/02 23:00:00+00,Mon 03 May 2021,14099,840,1,1214269,479405,33,1214302,479438,28.7203873970143,11.3395556400712,33
-7.6926,53.28823,2021/08/23 23:00:00+00,Tue 24 Aug 2021,9639,22707,368,3410612,3063760,231858,3642470,3295618,86.1508500208372,77.947187497487,34
-7.6926,53.28823,2021/08/24 23:00:00+00,Wed 25 Aug 2021,9340,19268,305,3419952,3083028,232163,3652115,3315191,86.3789713089881,78.4101235237159,35
-7.6926,53.28823,2021/05/03 23:00:00+00,Tue 04 May 2021,26441,6687,1,1240710,486092,34,1240744,486126,29.3457874075157,11.4977386546024,36
-7.6926,53.28823,2021/08/25 23:00:00+00,Thu 26 Aug 2021,8507,19221,358,3428459,3102249,232521,3660980,3334770,86.5886442192481,78.8732014605439,37
-7.6926,53.28823,2020/12/28 00:00:00+00,Mon 28 Dec 2020,109,8,5,109,8,5,114,13,0.00269630138405407,0.000307472964848272,38
-7.6926,53.28823,2021/05/04 23:00:00+00,Wed 05 May 2021,31851,13313,61,1272561,499405,95,1272656,499500,30.1005625809186,11.8140573801317,39
-7.6926,53.28823,2020/12/29 00:00:00+00,Tue 29 Dec 2020,67,1,0,176,9,5,181,14,0.00428096974134901,0.000331124731375062,40
-7.6926,53.28823,2021/08/26 23:00:00+00,Fri 27 Aug 2021,9651,19016,424,3438110,3121265,232945,3671055,3354210,86.8269357670055,79.3329918018247,41
-7.6926,53.28823,2020/12/30 00:00:00+00,Wed 30 Dec 2020,1041,0,0,1217,9,5,1222,14,0.0289024586957375,0.000331124731375062,42
-7.6926,53.28823,2021/05/05 23:00:00+00,Thu 06 May 2021,37059,14253,119,1309620,513658,214,1309834,513872,30.9798879568516,12.1539805686547,43
-7.6926,53.28823,2021/08/27 23:00:00+00,Sat 28 Aug 2021,9876,7764,145,3447986,3129029,233090,3681076,3362119,87.0639501193705,79.5200536232851,44
-7.6926,53.28823,2020/12/31 00:00:00+00,Thu 31 Dec 2020,1020,1,0,2237,10,5,2242,15,0.0530272605530634,0.000354776497901852,45
-7.6926,53.28823,2021/05/06 23:00:00+00,Fri 07 May 2021,40326,14946,81,1349946,528604,295,1350241,528899,31.9355848868996,12.5093956642528,46
-7.6926,53.28823,2021/08/28 23:00:00+00,Sun 29 Aug 2021,8781,9121,23,3456767,3138150,233113,3689880,3371263,87.2721802718723,79.736325376406,47
-7.6926,53.28823,2021/01/01 00:00:00+00,Fri 01 Jan 2021,792,0,0,3029,10,5,3034,15,0.0717594596422812,0.000354776497901852,48
-7.6926,53.28823,2021/05/07 23:00:00+00,Sat 08 May 2021,25387,6952,2,1375333,535556,297,1375630,535853,32.5360795872483,12.6738700486801,49
-7.6926,53.28823,2021/08/29 23:00:00+00,Mon 30 Aug 2021,5016,10950,77,3461783,3149100,233190,3694973,3382290,87.3926387187933,79.997133405897,50
-7.6926,53.28823,2021/05/08 23:00:00+00,Sun 09 May 2021,19542,863,0,1394875,536419,297,1395172,536716,32.9982824087148,12.6942815231927,51
-7.6926,53.28823,2021/05/09 23:00:00+00,Mon 10 May 2021,28593,4526,154,1423468,540945,451,1423919,541396,33.6781997410605,12.8049717905381,52
-7.6926,53.28823,2021/05/10 23:00:00+00,Tue 11 May 2021,34107,14701,142,1457575,555646,593,1458168,556239,34.4882490928365,13.1560349610952,53
-7.6926,53.28823,2021/05/11 23:00:00+00,Wed 12 May 2021,31026,20799,141,1488601,576445,734,1489335,577179,35.225403700177,13.6513029521662,54
-7.6926,53.28823,2021/05/12 23:00:00+00,Thu 13 May 2021,35757,25360,132,1524358,601805,866,1525224,602671,36.0742419490569,14.2542337844671,55
-7.6926,53.28823,2021/05/13 23:00:00+00,Fri 14 May 2021,37963,27844,220,1562321,629649,1086,1563407,630735,36.9773373503494,14.917996960275,56
-7.6926,53.28823,2021/05/14 23:00:00+00,Sat 15 May 2021,28611,12335,0,1590932,641984,1086,1592018,643070,37.6540380424474,15.2097415003829,57
-7.6926,53.28823,2021/05/15 23:00:00+00,Sun 16 May 2021,23007,1106,0,1613939,643090,1086,1615025,644176,38.1981942349292,15.2359003541616,58
-7.6926,53.28823,2021/05/16 23:00:00+00,Mon 17 May 2021,35170,3851,100,1649109,646941,1186,1650295,648127,39.0323920403291,15.3293484837089,59
-7.6926,53.28823,2021/05/17 23:00:00+00,Tue 18 May 2021,38782,12351,108,1687891,659292,1294,1689185,660586,39.952209240556,15.6240258428662,60
-7.6926,53.28823,2021/05/18 23:00:00+00,Wed 19 May 2021,36756,17466,193,1724647,676758,1487,1726134,678245,40.8261183619543,16.0416923879628,61
-7.6926,53.28823,2021/05/19 23:00:00+00,Thu 20 May 2021,38801,19506,107,1763448,696264,1594,1765042,697858,41.7463612939787,16.5055744848527,62
-7.6926,53.28823,2021/05/20 23:00:00+00,Fri 21 May 2021,25569,23063,14908,1789017,719327,16502,1805519,735829,42.7037138476836,17.4036557116414,63
-7.6926,53.28823,2021/05/21 23:00:00+00,Sat 22 May 2021,16372,10137,13489,1805389,729464,29991,1835380,759455,43.4099792479401,17.9624523476034,64
-7.6926,53.28823,2021/05/22 23:00:00+00,Sun 23 May 2021,8058,5468,10189,1813447,734932,40180,1853627,775112,43.8415530317544,18.3327680561133,65
-7.6926,53.28823,2021/05/23 23:00:00+00,Mon 24 May 2021,22297,8081,8425,1835744,743013,48605,1884349,791618,44.5681826029904,18.7231641144045,66
-7.6926,53.28823,2021/05/24 23:00:00+00,Tue 25 May 2021,30046,16341,3205,1865790,759354,51810,1917600,811164,45.3546274917727,19.1854615429372,67
-7.6926,53.28823,2021/05/25 23:00:00+00,Wed 26 May 2021,19661,25274,3026,1885451,784628,54836,1940287,839464,45.891215118966,19.8548065356453,68
-7.6926,53.28823,2021/05/26 23:00:00+00,Thu 27 May 2021,16718,35827,539,1902169,820455,55375,1957544,875830,46.2993736539188,20.7149266771586,69
-7.6926,53.28823,2021/05/27 23:00:00+00,Fri 28 May 2021,26743,31690,1513,1928912,852145,56888,1985800,909033,46.9676779688998,21.5002362811476,70
-7.6926,53.28823,2021/05/28 23:00:00+00,Sat 29 May 2021,24244,7293,493,1953156,859438,57381,2010537,916819,47.552751717473,21.6843889353252,71
-7.6926,53.28823,2021/05/29 23:00:00+00,Sun 30 May 2021,24071,1600,182,1977227,861038,57563,2034790,918601,48.1263780110473,21.7265363832759,72
-7.6926,53.28823,2021/05/30 23:00:00+00,Mon 31 May 2021,22268,7198,3409,1999495,868236,60972,2060467,929208,48.7336844201557,21.9774106708256,73
-7.6926,53.28823,2021/05/31 23:00:00+00,Tue 01 Jun 2021,27156,11336,3617,2026651,879572,64589,2091240,944161,49.4615202314846,22.3310755357007,74
-7.6926,53.28823,2021/06/01 23:00:00+00,Wed 02 Jun 2021,18356,20736,3970,2045007,900308,68559,2113566,968867,49.9895695709617,22.9154160795116,75
-7.6926,53.28823,2021/06/02 23:00:00+00,Thu 03 Jun 2021,16414,30527,1951,2061421,930835,70510,2131931,1001345,50.4239342632262,23.6835781527687,76
-7.6926,53.28823,2021/06/03 23:00:00+00,Fri 04 Jun 2021,28719,23145,111,2090140,953980,70621,2160761,1024601,51.1058146921935,24.2336236351157,77
-7.6926,53.28823,2021/06/04 23:00:00+00,Sat 05 Jun 2021,20680,11341,1,2110820,965321,70622,2181442,1035943,51.5949568757341,24.5018819710625,78
-7.6926,53.28823,2021/06/05 23:00:00+00,Sun 06 Jun 2021,19733,3790,7,2130553,969111,70629,2201182,1039740,52.0618427469729,24.5916877285648,79
-7.6926,53.28823,2021/06/06 23:00:00+00,Mon 07 Jun 2021,19526,4383,0,2150079,973494,70629,2220708,1044123,52.523667140175,24.6953534212517,80
-7.6926,53.28823,2021/06/07 23:00:00+00,Tue 08 Jun 2021,26256,18319,10,2176335,991813,70639,2246974,1062452,53.1449044397677,25.1288666499212,81
-7.6926,53.28823,2021/06/08 23:00:00+00,Wed 09 Jun 2021,32573,19891,141,2208908,1011704,70780,2279688,1082484,53.9186483299251,25.6026588369859,82
-7.6926,53.28823,2021/06/09 23:00:00+00,Thu 10 Jun 2021,27402,27282,234,2236310,1038986,71014,2307324,1110000,54.5722885496595,26.253460844737,83
-7.6926,53.28823,2021/06/10 23:00:00+00,Fri 11 Jun 2021,26179,32693,0,2262489,1071679,71014,2333503,1142693,55.1914681455643,27.0267080477974,84
-7.6926,53.28823,2021/06/11 23:00:00+00,Sat 12 Jun 2021,11944,19522,75,2274433,1091201,71089,2345522,1162290,55.4757387274498,27.4902117164229,85
-7.6926,53.28823,2021/06/12 23:00:00+00,Sun 13 Jun 2021,8396,18051,807,2282829,1109252,71896,2354725,1181148,55.6934059347959,27.9362367295851,86
-7.6926,53.28823,2021/06/13 23:00:00+00,Mon 14 Jun 2021,15768,31063,9,2298597,1140315,71905,2370502,1212220,56.066559855289,28.6711444191055,87
-7.6926,53.28823,2021/06/14 23:00:00+00,Tue 15 Jun 2021,14412,41257,175,2313009,1181572,72080,2385089,1253652,56.4115681736153,29.6510844098435,88
-7.6926,53.28823,2021/06/15 23:00:00+00,Wed 16 Jun 2021,13147,48066,190,2326156,1229638,72270,2398426,1301908,56.7270117837831,30.7924240553603,89
-7.6926,53.28823,2021/06/16 23:00:00+00,Thu 17 Jun 2021,21268,42369,497,2347424,1272007,72767,2420191,1344774,57.2417924822387,31.8062806792977,90
-7.6926,53.28823,2021/06/17 23:00:00+00,Fri 18 Jun 2021,11793,49773,521,2359217,1321780,73288,2432505,1395068,57.5330403352496,32.995822624996,91
-7.6926,53.28823,2021/06/18 23:00:00+00,Sat 19 Jun 2021,6068,32587,400,2365285,1354367,73688,2438973,1428055,57.6860199611449,33.7760234474153,92
-7.6926,53.28823,2021/06/19 23:00:00+00,Sun 20 Jun 2021,8339,25996,158,2373624,1380363,73846,2447470,1454209,57.886989021323,34.3946117491569,93
-7.6926,53.28823,2021/06/20 23:00:00+00,Mon 21 Jun 2021,15211,32086,532,2388835,1412449,74378,2463213,1486827,58.2593387817543,35.1660850697278,94
-7.6926,53.28823,2021/06/21 23:00:00+00,Tue 22 Jun 2021,14878,43287,686,2403713,1455736,75064,2478777,1530800,58.6274548759772,36.2061241992103,95
-7.6926,53.28823,2021/06/22 23:00:00+00,Wed 23 Jun 2021,19794,39089,846,2423507,1494825,75910,2499417,1570735,59.1156273370902,37.1506574954577,96
-7.6926,53.28823,2021/06/23 23:00:00+00,Thu 24 Jun 2021,18781,43972,998,2442288,1538797,76908,2519196,1615705,59.5834356272236,38.2142774361674,97
-7.6926,53.28823,2021/06/24 23:00:00+00,Fri 25 Jun 2021,14923,49847,782,2457211,1588644,77690,2534901,1666334,59.9548866205268,39.4117427236523,98
-7.6926,53.28823,2021/06/25 23:00:00+00,Sat 26 Jun 2021,8798,30287,450,2466009,1618931,78140,2544149,1697071,60.1736181573666,40.1387270713862,99
-7.6926,53.28823,2021/06/26 23:00:00+00,Sun 27 Jun 2021,8565,30268,31,2474574,1649199,78171,2552745,1727370,60.3769287424308,40.8553519453814,100
-7.6926,53.28823,2021/06/27 23:00:00+00,Mon 28 Jun 2021,23990,24357,448,2498564,1673556,78619,2577183,1752175,60.9549306128125,41.4420340140785,101
-7.6926,53.28823,2021/06/28 23:00:00+00,Tue 29 Jun 2021,27853,30689,754,2526417,1704245,79373,2605790,1783618,61.6315366978444,42.1857165089803,102
-7.6926,53.28823,2021/06/29 23:00:00+00,Wed 30 Jun 2021,22251,36492,528,2548668,1740737,79901,2628569,1820638,62.1703002875582,43.0613049058021,103
-7.6926,53.28823,2021/06/30 23:00:00+00,Thu 01 Jul 2021,14580,48031,580,2563248,1788768,80481,2643729,1869249,62.5288610681043,44.2110409284359,104
-7.6926,53.28823,2021/07/01 23:00:00+00,Fri 02 Jul 2021,13337,46932,767,2576585,1835700,81248,2657833,1916948,62.8624455831982,45.3392065399973,105
-7.6926,53.28823,2021/07/02 23:00:00+00,Sat 03 Jul 2021,9094,30152,455,2585679,1865852,81703,2667382,1947555,63.0882963017625,46.0631161580827,106
-7.6926,53.28823,2021/07/03 23:00:00+00,Sun 04 Jul 2021,6277,27626,196,2591956,1893478,81899,2673855,1975377,63.2413941864904,46.7211556063911,107
-7.6926,53.28823,2021/07/04 23:00:00+00,Mon 05 Jul 2021,15229,33052,5302,2607185,1926530,87201,2694386,2013731,63.7269886050519,47.6282954597596,108
-7.6926,53.28823,2021/07/05 23:00:00+00,Tue 06 Jul 2021,12111,48061,5432,2619296,1974591,92633,2711929,2067224,64.1419115452314,48.8934994065772,109
-7.6926,53.28823,2021/07/06 23:00:00+00,Wed 07 Jul 2021,19413,43389,4988,2638709,2017980,97621,2736330,2115601,64.7190383002516,50.0377009158437,110
-7.6926,53.28823,2021/07/07 23:00:00+00,Thu 08 Jul 2021,17525,45276,5941,2656234,2063256,103562,2759796,2166818,65.2740506535693,51.2490734420463,111
-7.6926,53.28823,2021/07/08 23:00:00+00,Fri 09 Jul 2021,13278,44772,6493,2669512,2108028,110055,2779567,2218083,65.7416697295704,52.4615812530422,112
-7.6926,53.28823,2021/07/09 23:00:00+00,Sat 10 Jul 2021,8414,23564,4316,2677926,2131592,114371,2792297,2245963,66.0427567174565,53.1209925038091,113
-7.6926,53.28823,2021/07/10 23:00:00+00,Sun 11 Jul 2021,15092,15936,2128,2693018,2147528,116499,2809517,2264027,66.4500401370478,53.5482380143491,114
-7.6926,53.28823,2021/07/11 23:00:00+00,Mon 12 Jul 2021,16917,31405,6034,2709935,2178933,122533,2832468,2301466,66.9928718306042,54.4337365013455,115
-7.6926,53.28823,2021/07/12 23:00:00+00,Tue 13 Jul 2021,19883,36192,8443,2729818,2215125,130976,2860794,2346101,67.662831769242,55.4894331002688,116
-7.6926,53.28823,2021/07/13 23:00:00+00,Wed 14 Jul 2021,20579,35312,9279,2750397,2250437,140255,2890652,2390692,68.3690262141989,56.5440890214649,117
-7.6926,53.28823,2021/07/14 23:00:00+00,Thu 15 Jul 2021,23383,28448,9521,2773780,2278885,149776,2923556,2428661,69.1472639399964,57.4421229447206,118
-7.6926,53.28823,2021/07/15 23:00:00+00,Fri 16 Jul 2021,23331,27015,9112,2797111,2305900,158888,2955999,2464788,69.9145982014251,58.296590314034,119
-7.6926,53.28823,2021/07/16 23:00:00+00,Sat 17 Jul 2021,11354,19116,4629,2808465,2325016,163517,2971982,2488533,70.2926243858228,58.8582015102126,120
-7.6926,53.28823,2021/07/17 23:00:00+00,Sun 18 Jul 2021,16737,15593,1907,2825202,2340609,165424,2990626,2506033,70.7335879209482,59.2721074244314,121
-7.6926,53.28823,2021/07/18 23:00:00+00,Mon 19 Jul 2021,24658,18057,6188,2849860,2358666,171612,3021472,2530278,71.4631503112336,59.8455445038734,122
-7.6926,53.28823,2021/07/19 23:00:00+00,Tue 20 Jul 2021,30373,17752,7651,2880233,2376418,179263,3059496,2555681,72.3624850816483,60.4463703289535,123
-7.6926,53.28823,2021/07/20 23:00:00+00,Wed 21 Jul 2021,30093,19460,6828,2910326,2395878,186091,3096417,2581969,73.2357319535839,61.0681279674098,124
-7.6926,53.28823,2021/07/21 23:00:00+00,Thu 22 Jul 2021,33322,15548,6873,2943648,2411426,192964,3136612,2604390,74.1864147091282,61.5984242247069,125
-7.6926,53.28823,2021/07/22 23:00:00+00,Fri 23 Jul 2021,26904,20443,5545,2970552,2431869,198509,3169061,2630378,74.953890881156,62.2130863332051,126
-7.6926,53.28823,2021/07/23 23:00:00+00,Sat 24 Jul 2021,15306,14491,2202,2985858,2446360,200711,3186569,2647071,75.3679860095071,62.6079052718368,127
-7.6926,53.28823,2021/07/24 23:00:00+00,Sun 25 Jul 2021,14625,13453,1016,3000483,2459813,201727,3202210,2661540,75.7379232897526,62.950122681713,128
-7.6926,53.28823,2021/07/25 23:00:00+00,Mon 26 Jul 2021,23669,17811,3399,3024152,2477624,205126,3229278,2682750,76.3781293060997,63.4517766497462,129
-7.6926,53.28823,2021/07/26 23:00:00+00,Tue 27 Jul 2021,25290,23440,3607,3049442,2501064,208733,3258175,2709797,77.0615944034244,64.0914859789963,130
-7.6926,53.28823,2021/07/27 23:00:00+00,Wed 28 Jul 2021,23259,24909,3225,3072701,2525973,211958,3284659,2737931,77.6879877881199,64.756904778461,131
-7.6926,53.28823,2021/07/28 23:00:00+00,Thu 29 Jul 2021,19113,27493,2920,3091814,2553466,214878,3306692,2768344,78.2091071600047,65.4762259538403,132
-7.6926,53.28823,2021/07/29 23:00:00+00,Fri 30 Jul 2021,21766,22542,2080,3113580,2576008,216958,3330538,2792966,78.7731071846025,66.0585797492629,133
-7.6926,53.28823,2021/07/30 23:00:00+00,Sat 31 Jul 2021,13624,12183,883,3127204,2588191,217841,3345045,2806032,79.1162233616067,66.3676137307019,134
-7.6926,53.28823,2021/07/31 23:00:00+00,Sun 01 Aug 2021,10977,9134,355,3138181,2597325,218196,3356377,2815521,79.3842451798882,66.5920453432746,135
-7.6926,53.28823,2021/08/01 23:00:00+00,Mon 02 Aug 2021,14872,15627,393,3153053,2612952,218589,3371642,2831541,79.7452893959197,66.9709466430338,136
-7.6926,53.28823,2021/08/02 23:00:00+00,Tue 03 Aug 2021,17187,25091,1084,3170240,2638043,219673,3389913,2857716,80.1774308221307,67.5900316318725,137
-7.6926,53.28823,2021/08/03 23:00:00+00,Wed 04 Aug 2021,21938,16928,1554,3192178,2654971,221227,3413405,2876198,80.733058121378,68.0271635808207,138
-7.6926,53.28823,2021/08/04 23:00:00+00,Thu 05 Aug 2021,13372,29702,1401,3205550,2684673,222628,3428178,2907301,81.0824656682783,68.7628044751035,139
-7.6926,53.28823,2021/08/05 23:00:00+00,Fri 06 Aug 2021,12027,24420,922,3217577,2709093,223550,3441127,2932643,81.3887323930337,69.3621875424254,140
-7.6926,53.28823,2021/01/02 00:00:00+00,Sat 02 Jan 2021,1008,0,0,4037,10,5,4042,15,0.0956004403012857,0.000354776497901852,141
-7.6926,53.28823,2021/08/30 23:00:00+00,Tue 31 Aug 2021,4007,12665,134,3465790,3161765,233324,3699114,3395089,87.4905806839807,80.2998523656733,142
-7.6926,53.28823,2021/01/03 00:00:00+00,Sun 03 Jan 2021,12,0,0,4049,10,5,4054,15,0.0958842614996071,0.000354776497901852,143
-7.6926,53.28823,2021/08/31 23:00:00+00,Wed 01 Sep 2021,4898,12362,171,3470688,3174127,233495,3704183,3407622,87.610471488505,80.5962799555536,144
-7.6926,53.28823,2021/01/04 00:00:00+00,Mon 04 Jan 2021,1169,1,0,5218,11,5,5223,16,0.123533176569425,0.000378428264428642,145
-7.6926,53.28823,2021/09/01 23:00:00+00,Thu 02 Sep 2021,4960,12228,243,3475648,3186355,233738,3709386,3420093,87.7335316297439,80.8912411359092,146
-7.6926,53.28823,2021/09/02 23:00:00+00,Fri 03 Sep 2021,4718,15881,159,3480366,3202236,233897,3714263,3436133,87.8488812950951,81.2706154709989,147
-7.6926,53.28823,2021/09/03 23:00:00+00,Sat 04 Sep 2021,4599,10497,128,3484965,3212733,234025,3718990,3446758,87.9606831954672,81.521915490346,148
-7.6926,53.28823,2021/09/04 23:00:00+00,Sun 05 Sep 2021,5290,11832,0,3490255,3224565,234025,3724280,3458590,88.0858010403939,81.801763191891,149
-7.6926,53.28823,2021/09/05 23:00:00+00,Mon 06 Sep 2021,2104,9563,68,3492359,3234128,234093,3726452,3468221,88.1371726772901,82.0295533553106,150
-7.6926,53.28823,2021/09/06 23:00:00+00,Tue 07 Sep 2021,2992,9884,134,3495351,3244012,234227,3729578,3478239,88.2111080994528,82.2664967523759,151
-7.6926,53.28823,2021/09/07 23:00:00+00,Wed 08 Sep 2021,2568,14676,178,3497919,3258688,234405,3732324,3493093,88.2760558503354,82.6178200923649,152
-7.6926,53.28823,2021/09/08 23:00:00+00,Thu 09 Sep 2021,3075,14677,134,3500994,3273365,234539,3735533,3507904,88.3519543691199,82.9681264063932,153
-7.6926,53.28823,2021/09/09 23:00:00+00,Fri 10 Sep 2021,3348,13839,107,3504342,3287204,234646,3738988,3521850,88.4336712224699,83.2979739423758,154
-7.6926,53.28823,2021/09/10 23:00:00+00,Sat 11 Sep 2021,2537,11227,57,3506879,3298431,234703,3741582,3533134,88.4950239048404,83.5648604758641,155
-7.6926,53.28823,2021/09/11 23:00:00+00,Sun 12 Sep 2021,2021,12842,0,3508900,3311273,234703,3743603,3545976,88.5428241249911,83.8685964616011,156
-7.6926,53.28823,2021/09/12 23:00:00+00,Mon 13 Sep 2021,1571,7636,46,3510471,3318909,234749,3745220,3553658,88.5810690314649,84.0502893320599,157
-7.6926,53.28823,2021/09/13 23:00:00+00,Tue 14 Sep 2021,1515,10672,79,3511986,3329581,234828,3746814,3564409,88.6187699473086,84.3045694739894,158
-7.6926,53.28823,2021/09/14 23:00:00+00,Wed 15 Sep 2021,3244,12306,131,3515230,3341887,234959,3750189,3576846,88.6985946593365,84.5987264942831,159
-7.6926,53.28823,2021/09/15 23:00:00+00,Thu 16 Sep 2021,1880,10499,109,3517110,3352386,235068,3752178,3587454,88.7456380229583,84.8496244335993,160
-7.6926,53.28823,2021/09/16 23:00:00+00,Fri 17 Sep 2021,2532,14514,89,3519642,3366900,235157,3754799,3602057,88.807629303025,85.19501118019,161
-7.6926,53.28823,2021/09/17 23:00:00+00,Sat 18 Sep 2021,2267,11165,40,3521909,3378065,235197,3757106,3613262,88.8621939284023,85.4600292241227,162
-7.6926,53.28823,2021/09/18 23:00:00+00,Sun 19 Sep 2021,1853,8455,11,3523762,3386520,235208,3758970,3621728,88.9062808212083,85.6602650795385,163
-7.6926,53.28823,2021/09/19 23:00:00+00,Mon 20 Sep 2021,946,5548,29,3524708,3392068,235237,3759945,3627305,88.9293412935719,85.7921709814584,164
-7.6926,53.28823,2021/09/20 23:00:00+00,Tue 21 Sep 2021,1436,6587,89,3526144,3398655,235326,3761470,3633981,88.9654102375252,85.9500701747913,165
-7.6926,53.28823,2021/09/21 23:00:00+00,Wed 22 Sep 2021,1881,8064,94,3528025,3406719,235420,3763445,3642139,89.0121224764156,86.1430212861168,166
-7.6926,53.28823,2021/09/22 23:00:00+00,Thu 23 Sep 2021,1678,8679,85,3529703,3415398,235505,3765208,3650903,89.0538205408024,86.3503053679576,167
-7.6926,53.28823,2021/09/23 23:00:00+00,Fri 24 Sep 2021,1895,7294,79,3531598,3422692,235584,3767182,3658276,89.1005091279263,86.5246898425597,168
-7.6926,53.28823,2021/09/24 23:00:00+00,Sat 25 Sep 2021,2401,6532,50,3533999,3429224,235634,3769633,3664858,89.1584796076834,86.680365769839,169
-7.6926,53.28823,2021/09/25 23:00:00+00,Sun 26 Sep 2021,1534,7078,0,3535533,3436302,235634,3771167,3671936,89.1947614175355,86.8477729733156,170
-7.6926,53.28823,2021/09/26 23:00:00+00,Mon 27 Sep 2021,1164,3697,45,3536697,3439999,235679,3772376,3675678,89.2233564032664,86.9362778836588,171
-7.6926,53.28823,2021/09/27 23:00:00+00,Tue 28 Sep 2021,1432,5041,89,3538129,3445040,235768,3773897,3680808,89.2593307401537,87.0576114459413,172
-7.6926,53.28823,2021/09/28 23:00:00+00,Wed 29 Sep 2021,1630,3533,72,3539759,3448573,235840,3775599,3684413,89.2995860467823,87.1428760642704,173
-7.6926,53.28823,2021/09/29 23:00:00+00,Thu 30 Sep 2021,1265,3876,77,3541024,3452449,235917,3776941,3688366,89.3313267174612,87.2363714973508,174
-7.6926,53.28823,2021/09/30 23:00:00+00,Fri 01 Oct 2021,1831,5088,37,3542855,3457537,235954,3778809,3693491,89.3755082173332,87.3575868008006,175
-7.6926,53.28823,2021/10/01 23:00:00+00,Sat 02 Oct 2021,1703,4035,39,3544558,3461572,235993,3780551,3697565,89.4167095946229,87.4539440976307,176
-7.6926,53.28823,2021/10/02 23:00:00+00,Sun 03 Oct 2021,1202,2989,8,3545760,3464561,236001,3781761,3700562,89.4453282321203,87.5248284419115,177
-7.6926,53.28823,2021/10/03 23:00:00+00,Mon 04 Oct 2021,330,1156,16,3546090,3465717,236017,3782107,3701734,89.4535117433386,87.5525483122809,178
-7.6926,53.28823,2021/10/04 23:00:00+00,Tue 05 Oct 2021,979,2747,68,3547069,3468464,236085,3783154,3704549,89.4782751428921,87.6191280350538,179
-7.6926,53.28823,2021/10/05 23:00:00+00,Wed 06 Oct 2021,972,2487,34,3548041,3470951,236119,3784160,3707070,89.5020688200181,87.6787541384679,180
-7.6926,53.28823,2021/10/06 23:00:00+00,Thu 07 Oct 2021,1198,2625,41,3549239,3473576,236160,3785399,3709736,89.5313733587448,87.7418097480283,181
-7.6926,53.28823,2021/10/07 23:00:00+00,Fri 08 Oct 2021,977,2679,42,3550216,3476255,236202,3786418,3712457,89.5554745088356,87.8061662047477,182
-7.6926,53.28823,2021/10/08 23:00:00+00,Sat 09 Oct 2021,729,2317,18,3550945,3478572,236220,3787165,3714792,89.5731423784311,87.8613930795877,183
-7.6926,53.28823,2021/10/09 23:00:00+00,Sun 10 Oct 2021,1528,3888,0,3552473,3482460,236220,3788693,3718680,89.609282277684,87.9533511478439,184
-7.6926,53.28823,2021/10/10 23:00:00+00,Mon 11 Oct 2021,322,1065,12,3552795,3483525,236232,3789027,3719757,89.617181967704,87.9788241003932,185
-7.6926,53.28823,2021/10/11 23:00:00+00,Tue 12 Oct 2021,544,1562,20,3553339,3485087,236252,3789591,3721339,89.6305215640251,88.0162411950386,186
-7.6926,53.28823,2021/10/12 23:00:00+00,Wed 13 Oct 2021,996,1974,9,3554335,3487061,236261,3790596,3723322,89.6542915893845,88.0631426480612,187
-7.6926,53.28823,2021/10/13 23:00:00+00,Thu 14 Oct 2021,695,1509,7,3555030,3488570,236268,3791298,3724838,89.6708951294863,88.0989987261159,188
-7.6926,53.28823,2021/10/14 23:00:00+00,Fri 15 Oct 2021,949,1997,5,3555979,3490567,236273,3792252,3726840,89.6934589147529,88.1463495627025,189
-7.6926,53.28823,2021/10/15 23:00:00+00,Sat 16 Oct 2021,1375,2590,11,3557354,3493157,236284,3793638,3729441,89.726240263159,88.2078678074387,190
-7.6926,53.28823,2021/10/16 23:00:00+00,Sun 17 Oct 2021,1708,2868,1,3559062,3496025,236285,3795347,3732310,89.7666611321533,88.275724725604,191
-7.6926,53.28823,2021/10/17 23:00:00+00,Mon 18 Oct 2021,667,1169,3,3559729,3497194,236288,3796017,3733482,89.7825078157262,88.3034445959734,192
-7.6926,53.28823,2021/10/18 23:00:00+00,Tue 19 Oct 2021,1321,1727,10,3561050,3498921,236298,3797348,3735219,89.8139883169734,88.3445277144305,193
-7.6926,53.28823,2021/10/19 23:00:00+00,Wed 20 Oct 2021,2237,2246,0,3563287,3501167,236298,3799585,3737465,89.8668973186938,88.3976495820496,194
-7.6926,53.28823,2021/10/20 23:00:00+00,Thu 21 Oct 2021,1740,1758,8,3565027,3502925,236306,3801333,3739231,89.9082406065827,88.4394186017359,195
-7.6926,53.28823,2021/10/21 23:00:00+00,Fri 22 Oct 2021,1477,1883,0,3566504,3504808,236306,3802810,3741114,89.9431742657427,88.4839548781059,196
-7.6926,53.28823,2021/10/22 23:00:00+00,Sat 23 Oct 2021,2006,1658,0,3568510,3506466,236306,3804816,3742772,89.9906197093955,88.5231695070073,197
-7.6926,53.28823,2021/10/23 23:00:00+00,Sun 24 Oct 2021,1942,2171,0,3570452,3508637,236306,3806758,3744943,90.0365514399905,88.574517492137,198
-7.6926,53.28823,2021/10/24 23:00:00+00,Mon 25 Oct 2021,1208,801,0,3571660,3509438,236306,3807966,3745744,90.0651227739549,88.5934625571249,199
-7.6926,53.28823,2021/10/25 23:00:00+00,Tue 26 Oct 2021,1231,1158,5,3572891,3510596,236311,3809202,3746907,90.094356357382,88.6209695615956,200
-7.6926,53.28823,2021/10/26 23:00:00+00,Wed 27 Oct 2021,1548,1380,4,3574439,3511976,236315,3810754,3748291,90.1310638990315,88.6537036064687,201
-7.6926,53.28823,2021/10/27 23:00:00+00,Thu 28 Oct 2021,2130,1637,2,3576569,3513613,236317,3812886,3749930,90.1814894652667,88.6924688518061,202
-7.6926,53.28823,2021/10/28 23:00:00+00,Fri 29 Oct 2021,2109,1308,0,3578678,3514921,236317,3814995,3751238,90.2313710408717,88.7234053624231,203
-7.6926,53.28823,2021/10/29 23:00:00+00,Sat 30 Oct 2021,1994,1418,0,3580672,3516339,236317,3816989,3752656,90.2785326633261,88.7569435673581,204
-7.6926,53.28823,2021/10/30 23:00:00+00,Sun 31 Oct 2021,1620,1310,0,3582292,3517649,236317,3818609,3753966,90.3168485250995,88.7879273815082,205
-7.6926,53.28823,2021/11/01 00:00:00+00,Mon 01 Nov 2021,243,235,0,3582535,3517884,236317,3818852,3754201,90.3225959043655,88.793485546642,206
-7.6926,53.28823,2021/11/02 00:00:00+00,Tue 02 Nov 2021,1077,1048,10,3583612,3518932,236327,3819939,3755259,90.3483053745801,88.8185091156273,207
-7.6926,53.28823,2021/11/03 00:00:00+00,Wed 03 Nov 2021,2514,1769,5,3586126,3520701,236332,3822458,3757033,90.4078841744611,88.8604673494459,208
-7.6926,53.28823,2021/11/04 00:00:00+00,Thu 04 Nov 2021,1533,1208,0,3587659,3521909,236332,3823991,3758241,90.4441423325467,88.8890386834102,209
-7.6926,53.28823,2021/11/05 00:00:00+00,Fri 05 Nov 2021,1570,990,1,3589229,3522899,236333,3825562,3759232,90.4812992577603,88.9124775840383,210
-7.6926,53.28823,2021/11/06 00:00:00+00,Sat 06 Nov 2021,1818,1308,5,3591047,3524207,236338,3827385,3760545,90.5244164281386,88.943532353488,211
-7.6926,53.28823,2021/11/07 00:00:00+00,Sun 07 Nov 2021,727,762,0,3591774,3524969,236338,3828112,3761307,90.5416112624036,88.9615549995814,212
-7.6926,53.28823,2021/11/08 00:00:00+00,Mon 08 Nov 2021,502,471,0,3592276,3525440,236338,3828614,3761778,90.5534844492,88.9726949816155,213
-7.6926,53.28823,2021/11/09 00:00:00+00,Tue 09 Nov 2021,1367,972,1,3593643,3526412,236339,3829982,3762751,90.5858400658087,88.995708150446,214
-7.6926,53.28823,2021/11/10 00:00:00+00,Wed 10 Nov 2021,1557,1260,0,3595200,3527672,236339,3831539,3764011,90.6226658662909,89.0255093762698,215
-7.6926,53.28823,2021/11/11 00:00:00+00,Thu 11 Nov 2021,1380,1025,1,3596580,3528697,236340,3832920,3765037,90.6553289558644,89.0497760887263,216
-7.6926,53.28823,2021/11/12 00:00:00+00,Fri 12 Nov 2021,1121,1034,5,3597701,3529731,236345,3834046,3766076,90.6819608449736,89.0743502741476,217
-7.6926,53.28823,2021/11/13 00:00:00+00,Sat 13 Nov 2021,1397,1313,1,3599098,3531044,236346,3835444,3767390,90.715026014578,89.1054286953638,218
-7.6926,53.28823,2021/11/14 00:00:00+00,Sun 14 Nov 2021,1643,1784,0,3600741,3532828,236346,3837087,3769174,90.7538858669815,89.1476234468476,219
-7.6926,53.28823,2021/11/15 00:00:00+00,Mon 15 Nov 2021,1232,515,0,3601973,3533343,236346,3838319,3769689,90.7830248433425,89.1598041066089,220
-7.6926,53.28823,2021/11/16 00:00:00+00,Tue 16 Nov 2021,1290,980,4,3603263,3534323,236350,3839613,3770673,90.8136302292282,89.1830774448713,221
-7.6926,53.28823,2021/11/17 00:00:00+00,Wed 17 Nov 2021,1479,1001,0,3604742,3535324,236350,3841092,3771674,90.8486111919213,89.2067528631646,222
-7.6926,53.28823,2021/11/18 00:00:00+00,Thu 18 Nov 2021,1545,2366,5,3606287,3537690,236355,3842642,3774045,90.8852714300378,89.2628312015996,223
-7.6926,53.28823,2021/11/19 00:00:00+00,Fri 19 Nov 2021,1064,1354,0,3607351,3539044,236355,3843706,3775399,90.9104369096223,89.2948556934769,224
-7.6926,53.28823,2021/11/20 00:00:00+00,Sat 20 Nov 2021,1473,2849,10,3608824,3541893,236365,3845189,3778258,90.9455124793816,89.362476093977,225
-7.6926,53.28823,2021/11/21 00:00:00+00,Sun 21 Nov 2021,1771,2739,0,3610595,3544632,236365,3846960,3780997,90.9873997579005,89.4272582824939,226
-7.6926,53.28823,2021/11/22 00:00:00+00,Mon 22 Nov 2021,621,401,2,3611216,3545033,236367,3847583,3781400,91.0021348084467,89.4367899444042,227
-7.6926,53.28823,2021/11/23 00:00:00+00,Tue 23 Nov 2021,2027,1462,5,3613243,3546495,236372,3849615,3782867,91.0501951980291,89.471487085899,228
-7.6926,53.28823,2021/01/05 00:00:00+00,Tue 05 Jan 2021,3490,3,0,8708,14,5,8713,19,0.206077841747922,0.000449383564009012,229
-7.6926,53.28823,2021/01/06 00:00:00+00,Wed 06 Jan 2021,6733,2,0,15441,16,5,15446,21,0.3653251857728,0.000496687097062593,230
-7.6926,53.28823,2021/01/07 00:00:00+00,Thu 07 Jan 2021,11693,1,0,27134,17,5,27139,22,0.641885291770557,0.000520338863589383,231
-7.6926,53.28823,2021/01/08 00:00:00+00,Fri 08 Jan 2021,12649,1,0,39783,18,5,39788,23,0.941056486567925,0.000543990630116173,232
-7.6926,53.28823,2021/01/09 00:00:00+00,Sat 09 Jan 2021,8051,0,0,47834,18,5,47839,23,1.13147685887511,0.000543990630116173,233
-7.6926,53.28823,2021/01/10 00:00:00+00,Sun 10 Jan 2021,4751,1,1,52585,19,6,52591,25,1.24387005341042,0.000591294163169753,234
-7.6926,53.28823,2021/01/11 00:00:00+00,Mon 11 Jan 2021,8310,3,0,60895,22,6,60901,28,1.44041623324805,0.000662249462750123,235
-7.6926,53.28823,2021/01/12 00:00:00+00,Tue 12 Jan 2021,8829,4,0,69724,26,6,69730,32,1.64923767991308,0.000756856528857284,236
-7.6926,53.28823,2021/01/13 00:00:00+00,Wed 13 Jan 2021,9828,2,0,79552,28,6,79558,34,1.88168724133837,0.000804160061910864,237
-7.6926,53.28823,2021/01/14 00:00:00+00,Thu 14 Jan 2021,8031,1,0,87583,29,6,87589,35,2.07163457831502,0.000827811828437654,238
-7.6926,53.28823,2021/01/15 00:00:00+00,Fri 15 Jan 2021,7624,2,0,95207,31,6,95213,37,2.25195564631527,0.000875115361491235,239
-7.6926,53.28823,2021/01/16 00:00:00+00,Sat 16 Jan 2021,5197,1,0,100404,32,6,100410,38,2.374873876955,0.000898767128018024,240
-7.6926,53.28823,2021/01/17 00:00:00+00,Sun 17 Jan 2021,1092,3,0,101496,35,6,101502,41,2.40070160600225,0.000969722427598395,241
-7.6926,53.28823,2021/01/18 00:00:00+00,Mon 18 Jan 2021,8656,3,0,110152,38,6,110158,44,2.60543129705815,0.00104067772717877,242
-7.6926,53.28823,2021/01/19 00:00:00+00,Tue 19 Jan 2021,8338,14,0,118490,52,6,118496,58,2.80263972635852,0.00137180245855383,243
-7.6926,53.28823,2021/01/20 00:00:00+00,Wed 20 Jan 2021,8400,953,0,126890,1005,6,126896,1011,3.00131456518356,0.0239119359585848,244
-7.6926,53.28823,2021/01/21 00:00:00+00,Thu 21 Jan 2021,8923,955,0,135813,1960,6,135819,1966,3.21235927790211,0.0464993729916694,245
-7.6926,53.28823,2021/01/22 00:00:00+00,Fri 22 Jan 2021,6707,961,0,142520,2921,6,142526,2927,3.37099167599729,0.0692287206239147,246
-7.6926,53.28823,2021/01/23 00:00:00+00,Sat 23 Jan 2021,4144,456,0,146664,3377,6,146670,3383,3.46900459648431,0.080013926160131,247
-7.6926,53.28823,2021/01/24 00:00:00+00,Sun 24 Jan 2021,1158,393,0,147822,3770,6,147828,3776,3.49639334212233,0.0893090704051595,248
-7.6926,53.28823,2021/01/25 00:00:00+00,Mon 25 Jan 2021,1317,1279,0,149139,5049,6,149145,5055,3.52754271863811,0.119559679792924,249
-7.6926,53.28823,2021/01/26 00:00:00+00,Tue 26 Jan 2021,971,3491,0,150110,8540,6,150116,8546,3.55050858393563,0.202127996737948,250
-7.6926,53.28823,2021/01/27 00:00:00+00,Wed 27 Jan 2021,2126,6688,0,152236,15228,6,152242,15234,3.60079223957158,0.360311011269121,251
-7.6926,53.28823,2021/01/28 00:00:00+00,Thu 28 Jan 2021,937,11536,0,153173,26764,6,153179,26770,3.62295394480718,0.633157789922172,252
-7.6926,53.28823,2021/01/29 00:00:00+00,Fri 29 Jan 2021,1523,11516,0,154696,38280,6,154702,38286,3.65897558522749,0.905531533244686,253
-7.6926,53.28823,2021/01/30 00:00:00+00,Sat 30 Jan 2021,590,7787,0,155286,46067,6,155292,46073,3.67293012747829,1.0897078391888,254
-7.6926,53.28823,2021/01/31 00:00:00+00,Sun 31 Jan 2021,195,4078,0,155481,50145,6,155487,50151,3.67754222195102,1.18615974308505,255
-7.6926,53.28823,2021/02/01 00:00:00+00,Mon 01 Feb 2021,966,8320,0,156447,58465,6,156453,58471,3.70038982841589,1.38294244058795,256
-7.6926,53.28823,2021/02/02 00:00:00+00,Tue 02 Feb 2021,774,5085,0,157221,63550,6,157227,63556,3.71869629570763,1.50321167337667,257
-7.6926,53.28823,2021/02/03 00:00:00+00,Wed 03 Feb 2021,1346,6848,0,158567,70398,6,158573,70404,3.75053157345269,1.66517897055213,258
-7.6926,53.28823,2021/02/04 00:00:00+00,Thu 04 Feb 2021,1370,10522,0,159937,80920,6,159943,80926,3.78293449359439,1.91404285794702,259
-7.6926,53.28823,2021/02/05 00:00:00+00,Fri 05 Feb 2021,3343,8591,0,163280,89511,6,163286,89517,3.86200234909345,2.11723518417867,260
-7.6926,53.28823,2021/02/06 00:00:00+00,Sat 06 Feb 2021,860,3858,0,164140,93369,6,164146,93375,3.88234286830649,2.20848369943903,261
-7.6926,53.28823,2021/02/07 00:00:00+00,Sun 07 Feb 2021,297,1289,0,164437,94658,6,164443,94664,3.88936744296495,2.23897082649206,262
-7.6926,53.28823,2021/02/08 00:00:00+00,Mon 08 Feb 2021,1113,869,0,165550,95527,6,165556,95533,3.91569185910927,2.25952421160384,263
-7.6926,53.28823,2021/02/09 00:00:00+00,Tue 09 Feb 2021,4176,520,0,169726,96047,6,169732,96053,4.01446163612514,2.27182313019777,264
-7.6926,53.28823,2021/02/10 00:00:00+00,Wed 10 Feb 2021,8775,568,0,178501,96615,6,178507,96621,4.22200588739772,2.28525733358499,265
-7.6926,53.28823,2021/02/11 00:00:00+00,Thu 11 Feb 2021,6109,421,0,184610,97036,6,184616,97042,4.36649452910989,2.29521472729277,266
-7.6926,53.28823,2021/02/12 00:00:00+00,Fri 12 Feb 2021,4347,511,0,188957,97547,6,188963,97553,4.46930875820184,2.30730077998796,267
-7.6926,53.28823,2021/02/13 00:00:00+00,Sat 13 Feb 2021,1166,1908,0,190123,99455,6,190129,99461,4.49688671797208,2.35242835052107,268
-7.6926,53.28823,2021/02/14 00:00:00+00,Sun 14 Feb 2021,2662,16,0,192785,99471,6,192791,99477,4.55984772046639,2.3528067787855,269
-7.6926,53.28823,2021/02/15 00:00:00+00,Mon 15 Feb 2021,1911,7860,0,194696,107331,6,194702,107337,4.60504624629909,2.53870966368607,270
-7.6926,53.28823,2021/02/16 00:00:00+00,Tue 16 Feb 2021,5587,8132,0,200283,115463,6,200289,115469,4.73718866588427,2.73104582908193,271
-7.6926,53.28823,2021/02/17 00:00:00+00,Wed 17 Feb 2021,9685,8445,0,209968,123908,6,209974,123914,4.96625602469623,2.93078499740067,272
-7.6926,53.28823,2021/02/18 00:00:00+00,Thu 18 Feb 2021,8410,8313,0,218378,132221,6,218384,132227,5.16516738118653,3.12740213253788,273
-7.6926,53.28823,2021/02/19 00:00:00+00,Fri 19 Feb 2021,9346,6556,0,227724,138777,6,227730,138783,5.38621679114591,3.28246311388751,274
-7.6926,53.28823,2021/02/20 00:00:00+00,Sat 20 Feb 2021,5842,3557,1,233566,142334,7,233573,142341,5.52441406296195,3.36661609918983,275
-7.6926,53.28823,2021/02/21 00:00:00+00,Sun 21 Feb 2021,1071,1014,2,234637,143348,9,234646,143357,5.54979240844519,3.39064629398105,276
-7.6926,53.28823,2021/02/22 00:00:00+00,Mon 22 Feb 2021,3892,1091,0,238529,144439,9,238538,144448,5.64184508376746,3.41645037126178,277
-7.6926,53.28823,2021/02/23 00:00:00+00,Tue 23 Feb 2021,13308,1049,0,251837,145488,9,251846,145497,5.95660279270598,3.44126107434838,278
-7.6926,53.28823,2021/02/24 00:00:00+00,Wed 24 Feb 2021,16861,2073,2,268698,147561,11,268709,147572,6.35544253164725,3.49033848989147,279
-7.6926,53.28823,2021/02/25 00:00:00+00,Thu 25 Feb 2021,17984,1726,0,286682,149287,11,286693,149298,6.78079590086504,3.53116143891671,280
-7.6926,53.28823,2021/02/26 00:00:00+00,Fri 26 Feb 2021,15998,2734,0,302680,152021,11,302691,152032,7.15917686176063,3.59582536860096,281
-7.6926,53.28823,2021/02/27 00:00:00+00,Sat 27 Feb 2021,8928,696,1,311608,152717,12,311620,152729,7.37036348507834,3.61231064987013,282
-7.6926,53.28823,2021/02/28 00:00:00+00,Sun 28 Feb 2021,2410,43,1,314018,152760,13,314031,152773,7.42738789417443,3.61335132759731,283
-7.6926,53.28823,2021/03/01 00:00:00+00,Mon 01 Mar 2021,5515,776,0,319533,153536,13,319546,153549,7.55782738656968,3.6317050984221,284
-7.6926,53.28823,2021/03/02 00:00:00+00,Tue 02 Mar 2021,12096,1584,0,331629,155120,13,331642,155133,7.84391915447773,3.66916949660053,285
-7.6926,53.28823,2021/03/03 00:00:00+00,Wed 03 Mar 2021,12747,1469,1,344376,156589,14,344390,156603,8.14543187416125,3.70393759339491,286
-7.6926,53.28823,2021/03/04 00:00:00+00,Thu 04 Mar 2021,18620,1665,0,362996,158254,14,363010,158268,8.58582776689008,3.74331778466202,287
-7.6926,53.28823,2021/03/05 00:00:00+00,Fri 05 Mar 2021,18338,2373,0,381334,160627,14,381348,160641,9.01955386145836,3.79944342663009,288
-7.6926,53.28823,2021/03/06 00:00:00+00,Sat 06 Mar 2021,10304,118,0,391638,160745,14,391652,160759,9.2632616637504,3.80223433508025,289
-7.6926,53.28823,2021/03/07 00:00:00+00,Sun 07 Mar 2021,1470,5,0,393108,160750,14,393122,160764,9.29802976054478,3.80235259391289,290
-7.6926,53.28823,2021/03/08 00:00:00+00,Mon 08 Mar 2021,6562,1465,0,399670,162215,14,399684,162229,9.45323265249358,3.83700243187463,291
-7.6926,53.28823,2021/03/09 00:00:00+00,Tue 09 Mar 2021,13689,3073,1,413359,165288,15,413374,165303,9.77702533624534,3.90970796217799,292
-7.6926,53.28823,2021/03/10 00:00:00+00,Wed 10 Mar 2021,13605,3950,0,426964,169238,15,426979,169253,10.0988076198423,4.00313243995881,293
-7.6926,53.28823,2021/03/11 00:00:00+00,Thu 11 Mar 2021,18328,2068,0,445292,171306,15,445307,171321,10.5322971967453,4.05204429313621,294
-7.6926,53.28823,2021/03/12 00:00:00+00,Fri 12 Mar 2021,17193,1308,1,462485,172614,16,462501,172630,10.938965670407,4.08300445551978,295
-7.6926,53.28823,2021/03/13 00:00:00+00,Sat 13 Mar 2021,8188,153,0,470673,172767,16,470689,172783,11.1326263347283,4.08662317579838,296
-7.6926,53.28823,2021/03/14 00:00:00+00,Sun 14 Mar 2021,317,5,0,470990,172772,16,471006,172788,11.1401239447173,4.08674143463101,297
-7.6926,53.28823,2021/03/15 00:00:00+00,Mon 15 Mar 2021,2515,960,0,473505,173732,16,473521,173748,11.1996081375322,4.10944713049673,298
-7.6926,53.28823,2021/03/16 00:00:00+00,Tue 16 Mar 2021,8827,3783,0,482332,177515,16,482348,177531,11.4083822806642,4.19892176326758,299
-7.6926,53.28823,2021/03/17 00:00:00+00,Wed 17 Mar 2021,4792,2380,2,487124,179895,18,487142,179913,11.5217688493936,4.25526027113439,300
-7.6926,53.28823,2021/03/18 00:00:00+00,Thu 18 Mar 2021,11577,4645,1,498701,184540,19,498720,184559,11.7956090022408,4.36514637841786,301
-7.6926,53.28823,2021/03/19 00:00:00+00,Fri 19 Mar 2021,10200,6081,1,508901,190621,20,508921,190641,12.0368806725806,4.5089964224338,302
-7.6926,53.28823,2021/03/20 00:00:00+00,Sat 20 Mar 2021,5099,3089,0,514000,193710,20,514020,193730,12.1574810301007,4.58205672923505,303
-7.6926,53.28823,2021/03/21 00:00:00+00,Sun 21 Mar 2021,3532,38,0,517532,193748,20,517552,193768,12.2410190694733,4.58295549636307,304
-7.6926,53.28823,2021/03/22 00:00:00+00,Mon 22 Mar 2021,7276,2363,0,524808,196111,20,524828,196131,12.4131093227222,4.63884462066587,305
-7.6926,53.28823,2021/03/23 00:00:00+00,Tue 23 Mar 2021,12398,7347,0,537206,203458,20,537226,203478,12.7063439241213,4.8126141493382,306
-7.6926,53.28823,2021/03/24 00:00:00+00,Wed 24 Mar 2021,13476,9731,0,550682,213189,20,550702,213209,13.0250751298364,5.04276948941039,307
-7.6926,53.28823,2021/03/25 00:00:00+00,Thu 25 Mar 2021,20705,10171,0,571387,223360,20,571407,223380,13.5147849557736,5.28333160675438,308
-7.6926,53.28823,2021/03/26 00:00:00+00,Fri 26 Mar 2021,19533,9419,0,590920,232779,20,590940,232799,13.9767749113414,5.50610759567021,309
-7.6926,53.28823,2021/03/27 00:00:00+00,Sat 27 Mar 2021,11589,5289,1,602509,238068,21,602530,238089,14.2508988853869,5.63122544059693,310
-7.6926,53.28823,2021/03/28 00:00:00+00,Sun 28 Mar 2021,2402,459,0,604911,238527,21,604932,238548,14.3077104285842,5.64208160143273,311
-7.6926,53.28823,2021/03/28 23:00:00+00,Mon 29 Mar 2021,9124,3059,0,614035,241586,21,614056,241607,14.5235091463746,5.71443235523818,312
-7.6926,53.28823,2021/03/29 23:00:00+00,Tue 30 Mar 2021,13175,8600,1,627210,250186,22,627232,250208,14.8351448221316,5.9178611991351,313
-7.6926,53.28823,2021/03/30 23:00:00+00,Wed 31 Mar 2021,15624,10412,0,642834,260598,22,642856,260620,15.2046800223462,6.16412339221204,314
-7.6926,53.28823,2021/03/31 23:00:00+00,Thu 01 Apr 2021,19529,11527,0,662363,272125,22,662385,272147,15.6665753708479,6.43675730496635,315
-7.6926,53.28823,2021/04/01 23:00:00+00,Fri 02 Apr 2021,19989,13664,0,682352,285789,22,682374,285811,16.1393505319519,6.75993504278841,316
-7.6926,53.28823,2021/04/02 23:00:00+00,Sat 03 Apr 2021,7411,4581,0,689763,290370,22,689785,290392,16.3146337736819,6.86828378524764,317
-7.6926,53.28823,2021/04/03 23:00:00+00,Sun 04 Apr 2021,2927,146,0,692690,290516,22,692712,290538,16.3838624943058,6.87173694316055,318
-7.6926,53.28823,2021/04/04 23:00:00+00,Mon 05 Apr 2021,3314,564,0,696004,291080,22,696026,291102,16.4622444485756,6.88507653948166,319
-7.6926,53.28823,2021/04/05 23:00:00+00,Tue 06 Apr 2021,11820,8096,0,707824,299176,22,707846,299198,16.7418083289223,7.07656124128255,320
-7.6926,53.28823,2021/04/06 23:00:00+00,Wed 07 Apr 2021,18163,10399,0,725987,309575,22,726009,309597,17.1713953643484,7.32251596139464,321
-7.6926,53.28823,2021/04/07 23:00:00+00,Thu 08 Apr 2021,19998,10479,0,745985,320054,22,746007,320076,17.6443833913511,7.57036282282887,322
-7.6926,53.28823,2021/04/08 23:00:00+00,Fri 09 Apr 2021,20540,9076,0,766525,329130,22,766547,329152,18.1301906758114,7.78502625582602,323
-7.6926,53.28823,2021/04/09 23:00:00+00,Sat 10 Apr 2021,11008,4119,1,777533,333249,23,777556,333272,18.3905729735048,7.8824715339164,324
-7.6926,53.28823,2021/04/10 23:00:00+00,Sun 11 Apr 2021,2770,309,0,780303,333558,23,780326,333581,18.456088366784,7.88977992977317,325
-7.6926,53.28823,2021/04/11 23:00:00+00,Mon 12 Apr 2021,7642,2703,1,787945,336261,24,787969,336285,18.6368588183483,7.95373430646162,326
-7.6926,53.28823,2021/04/12 23:00:00+00,Tue 13 Apr 2021,11371,8504,0,799316,344765,24,799340,344789,18.9058030555244,8.15486892900544,327
-7.6926,53.28823,2021/04/13 23:00:00+00,Wed 14 Apr 2021,20188,6517,2,819504,351282,26,819530,351308,19.3833322217003,8.30905479499358,328
-7.6926,53.28823,2021/04/14 23:00:00+00,Thu 15 Apr 2021,26946,10701,0,846450,361983,26,846476,362009,20.0206527225312,8.56215234859676,329
-7.6926,53.28823,2021/04/15 23:00:00+00,Fri 16 Apr 2021,27802,9744,1,874252,371727,27,874279,371754,20.6782427872755,8.79263881340033,330
-7.6926,53.28823,2021/04/16 23:00:00+00,Sat 17 Apr 2021,15696,4479,1,889948,376206,28,889976,376234,21.0495045664466,8.89859872744035,331
