X,Y,VaccinationDate,VaccineText,Dose1,Dose2,SingleDose,Dose1Cum,Dose2Cum,SingleDoseCum,PartiallyVacc,FullyVacc,PartialPercent,FullyPercent,ObjectId
-7.6926,53.28823,2021/08/04 23:00:00+00,Thu 05 Aug 2021,13558,30077,1421,3244482,2715000,226522,3471004,2941522,72.3349016644511,61.3006221294529,1
-7.6926,53.28823,2021/08/05 23:00:00+00,Fri 06 Aug 2021,12238,24771,949,3256720,2739771,227471,3484191,2967242,72.6097156226744,61.8366208407219,2
-7.6926,53.28823,2021/08/06 23:00:00+00,Sat 07 Aug 2021,6350,8484,585,3263070,2748255,228056,3491126,2976311,72.7542393809423,62.0256166538051,3
-7.6926,53.28823,2021/08/07 23:00:00+00,Sun 08 Aug 2021,8636,11999,153,3271706,2760254,228209,3499915,2988463,72.9374000603103,62.2788614570454,4
-7.6926,53.28823,2021/08/08 23:00:00+00,Mon 09 Aug 2021,5572,23057,601,3277278,2783311,228810,3506088,3012121,73.0660439189675,62.7718885764545,5
-7.6926,53.28823,2021/08/09 23:00:00+00,Tue 10 Aug 2021,9386,26041,718,3286664,2809352,229528,3516192,3038880,73.2766088870337,63.3295398017597,6
-7.6926,53.28823,2021/08/10 23:00:00+00,Wed 11 Aug 2021,7041,31254,668,3293705,2840606,230196,3523901,3070802,73.4372626220715,63.9947867248207,7
-7.6926,53.28823,2021/08/11 23:00:00+00,Thu 12 Aug 2021,6795,38319,865,3300500,2878925,231061,3531561,3109986,73.5968952087092,64.8113720087385,8
-7.6926,53.28823,2021/08/12 23:00:00+00,Fri 13 Aug 2021,10954,28250,875,3311454,2907175,231936,3543390,3139111,73.8434087684138,65.4183301139372,9
-7.6926,53.28823,2021/08/13 23:00:00+00,Sat 14 Aug 2021,18154,5864,281,3329608,2913039,232217,3561825,3145256,74.2275898042708,65.5463904592229,10
-7.6926,53.28823,2021/08/14 23:00:00+00,Sun 15 Aug 2021,17007,3742,52,3346615,2916781,232269,3578884,3149050,74.5830953258703,65.6254565210641,11
-7.6926,53.28823,2021/08/15 23:00:00+00,Mon 16 Aug 2021,10208,23181,386,3356823,2939962,232655,3589478,3172617,74.8038717779381,66.1165872220158,12
-7.6926,53.28823,2021/08/16 23:00:00+00,Tue 17 Aug 2021,12886,26885,532,3369709,2966847,233187,3602896,3200034,75.0834997214766,66.6879510115517,13
-7.6926,53.28823,2021/08/17 23:00:00+00,Wed 18 Aug 2021,15251,25794,658,3384960,2992641,233845,3618805,3226486,75.4150395153171,67.2392044295334,14
-7.6926,53.28823,2021/08/18 23:00:00+00,Thu 19 Aug 2021,11381,25745,545,3396341,3018386,234390,3630731,3252776,75.6635745320587,67.7870818058655,15
-7.6926,53.28823,2021/08/19 23:00:00+00,Fri 20 Aug 2021,14870,22292,686,3411211,3040678,235076,3646287,3275754,75.9877578894655,68.265937886252,16
-7.6926,53.28823,2021/08/20 23:00:00+00,Sat 21 Aug 2021,11916,8000,246,3423127,3048678,235322,3658449,3284000,76.2412110903385,68.4377825741651,17
-7.6926,53.28823,2021/08/21 23:00:00+00,Sun 22 Aug 2021,8008,12266,162,3431135,3060944,235484,3666619,3296428,76.4114719562432,68.6967791520675,18
-7.6926,53.28823,2021/08/22 23:00:00+00,Mon 23 Aug 2021,10889,15415,293,3442024,3076359,235777,3677801,3312136,76.6445021891129,69.0241301534911,19
-7.6926,53.28823,2021/08/23 23:00:00+00,Tue 24 Aug 2021,9726,22941,384,3451750,3099300,236161,3687911,3335461,76.8551921957587,69.5102176317318,20
-7.6926,53.28823,2021/08/24 23:00:00+00,Wed 25 Aug 2021,9426,19557,318,3461176,3118857,236479,3697655,3355336,77.0582548490482,69.9244079266957,21
-7.6926,53.28823,2021/08/25 23:00:00+00,Thu 26 Aug 2021,8605,19468,370,3469781,3138325,236849,3706630,3375174,77.2452917243841,70.3378271504187,22
-7.6926,53.28823,2021/08/26 23:00:00+00,Fri 27 Aug 2021,9735,19245,432,3479516,3157570,237281,3716797,3394851,77.4571695975362,70.7478911722554,23
-7.6926,53.28823,2021/08/27 23:00:00+00,Sat 28 Aug 2021,9937,7948,155,3489453,3165518,237436,3726889,3402954,77.6674844884432,70.9167557740211,24
-7.6926,53.28823,2021/08/28 23:00:00+00,Sun 29 Aug 2021,8808,9204,30,3498261,3174722,237466,3735727,3412188,77.8516663162113,71.1091901480436,25
-7.6926,53.28823,2021/08/29 23:00:00+00,Mon 30 Aug 2021,5075,11175,85,3503336,3185897,237551,3740887,3423448,77.9591994946774,71.3438458824483,26
-7.6926,53.28823,2021/11/23 00:00:00+00,Tue 23 Nov 2021,2156,1603,8,3657067,3591607,241039,3898106,3832646,81.2356062360074,79.8714353324432,27
-7.6926,53.28823,2021/08/30 23:00:00+00,Tue 31 Aug 2021,4085,12918,146,3507421,3198815,237697,3745118,3436512,78.047372533067,71.6160965497896,28
-7.6926,53.28823,2021/08/31 23:00:00+00,Wed 01 Sep 2021,5004,12573,184,3512425,3211388,237881,3750306,3449269,78.1554892249046,71.8819494098075,29
-7.6926,53.28823,2021/11/24 00:00:00+00,Wed 24 Nov 2021,1615,3154,2,3658682,3594761,241041,3899723,3835802,81.2693041332128,79.937205625319,30
-7.6926,53.28823,2021/09/01 23:00:00+00,Thu 02 Sep 2021,5016,12392,249,3517441,3223780,238130,3755571,3461910,78.2652105785139,72.1453848572862,31
-7.6926,53.28823,2021/11/25 00:00:00+00,Thu 25 Nov 2021,982,1191,2,3659664,3595952,241043,3900707,3836995,81.2898104602691,79.9620674628984,32
-7.6926,53.28823,2021/09/02 23:00:00+00,Fri 03 Sep 2021,4790,16120,167,3522231,3239900,238297,3760528,3478197,78.3685132850365,72.4848020816423,33
-7.6926,53.28823,2021/09/03 23:00:00+00,Sat 04 Sep 2021,4634,10596,136,3526865,3250496,238433,3765298,3488929,78.4679189558278,72.7084544210412,34
-7.6926,53.28823,2021/11/26 00:00:00+00,Fri 26 Nov 2021,1279,1116,12,3660943,3597068,241055,3901998,3838123,81.3167145946489,79.9855747158655,35
-7.6926,53.28823,2021/09/04 23:00:00+00,Sun 05 Sep 2021,5310,11914,1,3532175,3262410,238434,3770609,3500844,78.5785989385475,72.9567602003868,36
-7.6926,53.28823,2021/11/27 00:00:00+00,Sat 27 Nov 2021,1200,1567,6,3662143,3598635,241061,3903204,3839696,81.3418473491509,80.018355663487,37
-7.6926,53.28823,2021/11/28 00:00:00+00,Sun 28 Nov 2021,1962,2263,1,3664105,3600898,241062,3905167,3841960,81.3827558044472,80.0655368875272,38
-7.6926,53.28823,2021/09/05 23:00:00+00,Mon 06 Sep 2021,2172,9713,76,3534347,3272123,238510,3772857,3510633,78.6254467263754,73.1607606430234,39
-7.6926,53.28823,2021/11/29 00:00:00+00,Mon 29 Nov 2021,537,1005,2,3664642,3601903,241064,3905706,3842967,81.393988436849,80.0865225291387,40
-7.6926,53.28823,2021/09/06 23:00:00+00,Tue 07 Sep 2021,3040,10047,162,3537387,3282170,238672,3776059,3520842,78.6921756483615,73.3735137862328,41
-7.6926,53.28823,2021/11/30 00:00:00+00,Tue 30 Nov 2021,1899,1656,6,3666541,3603559,241070,3907611,3844629,81.4336881858757,80.1211582156911,42
-7.6926,53.28823,2021/09/07 23:00:00+00,Wed 08 Sep 2021,2615,14828,191,3540002,3296998,238863,3778865,3535861,78.7506520240933,73.6865061907643,43
-7.6926,53.28823,2021/12/01 00:00:00+00,Wed 01 Dec 2021,1075,1392,4,3667616,3604951,241074,3908690,3846025,81.4561742904425,80.1502505252141,44
-7.6926,53.28823,2021/09/08 23:00:00+00,Thu 09 Sep 2021,3131,14842,138,3543133,3311840,239001,3782134,3550841,78.8187772102184,73.9986858445283,45
-7.6926,53.28823,2021/12/02 00:00:00+00,Thu 02 Dec 2021,1737,1418,0,3669353,3606369,241074,3910427,3847443,81.4923729592401,80.179801309529,46
-7.6926,53.28823,2021/09/09 23:00:00+00,Fri 10 Sep 2021,3398,13961,116,3546531,3325801,239117,3785648,3564918,78.8920081383444,74.2920471920607,47
-7.6926,53.28823,2021/12/03 00:00:00+00,Fri 03 Dec 2021,1016,1206,2,3670369,3607575,241076,3911445,3848651,81.5135878382476,80.2049757435575,48
-7.6926,53.28823,2021/09/10 23:00:00+00,Sat 11 Sep 2021,2567,11351,62,3549098,3337152,239179,3788277,3576331,78.9467958759776,74.5298914102455,49
-7.6926,53.28823,2021/12/04 00:00:00+00,Sat 04 Dec 2021,1204,1706,3,3671573,3609281,241079,3912652,3850360,81.5387414325128,80.2405908989836,50
-7.6926,53.28823,2021/12/05 00:00:00+00,Sun 05 Dec 2021,1349,1779,2,3672922,3611060,241081,3914003,3852141,81.5668959526887,80.277706517365,51
-7.6926,53.28823,2021/12/06 00:00:00+00,Mon 06 Dec 2021,939,1306,0,3673861,3612366,241081,3914942,3853447,81.586464490398,80.3049232481939,52
-7.6926,53.28823,2021/12/07 00:00:00+00,Tue 07 Dec 2021,487,752,2,3674348,3613118,241083,3915431,3854201,81.5966551346363,80.3206364296984,53
-7.6926,53.28823,2021/12/08 00:00:00+00,Wed 08 Dec 2021,797,1527,2,3675145,3614645,241085,3916230,3855730,81.613306105488,80.3525004277361,54
-7.6926,53.28823,2021/12/09 00:00:00+00,Thu 09 Dec 2021,787,1217,1,3675932,3615862,241086,3917018,3856948,81.6297278389436,80.3778832593973,55
-7.6926,53.28823,2021/12/10 00:00:00+00,Fri 10 Dec 2021,895,1621,1,3676827,3617483,241087,3917914,3858570,81.6484002668323,80.411685355419,56
-7.6926,53.28823,2021/12/11 00:00:00+00,Sat 11 Dec 2021,645,850,2,3677472,3618333,241089,3918561,3859422,81.6618835936671,80.4294408337239,57
-7.6926,53.28823,2021/12/12 00:00:00+00,Sun 12 Dec 2021,686,1193,0,3678158,3619526,241089,3919247,3860615,81.6761796712694,80.4543026713034,58
-7.6926,53.28823,2021/12/13 00:00:00+00,Mon 13 Dec 2021,725,1073,1,3678883,3620599,241090,3919973,3861689,81.6913093394024,80.4766845770539,59
-7.6926,53.28823,2021/12/14 00:00:00+00,Tue 14 Dec 2021,631,1205,3,3679514,3621804,241093,3920607,3862897,81.7045217493147,80.5018590110824,60
-7.6926,53.28823,2021/12/15 00:00:00+00,Wed 15 Dec 2021,791,1260,1,3680305,3623064,241094,3921399,3864158,81.7210268418235,80.5281379525641,61
-7.6926,53.28823,2021/12/16 00:00:00+00,Thu 16 Dec 2021,1048,1553,8,3681353,3624617,241102,3922455,3865719,81.7430336318352,80.5606688230264,62
-7.6926,53.28823,2021/12/17 00:00:00+00,Fri 17 Dec 2021,1199,2460,1,3682552,3627077,241103,3923655,3868180,81.7680413477575,80.6119554804305,63
-7.6926,53.28823,2021/12/18 00:00:00+00,Sat 18 Dec 2021,1252,1185,0,3683804,3628262,241103,3924907,3869365,81.7941327313698,80.6366505999038,64
-7.6926,53.28823,2021/12/19 00:00:00+00,Sun 19 Dec 2021,554,894,3,3684358,3629156,241106,3925464,3870262,81.8057404795104,80.6553438675558,65
-7.6926,53.28823,2021/12/20 00:00:00+00,Mon 20 Dec 2021,516,622,1,3684874,3629778,241107,3925981,3870885,81.8165146371203,80.6683270400722,66
-7.6926,53.28823,2021/12/21 00:00:00+00,Tue 21 Dec 2021,1406,1823,3,3686280,3631601,241110,3927390,3872711,81.8458778635658,80.7063804478007,67
-7.6926,53.28823,2021/12/22 00:00:00+00,Wed 22 Dec 2021,1169,1605,2,3687449,3633206,241112,3928561,3874318,81.8702812263534,80.7398699473734,68
-7.6926,53.28823,2021/12/23 00:00:00+00,Thu 23 Dec 2021,930,1404,0,3688379,3634610,241112,3929491,3875722,81.8896622061932,80.7691289750025,69
-7.6926,53.28823,2021/12/24 00:00:00+00,Fri 24 Dec 2021,101,165,0,3688480,3634775,241112,3929592,3875887,81.8917670222833,80.7725675359418,70
-7.6926,53.28823,2021/12/25 00:00:00+00,Sat 25 Dec 2021,1,6,0,3688481,3634781,241112,3929593,3875893,81.8917878620466,80.7726925745214,71
-7.6926,53.28823,2021/12/26 00:00:00+00,Sun 26 Dec 2021,12,13,0,3688493,3634794,241112,3929605,3875906,81.8920379392058,80.7729634914439,72
-7.6926,53.28823,2021/12/27 00:00:00+00,Mon 27 Dec 2021,392,591,0,3688885,3635385,241112,3929997,3876497,81.9002071264071,80.7852797915357,73
-7.6926,53.28823,2021/12/28 00:00:00+00,Tue 28 Dec 2021,469,752,0,3689354,3636137,241112,3930466,3877249,81.9099809753801,80.8009512935137,74
-7.6926,53.28823,2021/12/29 00:00:00+00,Wed 29 Dec 2021,1059,1315,0,3690413,3637452,241112,3931525,3878564,81.9320502846816,80.8283555822119,75
-7.6926,53.28823,2021/12/30 00:00:00+00,Thu 30 Dec 2021,1051,1205,1,3691464,3638657,241113,3932577,3879770,81.9539737156402,80.8534883367139,76
-7.6926,53.28823,2021/12/31 00:00:00+00,Fri 31 Dec 2021,714,1682,0,3692178,3640339,241113,3933291,3881452,81.968853306614,80.8885408185317,77
-7.6926,53.28823,2022/01/01 00:00:00+00,Sat 01 Jan 2022,71,101,0,3692249,3640440,241113,3933362,3881553,81.9703329298061,80.8906456346218,78
-7.6926,53.28823,2022/01/02 00:00:00+00,Sun 02 Jan 2022,271,629,0,3692520,3641069,241113,3933633,3882182,81.9759805056518,80.9037538457178,79
-7.6926,53.28823,2022/01/03 00:00:00+00,Mon 03 Jan 2022,3633,729,1,3696153,3641798,241114,3937267,3882912,82.05171220537,80.9189668729039,80
-7.6926,53.28823,2022/01/04 00:00:00+00,Tue 04 Jan 2022,1190,790,1,3697343,3642588,241115,3938458,3883703,82.076532363423,80.9354511256494,81
-7.6926,53.28823,2022/01/05 00:00:00+00,Wed 05 Jan 2022,2139,916,0,3699482,3643504,241115,3940597,3884619,82.1211086170545,80.9545403488034,82
-7.6926,53.28823,2022/01/06 00:00:00+00,Thu 06 Jan 2022,2454,1699,1,3701936,3645203,241116,3943052,3886319,82.172270235879,80.9899679463601,83
-7.6926,53.28823,2022/01/07 00:00:00+00,Fri 07 Jan 2022,4854,785,2,3706790,3645988,241118,3947908,3887106,82.2734681263115,81.0063688400525,84
-7.6926,53.28823,2022/01/08 00:00:00+00,Sat 08 Jan 2022,9789,745,2,3716579,3646733,241120,3957699,3887853,82.4775102484746,81.0219361432142,85
-7.6926,53.28823,2022/01/09 00:00:00+00,Sun 09 Jan 2022,7116,667,0,3723695,3647400,241120,3964815,3888520,82.6258060038941,81.0358362653144,86
-7.6926,53.28823,2022/01/10 00:00:00+00,Mon 10 Jan 2022,6668,512,1,3730363,3647912,241121,3971484,3889033,82.7647863851326,81.0465270638712,87
-7.6926,53.28823,2022/01/11 00:00:00+00,Tue 11 Jan 2022,4779,1372,1,3735142,3649284,241122,3976264,3890406,82.8644004535566,81.075140058839,88
-7.6926,53.28823,2022/01/12 00:00:00+00,Wed 12 Jan 2022,7560,928,1,3742702,3650212,241123,3983825,3891335,83.0219699036307,81.0945001989155,89
-7.6926,53.28823,2022/01/13 00:00:00+00,Thu 13 Jan 2022,7322,818,0,3750024,3651030,241123,3991147,3892153,83.1745586502836,81.1115471252693,90
-7.6926,53.28823,2022/01/14 00:00:00+00,Fri 14 Jan 2022,10725,839,0,3760749,3651869,241123,4001872,3892992,83.3980651113396,81.1290316866517,91
-7.6926,53.28823,2022/01/15 00:00:00+00,Sat 15 Jan 2022,8363,654,2,3769112,3652523,241125,4010237,3893648,83.5723897310816,81.1427025713559,92
-7.6926,53.28823,2022/01/16 00:00:00+00,Sun 16 Jan 2022,6965,1216,1,3776077,3653739,241126,4017203,3894865,83.7175595220109,81.1680645632538,93
-7.6926,53.28823,2022/01/17 00:00:00+00,Mon 17 Jan 2022,2565,563,0,3778642,3654302,241126,4019768,3895428,83.7710135147949,81.179797349974,94
-7.6926,53.28823,2022/01/18 00:00:00+00,Tue 18 Jan 2022,4056,455,3,3782698,3654757,241129,4023827,3895886,83.8556021139022,81.1893419615511,95
-7.6926,53.28823,2022/01/19 00:00:00+00,Wed 19 Jan 2022,3487,623,0,3786185,3655380,241129,4027314,3896509,83.9282703684199,81.2023251340674,96
-7.6926,53.28823,2022/01/20 00:00:00+00,Thu 20 Jan 2022,3699,939,1,3789884,3656319,241130,4031014,3897449,84.0053774925138,81.2219145115399,97
-7.6926,53.28823,2022/01/21 00:00:00+00,Fri 21 Jan 2022,3252,977,0,3793136,3657296,241130,4034266,3898426,84.0731484026634,81.2422749602534,98
-7.6926,53.28823,2022/01/22 00:00:00+00,Sat 22 Jan 2022,4274,645,0,3797410,3657941,241130,4038540,3899071,84.1622175508735,81.2557166075616,99
-7.6926,53.28823,2022/01/23 00:00:00+00,Sun 23 Jan 2022,3094,680,0,3800504,3658621,241130,4041634,3899751,84.2266957784266,81.2698876465843,100
-7.6926,53.28823,2022/01/24 00:00:00+00,Mon 24 Jan 2022,646,469,0,3801150,3659090,241130,4042280,3900220,84.2401582654982,81.2796614955573,101
-7.6926,53.28823,2022/01/25 00:00:00+00,Tue 25 Jan 2022,692,1837,1,3801842,3660927,241131,4042973,3902058,84.2546002214433,81.317964980445,102
-7.6926,53.28823,2022/01/26 00:00:00+00,Wed 26 Jan 2022,700,898,0,3802542,3661825,241131,4043673,3902956,84.2691880557314,81.3366790878602,103
-7.6926,53.28823,2022/01/27 00:00:00+00,Thu 27 Jan 2022,1278,1178,0,3803820,3663003,241131,4044951,3904134,84.2958212731887,81.3612283289907,104
-7.6926,53.28823,2022/01/28 00:00:00+00,Fri 28 Jan 2022,1031,3095,1,3804851,3666098,241132,4045983,3907230,84.3173279088819,81.4257482360703,105
-7.6926,53.28823,2022/01/29 00:00:00+00,Sat 29 Jan 2022,2329,3446,0,3807180,3669544,241132,4048312,3910676,84.3658637175345,81.497562060294,106
-7.6926,53.28823,2022/01/30 00:00:00+00,Sun 30 Jan 2022,1639,7538,0,3808819,3677082,241132,4049951,3918214,84.4000200895318,81.6546521958129,107
-7.6926,53.28823,2022/01/31 00:00:00+00,Mon 31 Jan 2022,483,1397,0,3809302,3678479,241132,4050434,3919611,84.4100856951905,81.6837653450992,108
-7.6926,53.28823,2022/02/01 00:00:00+00,Tue 01 Feb 2022,751,3422,1,3810053,3681901,241133,4051186,3923034,84.4257571971685,81.7550998547677,109
-7.6926,53.28823,2022/02/02 00:00:00+00,Wed 02 Feb 2022,653,2998,0,3810706,3684899,241133,4051839,3926032,84.439365562583,81.817577465047,110
-7.6926,53.28823,2022/02/03 00:00:00+00,Thu 03 Feb 2022,908,2436,1,3811614,3687335,241134,4052748,3928469,84.4583089073941,81.8683639681327,111
-7.6926,53.28823,2022/02/04 00:00:00+00,Fri 04 Feb 2022,1173,6524,0,3812787,3693859,241134,4053921,3934993,84.4827539497082,82.0043225836972,112
-7.6926,53.28823,2022/02/05 00:00:00+00,Sat 05 Feb 2022,1777,5750,0,3814564,3699609,241134,4055698,3940743,84.5197862090366,82.1241512224918,113
-7.6926,53.28823,2022/02/06 00:00:00+00,Sun 06 Feb 2022,1407,7556,0,3815971,3707165,241134,4057105,3948299,84.5491077559555,82.2816164737495,114
-7.6926,53.28823,2022/02/07 00:00:00+00,Mon 07 Feb 2022,441,1352,0,3816412,3708517,241134,4057546,3949651,84.558298091557,82.3097918336887,115
-7.6926,53.28823,2022/02/08 00:00:00+00,Tue 08 Feb 2022,900,1238,0,3817312,3709755,241134,4058446,3950889,84.5770538784988,82.3355914606152,116
-7.6926,53.28823,2022/02/09 00:00:00+00,Wed 09 Feb 2022,1335,1785,0,3818647,3711540,241134,4059781,3952674,84.6048749624624,82.3727904380497,117
-7.6926,53.28823,2022/02/10 00:00:00+00,Thu 10 Feb 2022,687,2555,1,3819334,3714095,241135,4060469,3955230,84.6192127195912,82.4260568729644,118
-7.6926,53.28823,2022/02/11 00:00:00+00,Fri 11 Feb 2022,546,4927,0,3819880,3719022,241135,4061015,3960157,84.6305912303359,82.5287343865889,119
-7.6926,53.28823,2022/02/12 00:00:00+00,Sat 12 Feb 2022,1397,5463,0,3821277,3724485,241135,4062412,3965620,84.6597043796221,82.6425820133254,120
-7.6926,53.28823,2022/02/13 00:00:00+00,Sun 13 Feb 2022,1566,4706,0,3822843,3729191,241135,4063978,3970326,84.6923394489008,82.7406539392675,121
-7.6926,53.28823,2022/02/14 00:00:00+00,Mon 14 Feb 2022,175,954,0,3823018,3730145,241135,4064153,3971280,84.6959864074728,82.7605350734258,122
-7.6926,53.28823,2022/02/15 00:00:00+00,Tue 15 Feb 2022,650,817,1,3823668,3730962,241136,4064804,3972098,84.7095530933607,82.7775819997795,123
-7.6926,53.28823,2022/02/16 00:00:00+00,Wed 16 Feb 2022,798,1787,0,3824466,3732749,241136,4065602,3973885,84.726183224449,82.8148226567405,124
-7.6926,53.28823,2022/02/17 00:00:00+00,Thu 17 Feb 2022,791,1194,2,3825257,3733943,241138,4066395,3975081,84.7427091567211,82.8397470136098,125
-7.6926,53.28823,2022/02/18 00:00:00+00,Fri 18 Feb 2022,792,3295,0,3826049,3737238,241138,4067187,3978376,84.7592142492298,82.9084140335799,126
-7.6926,53.28823,2022/02/19 00:00:00+00,Sat 19 Feb 2022,980,3556,0,3827029,3740794,241138,4068167,3981932,84.7796372172331,82.9825202317632,127
-7.6926,53.28823,2022/02/20 00:00:00+00,Sun 20 Feb 2022,1365,3588,0,3828394,3744382,241138,4069532,3985520,84.8080834940947,83.057293302371,128
-7.6926,53.28823,2022/02/21 00:00:00+00,Mon 21 Feb 2022,255,996,1,3828649,3745378,241139,4069788,3986517,84.8134184734915,83.0780705463498,129
-7.6926,53.28823,2022/02/22 00:00:00+00,Tue 22 Feb 2022,475,986,1,3829124,3746364,241140,4070264,3987504,84.8233382008074,83.0986393926959,130
-7.6926,53.28823,2022/02/23 00:00:00+00,Wed 23 Feb 2022,829,1273,1,3829953,3747637,241141,4071094,3988778,84.8406352043203,83.1251892511002,131
-7.6926,53.28823,2022/02/24 00:00:00+00,Thu 24 Feb 2022,653,1237,0,3830606,3748874,241141,4071747,3990015,84.8542435697347,83.1509680382635,132
-7.6926,53.28823,2022/02/25 00:00:00+00,Fri 25 Feb 2022,693,1228,0,3831299,3750102,241141,4072440,3991243,84.8686855256799,83.1765592675574,133
-7.6926,53.28823,2022/02/26 00:00:00+00,Sat 26 Feb 2022,960,2093,0,3832259,3752195,241141,4073400,3993336,84.8886916984178,83.2201768920786,134
-7.6926,53.28823,2022/02/27 00:00:00+00,Sun 27 Feb 2022,671,1783,0,3832930,3753978,241141,4074071,3995119,84.902675179571,83.2573341899865,135
-7.6926,53.28823,2022/02/28 00:00:00+00,Mon 28 Feb 2022,81,437,0,3833011,3754415,241141,4074152,3995556,84.9043632003958,83.2664411665349,136
-7.6926,53.28823,2022/03/01 00:00:00+00,Tue 01 Mar 2022,134,937,0,3833145,3755352,241141,4074286,3996493,84.9071557286738,83.2859680247176,137
-7.6926,53.28823,2022/03/02 00:00:00+00,Wed 02 Mar 2022,207,997,2,3833352,3756349,241143,4074495,3997492,84.9115112391969,83.306786948223,138
-7.6926,53.28823,2022/03/03 00:00:00+00,Thu 03 Mar 2022,279,1278,0,3833631,3757627,241143,4074774,3998770,84.9173255331489,83.3334201656803,139
-7.6926,53.28823,2022/03/04 00:00:00+00,Fri 04 Mar 2022,735,1508,1,3834366,3759135,241144,4075510,4000279,84.9326635989146,83.3648673684526,140
-7.6926,53.28823,2022/03/05 00:00:00+00,Sat 05 Mar 2022,963,3343,0,3835329,3762478,241144,4076473,4003622,84.9527322909423,83.4345346970597,141
-7.6926,53.28823,2022/03/06 00:00:00+00,Sun 06 Mar 2022,455,1916,0,3835784,3764394,241144,4076928,4005538,84.9622143832295,83.4744636834823,142
-7.6926,53.28823,2022/03/07 00:00:00+00,Mon 07 Mar 2022,116,125,1,3835900,3764519,241145,4077045,4005664,84.9646526355319,83.4770894936542,143
-7.6926,53.28823,2022/03/08 00:00:00+00,Tue 08 Mar 2022,120,493,0,3836020,3765012,241145,4077165,4006157,84.9671534071242,83.4873634969456,144
-7.6926,53.28823,2022/03/09 00:00:00+00,Wed 09 Mar 2022,130,344,1,3836150,3765356,241146,4077296,4006502,84.9698834161124,83.4945532152733,145
-7.6926,53.28823,2022/03/10 00:00:00+00,Thu 10 Mar 2022,259,508,0,3836409,3765864,241146,4077555,4007010,84.9752809147989,83.5051398150138,146
-7.6926,53.28823,2022/03/11 00:00:00+00,Fri 11 Mar 2022,493,2183,0,3836902,3768047,241146,4078048,4009193,84.9855549180904,83.5506330182292,147
-7.6926,53.28823,2022/03/12 00:00:00+00,Sat 12 Mar 2022,473,2393,2,3837375,3770440,241148,4078523,4011588,84.995453805643,83.6005442512575,148
-7.6926,53.28823,2021/09/11 23:00:00+00,Sun 12 Sep 2021,2045,12888,1,3551143,3350040,239180,3790323,3589220,78.9894340316252,74.7984951190148,149
-7.6926,53.28823,2021/09/12 23:00:00+00,Mon 13 Sep 2021,1624,7763,52,3552767,3357803,239232,3791999,3597035,79.0243614748634,74.9613578689592,150
-7.6926,53.28823,2021/09/13 23:00:00+00,Tue 14 Sep 2021,1558,10804,82,3554325,3368607,239314,3793639,3607921,79.0585386866239,75.1882195319014,151
-7.6926,53.28823,2021/09/14 23:00:00+00,Wed 15 Sep 2021,3294,12388,138,3557619,3380995,239452,3797071,3620447,79.1300607541619,75.4492584066042,152
-7.6926,53.28823,2021/09/15 23:00:00+00,Thu 16 Sep 2021,1922,10589,116,3559541,3391584,239568,3799109,3631152,79.1725321917033,75.6723480723948,153
-7.6926,53.28823,2021/09/16 23:00:00+00,Fri 17 Sep 2021,2566,14633,95,3562107,3406217,239663,3801770,3645880,79.2279868017611,75.9792761058151,154
-7.6926,53.28823,2021/09/17 23:00:00+00,Sat 18 Sep 2021,2292,11247,48,3564399,3417464,239711,3804110,3657175,79.2767518478097,76.2146612319343,155
-7.6926,53.28823,2021/09/18 23:00:00+00,Sun 19 Sep 2021,1865,8500,16,3566264,3425964,239727,3805991,3665691,79.315951442518,76.3921326559299,156
-7.6926,53.28823,2021/09/19 23:00:00+00,Mon 20 Sep 2021,968,5649,35,3567232,3431613,239762,3806994,3671375,79.3368537250764,76.5105858703487,157
-7.6926,53.28823,2021/09/20 23:00:00+00,Tue 21 Sep 2021,1479,6693,90,3568711,3438306,239852,3808563,3678158,79.3695513136449,76.6519419845998,158
-7.6926,53.28823,2021/09/21 23:00:00+00,Wed 22 Sep 2021,1903,8174,97,3570614,3446480,239949,3810563,3686429,79.4112308401821,76.8243076665946,159
-7.6926,53.28823,2021/09/22 23:00:00+00,Thu 23 Sep 2021,1693,8744,89,3572307,3455224,240038,3812345,3695262,79.4483672983268,77.0083852955464,160
-7.6926,53.28823,2021/09/23 23:00:00+00,Fri 24 Sep 2021,1917,7410,81,3574224,3462634,240119,3814343,3702753,79.4900051453375,77.1644959621917,161
-7.6926,53.28823,2021/09/24 23:00:00+00,Sat 25 Sep 2021,2426,6618,53,3576650,3469252,240172,3816822,3709424,79.5416669184805,77.3035180229567,162
-7.6926,53.28823,2021/09/25 23:00:00+00,Sun 26 Sep 2021,1550,7102,0,3578200,3476354,240172,3818372,3716526,79.5739685515468,77.4515220216905,163
-7.6926,53.28823,2021/09/26 23:00:00+00,Mon 27 Sep 2021,1181,3845,45,3579381,3480199,240217,3819598,3720416,79.5995181013142,77.5325887008054,164
-7.6926,53.28823,2021/09/27 23:00:00+00,Tue 28 Sep 2021,1458,5163,93,3580839,3485362,240310,3821149,3725672,79.6318405741438,77.6421224965453,165
-7.6926,53.28823,2021/09/28 23:00:00+00,Wed 29 Sep 2021,1654,3639,80,3582493,3489001,240390,3822883,3729391,79.6679767236516,77.7196255761413,166
-7.6926,53.28823,2021/09/29 23:00:00+00,Thu 30 Sep 2021,1276,4002,78,3583769,3493003,240468,3824237,3733471,79.6961937631173,77.8046518102773,167
-7.6926,53.28823,2021/09/30 23:00:00+00,Fri 01 Oct 2021,1875,5210,42,3585644,3498213,240510,3826154,3738723,79.7361435893033,77.9141022469641,168
-7.6926,53.28823,2021/10/01 23:00:00+00,Sat 02 Oct 2021,1684,4112,41,3587328,3502325,240551,3827879,3742876,79.7720921809417,78.0006497838187,169
-7.6926,53.28823,2021/10/02 23:00:00+00,Sun 03 Oct 2021,1197,3025,9,3588525,3505350,240560,3829085,3745910,79.7972249354436,78.0638776255757,170
-7.6926,53.28823,2021/10/03 23:00:00+00,Mon 04 Oct 2021,350,1244,18,3588875,3506594,240578,3829453,3747172,79.8048939683265,78.0901774068207,171
-7.6926,53.28823,2021/10/04 23:00:00+00,Tue 05 Oct 2021,960,2846,70,3589835,3509440,240648,3830483,3750088,79.8263589244932,78.150946156512,172
-7.6926,53.28823,2021/10/05 23:00:00+00,Wed 06 Oct 2021,974,2586,40,3590809,3512026,240688,3831497,3752714,79.8474904444475,78.2056713748554,173
-7.6926,53.28823,2021/10/06 23:00:00+00,Thu 07 Oct 2021,1214,2724,44,3592023,3514750,240732,3832755,3755482,79.8737068666395,78.263355839583,174
-7.6926,53.28823,2021/10/07 23:00:00+00,Fri 08 Oct 2021,916,2764,48,3592939,3517514,240780,3833719,3758294,79.8937963984304,78.3219572538944,175
-7.6926,53.28823,2021/10/08 23:00:00+00,Sat 09 Oct 2021,725,2373,23,3593664,3519887,240803,3834467,3760690,79.9093845413554,78.371889326686,176
-7.6926,53.28823,2021/10/09 23:00:00+00,Sun 10 Oct 2021,1521,3930,3,3595185,3523817,240806,3835991,3764623,79.9411443405768,78.4538521156215,177
-7.6926,53.28823,2021/10/10 23:00:00+00,Mon 11 Oct 2021,335,1149,19,3595520,3524966,240825,3836345,3765791,79.9485216167738,78.4781929591193,178
-7.6926,53.28823,2021/10/11 23:00:00+00,Tue 12 Oct 2021,563,1634,21,3596083,3526600,240846,3836929,3767446,79.9606920385227,78.5126827673288,179
-7.6926,53.28823,2021/10/12 23:00:00+00,Wed 13 Oct 2021,991,2089,11,3597074,3528689,240857,3837931,3769546,79.9815734813179,78.556446270193,180
-7.6926,53.28823,2021/10/13 23:00:00+00,Thu 14 Oct 2021,655,1622,9,3597729,3530311,240866,3838595,3771177,79.9954110841282,78.5904359240841,181
-7.6926,53.28823,2021/10/14 23:00:00+00,Fri 15 Oct 2021,957,2091,10,3598686,3532402,240876,3839562,3773278,80.015563135209,78.6342202667115,182
-7.6926,53.28823,2021/10/15 23:00:00+00,Sat 16 Oct 2021,1384,2662,14,3600070,3535064,240890,3840960,3775954,80.0446971242585,78.6899874732183,183
-7.6926,53.28823,2021/10/16 23:00:00+00,Sun 17 Oct 2021,1708,2894,3,3601778,3537958,240893,3842671,3778851,80.0803539592112,78.7503602674075,184
-7.6926,53.28823,2021/10/17 23:00:00+00,Mon 18 Oct 2021,680,1268,6,3602458,3539226,240899,3843357,3780125,80.0946500368134,78.7769101258117,185
-7.6926,53.28823,2021/10/18 23:00:00+00,Tue 19 Oct 2021,1343,1817,13,3603801,3541043,240912,3844713,3781955,80.1229087558057,78.8150468925933,186
-7.6926,53.28823,2021/10/19 23:00:00+00,Wed 20 Oct 2021,2263,2351,0,3606064,3543394,240912,3846976,3784306,80.1700691400826,78.8640411760379,187
-7.6926,53.28823,2021/10/20 23:00:00+00,Thu 21 Oct 2021,1731,1865,11,3607795,3545259,240923,3848718,3786182,80.2063720076965,78.9031365719298,188
-7.6926,53.28823,2021/10/21 23:00:00+00,Fri 22 Oct 2021,1509,1945,3,3609304,3547204,240926,3850230,3788130,80.2378817297587,78.9437324307771,189
-7.6926,53.28823,2021/10/22 23:00:00+00,Sat 23 Oct 2021,2018,1716,1,3611322,3548920,240927,3852249,3789847,80.2799572117981,78.9795143043093,190
-7.6926,53.28823,2021/10/23 23:00:00+00,Sun 24 Oct 2021,1959,2192,2,3613281,3551112,240929,3854210,3792041,80.3208239875678,79.0252367449207,191
-7.6926,53.28823,2021/10/24 23:00:00+00,Mon 25 Oct 2021,1242,869,2,3614523,3551981,240931,3855454,3792912,80.346748653074,79.0433881787277,192
-7.6926,53.28823,2021/10/25 23:00:00+00,Tue 26 Oct 2021,1247,1245,6,3615770,3553226,240937,3856707,3794163,80.3728608764496,79.0694587225767,193
-7.6926,53.28823,2021/10/26 23:00:00+00,Wed 27 Oct 2021,1569,1440,6,3617339,3554666,240943,3858282,3795609,80.4056835035977,79.0995930202631,194
-7.6926,53.28823,2021/10/27 23:00:00+00,Thu 28 Oct 2021,2160,1711,5,3619499,3556377,240948,3860447,3797325,80.4508015910743,79.1353540540321,195
-7.6926,53.28823,2021/10/28 23:00:00+00,Fri 29 Oct 2021,2148,1385,3,3621647,3557762,240951,3862598,3798713,80.4956279218651,79.1642796454489,196
-7.6926,53.28823,2021/10/29 23:00:00+00,Sat 30 Oct 2021,2021,1463,1,3623668,3559225,240952,3864620,3800177,80.5377659231942,79.1947890588742,197
-7.6926,53.28823,2021/10/30 23:00:00+00,Sun 31 Oct 2021,1601,1322,0,3625269,3560547,240952,3866221,3801499,80.5711303841873,79.2223392259153,198
-7.6926,53.28823,2021/11/01 00:00:00+00,Mon 01 Nov 2021,297,306,2,3625566,3560853,240954,3866520,3801807,80.5773614734046,79.2287578730021,199
-7.6926,53.28823,2021/11/02 00:00:00+00,Tue 02 Nov 2021,1100,1101,10,3626666,3561954,240964,3867630,3802918,80.6004936106328,79.2519108499935,200
-7.6926,53.28823,2021/11/03 00:00:00+00,Wed 03 Nov 2021,2540,1889,7,3629206,3563843,240971,3870177,3804814,80.653572487678,79.2914230411508,201
-7.6926,53.28823,2021/11/04 00:00:00+00,Thu 04 Nov 2021,1538,1297,2,3630744,3565140,240973,3871717,3806113,80.6856657231117,79.3184938936368,202
-7.6926,53.28823,2021/11/05 00:00:00+00,Fri 05 Nov 2021,1629,1109,4,3632373,3566249,240977,3873350,3807226,80.7196970565293,79.3416885501547,203
-7.6926,53.28823,2021/11/06 00:00:00+00,Sat 06 Nov 2021,1824,1366,6,3634197,3567615,240983,3875180,3808598,80.7578338233109,79.3702807053593,204
-7.6926,53.28823,2021/11/07 00:00:00+00,Sun 07 Nov 2021,698,775,0,3634895,3568390,240983,3875878,3809373,80.7723799780724,79.3864315218925,205
-7.6926,53.28823,2021/11/08 00:00:00+00,Mon 08 Nov 2021,520,539,4,3635415,3568929,240987,3876402,3809916,80.7833000140252,79.3977475133474,206
-7.6926,53.28823,2021/11/09 00:00:00+00,Tue 09 Nov 2021,1375,1077,4,3636790,3570006,240991,3877781,3810997,80.8120380475726,79.4202752974407,207
-7.6926,53.28823,2021/11/10 00:00:00+00,Wed 10 Nov 2021,1604,1370,2,3638394,3571376,240993,3879387,3812369,80.845506707382,79.4488674526453,208
-7.6926,53.28823,2021/11/11 00:00:00+00,Thu 11 Nov 2021,1395,1129,2,3639789,3572505,240995,3880784,3813500,80.8746198566683,79.4724372249021,209
-7.6926,53.28823,2021/11/12 00:00:00+00,Fri 12 Nov 2021,1143,1162,6,3640932,3573667,241001,3881933,3814668,80.8985647446639,79.4967780683998,210
-7.6926,53.28823,2021/11/13 00:00:00+00,Sat 13 Nov 2021,1396,1386,0,3642328,3575053,241001,3883329,3816054,80.9276570541869,79.5256619802902,211
-7.6926,53.28823,2021/11/14 00:00:00+00,Sun 14 Nov 2021,1647,1808,1,3643975,3576861,241002,3884977,3817863,80.9620009840536,79.5633611120431,212
-7.6926,53.28823,2021/11/15 00:00:00+00,Mon 15 Nov 2021,1244,600,1,3645219,3577461,241003,3886222,3818464,80.9879464893231,79.5758858097676,213
-7.6926,53.28823,2021/11/16 00:00:00+00,Tue 16 Nov 2021,1320,1085,5,3646539,3578546,241008,3887547,3819554,81.015559175654,79.5986011517303,214
-7.6926,53.28823,2021/11/17 00:00:00+00,Wed 17 Nov 2021,1503,1126,3,3648042,3579672,241011,3889053,3820683,81.0469438591365,79.6221292444606,215
-7.6926,53.28823,2021/11/18 00:00:00+00,Thu 18 Nov 2021,1641,2519,5,3649683,3582191,241016,3890699,3823207,81.0812461094767,79.6747288069506,216
-7.6926,53.28823,2021/11/19 00:00:00+00,Fri 19 Nov 2021,1166,1566,0,3650849,3583757,241016,3891865,3824773,81.1055452734479,79.7073638762293,217
-7.6926,53.28823,2021/11/20 00:00:00+00,Sat 20 Nov 2021,1547,2952,12,3652396,3586709,241028,3893424,3827737,81.1380344643837,79.7691329345575,218
-7.6926,53.28823,2021/11/21 00:00:00+00,Sun 21 Nov 2021,1790,2772,0,3654186,3589481,241028,3895214,3830509,81.1753376406345,79.8269007583382,219
-7.6926,53.28823,2021/11/22 00:00:00+00,Mon 22 Nov 2021,725,523,3,3654911,3590004,241031,3895942,3831035,81.1905089882941,79.8378624738174,220
-7.6926,53.28823,2022/03/13 00:00:00+00,Sun 13 Mar 2022,358,1082,0,3837733,3771522,241148,4078881,4012670,85.0029144408931,83.6230928751142,221
-7.6926,53.28823,2020/12/28 00:00:00+00,Mon 28 Dec 2020,296,24,4,296,24,4,300,28,0.00625192898058755,0.000583513371521505,222
-7.6926,53.28823,2022/03/14 00:00:00+00,Mon 14 Mar 2022,109,122,0,3837842,3771644,241148,4078990,4012792,85.0051859750894,83.625635326233,223
-7.6926,53.28823,2020/12/29 00:00:00+00,Tue 29 Dec 2020,81,3,0,377,27,4,381,31,0.00793994980534619,0.00064603266132738,224
-7.6926,53.28823,2022/03/15 00:00:00+00,Tue 15 Mar 2022,222,755,1,3838064,3772399,241149,4079213,4013548,85.0098332422983,83.641390187264,225
-7.6926,53.28823,2020/12/30 00:00:00+00,Wed 30 Dec 2020,1065,2,0,1442,29,4,1446,33,0.030134297686432,0.000687712187864631,226
-7.6926,53.28823,2022/03/16 00:00:00+00,Wed 16 Mar 2022,195,798,0,3838259,3773197,241149,4079408,4014346,85.0138969961357,83.6580203183524,227
-7.6926,53.28823,2020/12/31 00:00:00+00,Thu 31 Dec 2020,1042,1,0,2484,30,4,2488,34,0.0518493310123394,0.000708551951133256,228
-7.6926,53.28823,2022/03/18 00:00:00+00,Fri 18 Mar 2022,4,7,0,3838263,3773204,241149,4079412,4014353,85.0139803551887,83.6581661966953,229
-7.6926,53.28823,2021/01/01 00:00:00+00,Fri 01 Jan 2021,823,0,0,3307,30,4,3311,34,0.069000456182418,0.000708551951133256,230
-7.6926,53.28823,2022/03/19 00:00:00+00,Sat 19 Mar 2022,743,2779,0,3839006,3775983,241149,4080155,4017132,85.0294642992973,83.7160798988188,231
-7.6926,53.28823,2021/01/02 00:00:00+00,Sat 02 Jan 2021,1021,0,0,4328,30,4,4332,34,0.0902778544796843,0.000708551951133256,232
-7.6926,53.28823,2022/03/20 00:00:00+00,Sun 20 Mar 2022,395,1402,0,3839401,3777385,241149,4080550,4018534,85.0376960057885,83.7452972469214,233
-7.6926,53.28823,2021/01/03 00:00:00+00,Sun 03 Jan 2021,25,3,1,4353,33,5,4358,38,0.0908196883246685,0.000791911004207756,234
-7.6926,53.28823,2022/03/21 00:00:00+00,Mon 21 Mar 2022,57,112,0,3839458,3777497,241149,4080607,4018646,85.0388838722948,83.7476313004075,235
-7.6926,53.28823,2021/01/04 00:00:00+00,Mon 04 Jan 2021,1198,5,0,5551,38,5,5556,43,0.115785724720481,0.000896109820550883,236
-7.6926,53.28823,2022/03/22 00:00:00+00,Tue 22 Mar 2022,141,575,0,3839599,3778072,241149,4080748,4019221,85.0418222789156,83.7596141642869,237
-7.6926,53.28823,2021/01/05 00:00:00+00,Tue 05 Jan 2021,3546,14,0,9097,52,5,9102,57,0.189683525271026,0.00118786650631163,238
-7.6926,53.28823,2022/03/23 00:00:00+00,Wed 23 Mar 2022,102,221,0,3839701,3778293,241149,4080850,4019442,85.043947934769,83.7642197519693,239
-7.6926,53.28823,2022/03/24 00:00:00+00,Thu 24 Mar 2022,147,245,0,3839848,3778538,241149,4080997,4019687,85.0470113799695,83.7693254939701,240
-7.6926,53.28823,2022/03/25 00:00:00+00,Fri 25 Mar 2022,434,1625,0,3840282,3780163,241149,4081431,4021312,85.0560558372281,83.8031901092816,241
-7.6926,53.28823,2022/03/26 00:00:00+00,Sat 26 Mar 2022,874,1848,1,3841156,3782011,241150,4082306,4023161,85.0742906300882,83.8417228315653,242
-7.6926,53.28823,2022/03/27 00:00:00+00,Sun 27 Mar 2022,380,804,0,3841536,3782815,241150,4082686,4023965,85.0822097401302,83.8584780012333,243
-7.6926,53.28823,2022/03/27 23:00:00+00,Mon 28 Mar 2022,44,53,1,3841580,3782868,241151,4082731,4024019,85.0831475294773,83.8596033484498,244
-7.6926,53.28823,2022/03/28 23:00:00+00,Tue 29 Mar 2022,138,193,3,3841718,3783061,241154,4082872,4024215,85.0860859360982,83.8636879420505,245
-7.6926,53.28823,2022/03/29 23:00:00+00,Wed 30 Mar 2022,109,138,0,3841827,3783199,241154,4082981,4024353,85.0883574702945,83.8665638293815,246
-7.6926,53.28823,2022/03/30 23:00:00+00,Thu 31 Mar 2022,227,360,0,3842054,3783559,241154,4083208,4024713,85.0930880965565,83.8740661441582,247
-7.6926,53.28823,2022/03/31 23:00:00+00,Fri 01 Apr 2022,307,905,0,3842361,3784464,241154,4083515,4025618,85.0994859038799,83.8929261299163,248
-7.6926,53.28823,2022/04/01 23:00:00+00,Sat 02 Apr 2022,729,1538,1,3843090,3786002,241155,4084245,4027157,85.114698931066,83.9249985255867,249
-7.6926,53.28823,2022/04/02 23:00:00+00,Sun 03 Apr 2022,538,817,0,3843628,3786819,241155,4084783,4027974,85.1259107237045,83.9420246121772,250
-7.6926,53.28823,2022/04/03 23:00:00+00,Mon 04 Apr 2022,50,53,0,3843678,3786872,241155,4084833,4028027,85.126952711868,83.9431291196305,251
-7.6926,53.28823,2022/04/04 23:00:00+00,Tue 05 Apr 2022,132,170,0,3843810,3787042,241155,4084965,4028197,85.1297035606194,83.9466718793861,252
-7.6926,53.28823,2022/04/05 23:00:00+00,Wed 06 Apr 2022,158,211,0,3843968,3787253,241155,4085123,4028408,85.1329962432159,83.9510690694358,253
-7.6926,53.28823,2022/04/06 23:00:00+00,Thu 07 Apr 2022,117,179,0,3844085,3787432,241155,4085240,4028587,85.1354344955183,83.9547993870609,254
-7.6926,53.28823,2022/04/07 23:00:00+00,Fri 08 Apr 2022,256,422,2,3844341,3787854,241157,4085498,4029011,85.1408111544416,83.9636354466868,255
-7.6926,53.28823,2022/04/08 23:00:00+00,Sat 09 Apr 2022,558,1018,0,3844899,3788872,241157,4086056,4030029,85.1524397423455,83.9848503256942,256
-7.6926,53.28823,2022/04/09 23:00:00+00,Sun 10 Apr 2022,413,720,0,3845312,3789592,241157,4086469,4030749,85.1610465645754,83.9998549552477,257
-7.6926,53.28823,2022/04/10 23:00:00+00,Mon 11 Apr 2022,70,93,1,3845382,3789685,241158,4086540,4030843,85.1625261877675,84.0018138929949,258
-7.6926,53.28823,2022/04/11 23:00:00+00,Tue 12 Apr 2022,196,178,0,3845578,3789863,241158,4086736,4031021,85.1666107813682,84.0055233708567,259
-7.6926,53.28823,2022/04/12 23:00:00+00,Wed 13 Apr 2022,142,235,0,3845720,3790098,241158,4086878,4031256,85.1695700277523,84.0104207152248,260
-7.6926,53.28823,2022/04/13 23:00:00+00,Thu 14 Apr 2022,359,431,0,3846079,3790529,241158,4087237,4031687,85.1770515027657,84.0194026531936,261
-7.6926,53.28823,2022/04/14 23:00:00+00,Fri 15 Apr 2022,446,990,0,3846525,3791519,241158,4087683,4032677,85.1863460371836,84.0400340188296,262
-7.6926,53.28823,2022/04/15 23:00:00+00,Sat 16 Apr 2022,43,88,0,3846568,3791607,241158,4087726,4032765,85.1872421470041,84.0418679179972,263
-7.6926,53.28823,2022/04/16 23:00:00+00,Sun 17 Apr 2022,1,1,0,3846569,3791608,241158,4087727,4032766,85.1872629867674,84.0418887577605,264
-7.6926,53.28823,2022/04/17 23:00:00+00,Mon 18 Apr 2022,36,62,1,3846605,3791670,241159,4087764,4032829,85.1880340580083,84.0432016628464,265
-7.6926,53.28823,2022/04/18 23:00:00+00,Tue 19 Apr 2022,218,271,1,3846823,3791941,241160,4087983,4033101,85.1925979661641,84.0488700784555,266
-7.6926,53.28823,2022/04/19 23:00:00+00,Wed 20 Apr 2022,251,607,0,3847074,3792548,241160,4088234,4033708,85.1978287467446,84.0615198147595,267
-7.6926,53.28823,2022/04/20 23:00:00+00,Thu 21 Apr 2022,170,236,0,3847244,3792784,241160,4088404,4033944,85.2013715065002,84.0664379988909,268
-7.6926,53.28823,2022/04/21 23:00:00+00,Fri 22 Apr 2022,195,254,0,3847439,3793038,241160,4088599,4034198,85.2054352603376,84.0717312987611,269
-7.6926,53.28823,2022/04/22 23:00:00+00,Sat 23 Apr 2022,325,1010,0,3847764,3794048,241160,4088924,4035208,85.2122081833999,84.0927794596625,270
-7.6926,53.28823,2022/04/23 23:00:00+00,Sun 24 Apr 2022,181,252,0,3847945,3794300,241160,4089105,4035460,85.2159801805515,84.0980310800061,271
-7.6926,53.28823,2022/04/24 23:00:00+00,Mon 25 Apr 2022,41,60,1,3847986,3794360,241161,4089147,4035521,85.2168554506088,84.0993023055655,272
-7.6926,53.28823,2022/04/25 23:00:00+00,Tue 26 Apr 2022,144,238,0,3848130,3794598,241161,4089291,4035759,85.2198563765195,84.1042621692235,273
-7.6926,53.28823,2022/04/26 23:00:00+00,Wed 27 Apr 2022,123,207,0,3848253,3794805,241161,4089414,4035966,85.2224196674016,84.1085760002201,274
-7.6926,53.28823,2022/04/27 23:00:00+00,Thu 28 Apr 2022,100,130,0,3848353,3794935,241161,4089514,4036096,85.2245036437284,84.111285169445,275
-7.6926,53.28823,2022/04/28 23:00:00+00,Fri 29 Apr 2022,169,222,0,3848522,3795157,241161,4089683,4036318,85.2280255637208,84.1159115968906,276
-7.6926,53.28823,2022/04/29 23:00:00+00,Sat 30 Apr 2022,281,724,0,3848803,3795881,241161,4089964,4037042,85.2338815371993,84.1309995854971,277
-7.6926,53.28823,2022/04/30 23:00:00+00,Sun 01 May 2022,187,748,0,3848990,3796629,241161,4090151,4037790,85.2377785729305,84.146587728422,278
-7.6926,53.28823,2022/05/01 23:00:00+00,Mon 02 May 2022,12,26,0,3849002,3796655,241161,4090163,4037816,85.2380286500897,84.147129562267,279
-7.6926,53.28823,2022/05/02 23:00:00+00,Tue 03 May 2022,96,118,0,3849098,3796773,241161,4090259,4037934,85.2400292673635,84.1495886543327,280
-7.6926,53.28823,2022/05/03 23:00:00+00,Wed 04 May 2022,113,129,0,3849211,3796902,241161,4090372,4038063,85.2423841606129,84.1522769837944,281
-7.6926,53.28823,2022/05/04 23:00:00+00,Thu 05 May 2022,112,165,0,3849323,3797067,241161,4090484,4038228,85.244718214099,84.1557155447337,282
-7.6926,53.28823,2022/05/05 23:00:00+00,Fri 06 May 2022,138,257,0,3849461,3797324,241161,4090622,4038485,85.2475941014301,84.1610713638937,283
-7.6926,53.28823,2022/05/06 23:00:00+00,Sat 07 May 2022,441,1088,0,3849902,3798412,241161,4091063,4039573,85.2567844370315,84.18374502633,284
-7.6926,53.28823,2022/05/07 23:00:00+00,Sun 08 May 2022,274,437,0,3850176,3798849,241161,4091337,4040010,85.2624945321671,84.1928520028784,285
-7.6926,53.28823,2022/05/08 23:00:00+00,Mon 09 May 2022,24,32,0,3850200,3798881,241161,4091361,4040042,85.2629946864856,84.193518875303,286
-7.6926,53.28823,2022/05/09 23:00:00+00,Tue 10 May 2022,80,98,1,3850280,3798979,241162,4091442,4040141,85.2646827073103,84.1955820118666,287
-7.6926,53.28823,2022/05/10 23:00:00+00,Wed 11 May 2022,112,132,0,3850392,3799111,241162,4091554,4040273,85.2670167607964,84.198332860618,288
-7.6926,53.28823,2022/05/11 23:00:00+00,Thu 12 May 2022,207,398,0,3850599,3799509,241162,4091761,4040671,85.271330591793,84.2066270863989,289
-7.6926,53.28823,2022/05/12 23:00:00+00,Fri 13 May 2022,173,326,0,3850772,3799835,241162,4091934,4040997,85.2749358708385,84.2134208492245,290
-7.6926,53.28823,2022/05/13 23:00:00+00,Sat 14 May 2022,333,633,0,3851105,3800468,241162,4092267,4041630,85.2818755120069,84.2266124193736,291
-7.6926,53.28823,2022/05/14 23:00:00+00,Sun 15 May 2022,168,254,0,3851273,3800722,241162,4092435,4041884,85.2853765922361,84.2319057192438,292
-7.6926,53.28823,2022/05/15 23:00:00+00,Mon 16 May 2022,31,41,0,3851304,3800763,241162,4092466,4041925,85.2860226248974,84.2327601495378,293
-7.6926,53.28823,2022/05/16 23:00:00+00,Tue 17 May 2022,97,101,0,3851401,3800864,241162,4092563,4042026,85.2880440819344,84.2348649656279,294
-7.6926,53.28823,2022/05/17 23:00:00+00,Wed 18 May 2022,99,123,0,3851500,3800987,241162,4092662,4042149,85.2901072184981,84.23742825651,295
-7.6926,53.28823,2022/05/18 23:00:00+00,Thu 19 May 2022,73,107,0,3851573,3801094,241162,4092735,4042256,85.2916285212167,84.2396581111797,296
-7.6926,53.28823,2022/05/19 23:00:00+00,Fri 20 May 2022,127,210,0,3851700,3801304,241162,4092862,4042466,85.2942751711518,84.2440344614661,297
-7.6926,53.28823,2022/05/20 23:00:00+00,Sat 21 May 2022,392,762,0,3852092,3802066,241162,4093254,4043228,85.3024443583531,84.2599143610768,298
-7.6926,53.28823,2022/05/21 23:00:00+00,Sun 22 May 2022,234,410,0,3852326,3802476,241162,4093488,4043638,85.3073208629579,84.268458664017,299
-7.6926,53.28823,2022/05/22 23:00:00+00,Mon 23 May 2022,26,35,0,3852352,3802511,241162,4093514,4043673,85.3078626968029,84.2691880557314,300
-7.6926,53.28823,2022/05/23 23:00:00+00,Tue 24 May 2022,64,83,0,3852416,3802594,241162,4093578,4043756,85.3091964416521,84.2709177560827,301
-7.6926,53.28823,2022/05/24 23:00:00+00,Wed 25 May 2022,87,134,1,3852503,3802728,241163,4093666,4043891,85.3110303408197,84.2737311241239,302
-7.6926,53.28823,2022/05/25 23:00:00+00,Thu 26 May 2022,97,155,0,3852600,3802883,241163,4093763,4044046,85.3130517978568,84.2769612874306,303
-7.6926,53.28823,2022/05/26 23:00:00+00,Fri 27 May 2022,95,152,1,3852695,3803035,241164,4093859,4044199,85.3150524151306,84.2801497712107,304
-7.6926,53.28823,2022/05/27 23:00:00+00,Sat 28 May 2022,335,580,0,3853030,3803615,241164,4094194,4044779,85.3220337358256,84.2922368339065,305
-7.6926,53.28823,2022/05/28 23:00:00+00,Sun 29 May 2022,181,349,0,3853211,3803964,241164,4094375,4045128,85.3258057329772,84.2995099112872,306
-7.6926,53.28823,2022/05/29 23:00:00+00,Mon 30 May 2022,9,24,0,3853220,3803988,241164,4094384,4045152,85.3259932908466,84.3000100656057,307
-7.6926,53.28823,2022/05/30 23:00:00+00,Tue 31 May 2022,65,80,2,3853285,3804068,241166,4094451,4045234,85.3273895549856,84.3017189261937,308
-7.6926,53.28823,2022/05/31 23:00:00+00,Wed 01 Jun 2022,70,102,0,3853355,3804170,241166,4094521,4045336,85.3288483384144,84.3038445820471,309
-7.6926,53.28823,2022/06/01 23:00:00+00,Thu 02 Jun 2022,91,142,0,3853446,3804312,241166,4094612,4045478,85.3307447568719,84.3068038284312,310
-7.6926,53.28823,2022/06/02 23:00:00+00,Fri 03 Jun 2022,59,143,0,3853505,3804455,241166,4094671,4045621,85.3319743029047,84.3097839145786,311
-7.6926,53.28823,2022/06/03 23:00:00+00,Sat 04 Jun 2022,305,607,0,3853810,3805062,241166,4094976,4046228,85.3383304307016,84.3224336508827,312
-7.6926,53.28823,2022/06/04 23:00:00+00,Sun 05 Jun 2022,143,273,0,3853953,3805335,241166,4095119,4046501,85.3413105168491,84.328122906255,313
-7.6926,53.28823,2022/06/05 23:00:00+00,Mon 06 Jun 2022,5,7,1,3853958,3805342,241167,4095125,4046509,85.3414355554287,84.3282896243612,314
-7.6926,53.28823,2022/06/06 23:00:00+00,Tue 07 Jun 2022,29,54,0,3853987,3805396,241167,4095154,4046563,85.3420399085635,84.3294149715777,315
-7.6926,53.28823,2022/06/07 23:00:00+00,Wed 08 Jun 2022,36,76,0,3854023,3805472,241167,4095190,4046639,85.3427901400411,84.3309987935861,316
-7.6926,53.28823,2022/06/08 23:00:00+00,Thu 09 Jun 2022,73,122,0,3854096,3805594,241167,4095263,4046761,85.3443114427597,84.3335412447049,317
-7.6926,53.28823,2022/06/09 23:00:00+00,Fri 10 Jun 2022,56,108,0,3854152,3805702,241167,4095319,4046869,85.3454784695028,84.3357919391379,318
-7.6926,53.28823,2022/06/10 23:00:00+00,Sat 11 Jun 2022,190,562,0,3854342,3806264,241167,4095509,4047431,85.3494380245238,84.3475038860949,319
-7.6926,53.28823,2022/06/11 23:00:00+00,Sun 12 Jun 2022,143,288,0,3854485,3806552,241167,4095652,4047719,85.3524181106712,84.3535057379162,320
-7.6926,53.28823,2022/06/12 23:00:00+00,Mon 13 Jun 2022,17,44,0,3854502,3806596,241167,4095669,4047763,85.3527723866468,84.3544226875,321
-7.6926,53.28823,2022/06/13 23:00:00+00,Tue 14 Jun 2022,37,55,0,3854539,3806651,241167,4095706,4047818,85.3535434578877,84.3555688744798,322
-7.6926,53.28823,2022/06/14 23:00:00+00,Wed 15 Jun 2022,66,123,0,3854605,3806774,241167,4095772,4047941,85.3549188822635,84.3581321653619,323
-7.6926,53.28823,2022/06/15 23:00:00+00,Thu 16 Jun 2022,43,85,0,3854648,3806859,241167,4095815,4048026,85.355814992084,84.3599035452397,324
-7.6926,53.28823,2022/06/16 23:00:00+00,Fri 17 Jun 2022,59,95,0,3854707,3806954,241167,4095874,4048121,85.3570445381169,84.3618833227502,325
-7.6926,53.28823,2022/06/17 23:00:00+00,Sat 18 Jun 2022,223,488,0,3854930,3807442,241167,4096097,4048609,85.3616918053258,84.3720531272253,326
-7.6926,53.28823,2022/06/18 23:00:00+00,Sun 19 Jun 2022,79,129,0,3855009,3807571,241167,4096176,4048738,85.363338146624,84.3747414566869,327
-7.6926,53.28823,2022/06/19 23:00:00+00,Mon 20 Jun 2022,9,28,0,3855018,3807599,241167,4096185,4048766,85.3635257044934,84.3753249700585,328
-7.6926,53.28823,2022/06/20 23:00:00+00,Tue 21 Jun 2022,74,169,1,3855092,3807768,241168,4096260,4048936,85.3650886867386,84.3788677298141,329
-7.6926,53.28823,2022/06/21 23:00:00+00,Wed 22 Jun 2022,60,95,0,3855152,3807863,241168,4096320,4049031,85.3663390725347,84.3808475073246,330
-7.6926,53.28823,2022/06/22 23:00:00+00,Thu 23 Jun 2022,64,113,0,3855216,3807976,241168,4096384,4049144,85.3676728173839,84.383202400574,331
-7.6926,53.28823,2022/06/23 23:00:00+00,Fri 24 Jun 2022,55,93,1,3855271,3808069,241169,4096440,4049238,85.3688398441269,84.3851613383213,332
-7.6926,53.28823,2022/06/24 23:00:00+00,Sat 25 Jun 2022,210,293,0,3855481,3808362,241169,4096650,4049531,85.3732161944133,84.391267388959,333
-7.6926,53.28823,2022/06/25 23:00:00+00,Sun 26 Jun 2022,174,402,0,3855655,3808764,241169,4096824,4049933,85.3768423132221,84.399644973793,334
-7.6926,53.28823,2022/06/26 23:00:00+00,Mon 27 Jun 2022,5,35,0,3855660,3808799,241169,4096829,4049968,85.3769465120384,84.4003743655074,335
-7.6926,53.28823,2022/06/27 23:00:00+00,Tue 28 Jun 2022,49,60,0,3855709,3808859,241169,4096878,4050028,85.3779676604386,84.4016247513035,336
-7.6926,53.28823,2022/06/28 23:00:00+00,Wed 29 Jun 2022,63,81,3,3855772,3808940,241172,4096944,4050112,85.3793430848143,84.403375291418,337
-7.6926,53.28823,2022/06/29 23:00:00+00,Thu 30 Jun 2022,48,89,0,3855820,3809029,241172,4096992,4050201,85.3803433934512,84.4052300303489,338
-7.6926,53.28823,2022/06/30 23:00:00+00,Fri 01 Jul 2022,46,66,0,3855866,3809095,241172,4097038,4050267,85.3813020225615,84.4066054547247,339
-7.6926,53.28823,2021/01/06 00:00:00+00,Wed 06 Jan 2021,6797,14,0,15894,66,5,15899,71,0.331331396207872,0.00147962319207239,340
-7.6926,53.28823,2021/01/07 00:00:00+00,Thu 07 Jan 2021,11743,9,0,27637,75,5,27642,80,0.576052736271337,0.00166718106149001,341
-7.6926,53.28823,2021/01/08 00:00:00+00,Fri 08 Jan 2021,12691,8,0,40328,83,5,40333,88,0.840530171913459,0.00183389916763902,342
-7.6926,53.28823,2021/01/09 00:00:00+00,Sat 09 Jan 2021,8081,7,0,48409,90,5,48414,95,1.00893629888722,0.00197977751051939,343
-7.6926,53.28823,2021/01/10 00:00:00+00,Sun 10 Jan 2021,4790,6,1,53199,96,6,53205,102,1.1087796047072,0.00212565585339977,344
-7.6926,53.28823,2021/01/11 00:00:00+00,Mon 11 Jan 2021,8356,8,0,61555,104,6,61561,110,1.28291666657983,0.00229237395954877,345
-7.6926,53.28823,2021/01/12 00:00:00+00,Tue 12 Jan 2021,8901,15,0,70456,119,6,70462,125,1.46841139943387,0.00260497040857815,346
-7.6926,53.28823,2021/01/13 00:00:00+00,Wed 13 Jan 2021,9907,5,0,80363,124,6,80369,130,1.67487093413614,0.00270916922492127,347
-7.6926,53.28823,2021/01/14 00:00:00+00,Thu 14 Jan 2021,8099,6,0,88462,130,6,88468,136,1.84365217684873,0.00283420780453302,348
-7.6926,53.28823,2021/01/15 00:00:00+00,Fri 15 Jan 2021,7708,5,0,96170,135,6,96176,141,2.00428507212329,0.00293840662087615,349
-7.6926,53.28823,2021/01/16 00:00:00+00,Sat 16 Jan 2021,5248,3,0,101418,138,6,101424,144,2.11365214975704,0.00300092591068202,350
-7.6926,53.28823,2021/01/17 00:00:00+00,Sun 17 Jan 2021,1117,5,0,102535,143,6,102541,149,2.13693016532809,0.00310512472702515,351
-7.6926,53.28823,2021/01/18 00:00:00+00,Mon 18 Jan 2021,8731,9,1,111266,152,7,111273,159,2.31890297818973,0.0033135223597114,352
-7.6926,53.28823,2021/01/19 00:00:00+00,Tue 19 Jan 2021,8399,21,0,119665,173,7,119672,180,2.49393614988291,0.00375115738835253,353
-7.6926,53.28823,2021/01/20 00:00:00+00,Wed 20 Jan 2021,8458,966,0,128123,1139,7,128130,1146,2.67019886760894,0.0238823687058444,354
-7.6926,53.28823,2021/01/21 00:00:00+00,Thu 21 Jan 2021,9023,967,0,137146,2106,7,137153,2113,2.85823605158175,0.044034419786605,355
-7.6926,53.28823,2021/01/22 00:00:00+00,Fri 22 Jan 2021,6796,971,0,143942,3077,7,143949,3084,2.99986308275533,0.06426982992044,356
-7.6926,53.28823,2021/01/23 00:00:00+00,Sat 23 Jan 2021,4201,461,0,148143,3538,7,148150,3545,3.08741092824682,0.0738769607872762,357
-7.6926,53.28823,2021/01/24 00:00:00+00,Sun 24 Jan 2021,1190,400,0,149333,3938,7,149340,3945,3.11221024653648,0.0822128660947263,358
-7.6926,53.28823,2021/01/25 00:00:00+00,Mon 25 Jan 2021,1377,1294,0,150710,5232,7,150717,5239,3.14090660055738,0.109179519764327,359
-7.6926,53.28823,2021/01/26 00:00:00+00,Tue 26 Jan 2021,1012,3508,0,151722,8740,7,151729,8747,3.16199644098523,0.182285409310664,360
-7.6926,53.28823,2021/01/27 00:00:00+00,Wed 27 Jan 2021,2194,6710,0,153916,15450,7,153923,15457,3.20771888159659,0.322120220843139,361
-7.6926,53.28823,2021/01/28 00:00:00+00,Thu 28 Jan 2021,1028,11545,0,154944,26995,7,154951,27002,3.22914215823674,0.562715287779417,362
-7.6926,53.28823,2021/01/29 00:00:00+00,Fri 29 Jan 2021,1597,11526,0,156541,38521,7,156548,38528,3.26242326017673,0.802914399213591,363
-7.6926,53.28823,2021/01/30 00:00:00+00,Sat 30 Jan 2021,657,7795,0,157198,46316,7,157205,46323,3.27611498464422,0.965360353892524,364
-7.6926,53.28823,2021/01/31 00:00:00+00,Sun 31 Jan 2021,240,4088,0,157438,50404,7,157445,50411,3.28111652782869,1.05055330613466,365
-7.6926,53.28823,2021/02/01 00:00:00+00,Mon 01 Feb 2021,1044,8337,1,158482,58741,8,158490,58749,3.3028940804444,1.22431525226846,366
-7.6926,53.28823,2021/02/02 00:00:00+00,Tue 02 Feb 2021,851,5113,1,159333,63854,9,159342,63863,3.32064955874927,1.33088980162421,367
-7.6926,53.28823,2021/02/03 00:00:00+00,Wed 03 Feb 2021,1413,6873,0,160746,70727,9,160755,70736,3.35009614424784,1.47412149456947,368
-7.6926,53.28823,2021/02/04 00:00:00+00,Thu 04 Feb 2021,1458,10542,1,162204,81269,10,162214,81279,3.38050135885676,1.69383511871059,369
-7.6926,53.28823,2021/02/05 00:00:00+00,Fri 05 Feb 2021,3408,8616,0,165612,89885,10,165622,89895,3.45152327207624,1.87339051903306,370
-7.6926,53.28823,2021/02/06 00:00:00+00,Sat 06 Feb 2021,915,3871,0,166527,93756,10,166537,93766,3.47059165546703,1.95406124264591,371
-7.6926,53.28823,2021/02/07 00:00:00+00,Sun 07 Feb 2021,341,1300,2,166868,95056,12,166880,95068,3.47773969426817,1.98119461442166,372
-7.6926,53.28823,2021/02/08 00:00:00+00,Mon 08 Feb 2021,1197,882,0,168065,95938,12,168077,95950,3.50268489090071,1.99957528562459,373
-7.6926,53.28823,2021/02/09 00:00:00+00,Tue 09 Feb 2021,4276,555,3,172341,96493,15,172356,96508,3.59185823792716,2.01120387352848,374
-7.6926,53.28823,2021/02/10 00:00:00+00,Wed 10 Feb 2021,8836,585,0,181177,97078,15,181192,97093,3.77599838616873,2.02339513504062,375
-7.6926,53.28823,2021/02/11 00:00:00+00,Thu 11 Feb 2021,6208,452,0,187385,97530,15,187400,97545,3.90537163654036,2.03281470803804,376
-7.6926,53.28823,2021/02/12 00:00:00+00,Fri 12 Feb 2021,4409,527,0,191794,98057,15,191809,98072,3.99725415279173,2.04379726328061,377
-7.6926,53.28823,2021/02/13 00:00:00+00,Sat 13 Feb 2021,1224,1918,0,193018,99975,15,193033,99990,4.02276202303252,2.08376792922983,378
-7.6926,53.28823,2021/02/14 00:00:00+00,Sun 14 Feb 2021,2712,29,0,195730,100004,15,195745,100019,4.07927946101703,2.08437228236462,379
-7.6926,53.28823,2021/02/15 00:00:00+00,Mon 15 Feb 2021,1977,7897,0,197707,107901,15,197722,107916,4.12047967299911,2.24894389289695,380
-7.6926,53.28823,2021/02/16 00:00:00+00,Tue 16 Feb 2021,5663,8170,0,203370,116071,15,203385,116086,4.23849525238933,2.41920475880162,381
-7.6926,53.28823,2021/02/17 00:00:00+00,Wed 17 Feb 2021,9761,8467,0,213131,124538,15,213146,124553,4.44191218165438,2.59565503439707,382
-7.6926,53.28823,2021/02/18 00:00:00+00,Thu 18 Feb 2021,8478,8362,1,221609,132900,16,221625,132916,4.61861253440905,2.76993797461258,383
-7.6926,53.28823,2021/02/19 00:00:00+00,Fri 19 Feb 2021,9402,6595,2,231011,139495,18,231029,139513,4.8145896681872,2.9074178928957,384
-7.6926,53.28823,2021/02/20 00:00:00+00,Sat 20 Feb 2021,5900,3581,2,236911,143076,20,236931,143096,4.93758595099863,2.98208676468719,385
-7.6926,53.28823,2021/02/21 00:00:00+00,Sun 21 Feb 2021,1120,1025,6,238031,144101,26,238057,144127,4.9610515244391,3.00357256061714,386
-7.6926,53.28823,2021/02/22 00:00:00+00,Mon 22 Feb 2021,3956,1129,2,241987,145230,28,242015,145258,5.04353530745632,3.02714233287396,387
-7.6926,53.28823,2021/02/23 00:00:00+00,Tue 23 Feb 2021,13380,1075,1,255367,146305,29,255396,146334,5.32239217975379,3.049565918151,388
-7.6926,53.28823,2021/02/24 00:00:00+00,Wed 24 Feb 2021,16955,2111,6,272322,148416,35,272357,148451,5.67585540455295,3.09368369699068,389
-7.6926,53.28823,2021/02/25 00:00:00+00,Thu 25 Feb 2021,18110,1771,3,290432,150187,38,290470,150225,6.05332603663755,3.13065343702922,390
-7.6926,53.28823,2021/02/26 00:00:00+00,Fri 26 Feb 2021,16101,2782,1,306533,152969,39,306572,153008,6.38888790478896,3.1886504982058,391
-7.6926,53.28823,2021/02/27 00:00:00+00,Sat 27 Feb 2021,9013,707,1,315546,153676,40,315586,153716,6.57673753089234,3.20340505059999,392
-7.6926,53.28823,2021/02/28 00:00:00+00,Sun 28 Feb 2021,2455,61,2,318001,153737,42,318043,153779,6.62794082924336,3.20471795568591,393
-7.6926,53.28823,2021/03/01 00:00:00+00,Mon 01 Mar 2021,5635,810,0,323636,154547,42,323678,154589,6.74537289526206,3.2215981639335,394
-7.6926,53.28823,2021/03/02 00:00:00+00,Tue 02 Mar 2021,12213,1621,0,335849,156168,42,335891,156210,6.99988892406178,3.25537942019194,395
-7.6926,53.28823,2021/03/03 00:00:00+00,Wed 03 Mar 2021,12928,1515,1,348777,157683,43,348820,157726,7.26932622336183,3.28697250130717,396
-7.6926,53.28823,2021/03/04 00:00:00+00,Thu 04 Mar 2021,18744,1699,5,367521,159382,48,367569,159430,7.66005094488529,3.32248345791691,397
-7.6926,53.28823,2021/03/05 00:00:00+00,Fri 05 Mar 2021,18476,2407,6,385997,161789,54,386051,161843,8.04521144961602,3.3727698066841,398
-7.6926,53.28823,2021/03/06 00:00:00+00,Sat 06 Mar 2021,10415,150,5,396412,161939,59,396471,161998,8.26236178287509,3.37599996999074,399
-7.6926,53.28823,2021/03/07 00:00:00+00,Sun 07 Mar 2021,1539,18,5,397951,161957,64,398015,162021,8.29453837736185,3.37647928454592,400
-7.6926,53.28823,2021/03/08 00:00:00+00,Mon 08 Mar 2021,6686,1514,6,404637,163471,70,404707,163541,8.43399807315549,3.40815572471423,401
-7.6926,53.28823,2021/03/09 00:00:00+00,Tue 09 Mar 2021,13866,3115,6,418503,166586,76,418579,166662,8.72308726921786,3.47319662587561,402
-7.6926,53.28823,2021/03/10 00:00:00+00,Wed 10 Mar 2021,13765,4007,3,432268,170593,79,432347,170672,9.01000912990029,3.5567640765828,403
-7.6926,53.28823,2021/03/11 00:00:00+00,Thu 11 Mar 2021,18510,2108,4,450778,172701,83,450861,172784,9.39583650705561,3.60077765660613,404
-7.6926,53.28823,2021/03/12 00:00:00+00,Fri 12 Mar 2021,17363,1353,4,468141,174054,87,468228,174141,9.75776067574183,3.62905721536166,405
-7.6926,53.28823,2021/03/13 00:00:00+00,Sat 13 Mar 2021,8339,181,0,476480,174235,87,476567,174322,9.93154346163889,3.63282921251328,406
-7.6926,53.28823,2021/03/14 00:00:00+00,Sun 14 Mar 2021,399,23,2,476879,174258,89,476968,174347,9.93990020670961,3.63335020659499,407
-7.6926,53.28823,2021/03/15 00:00:00+00,Mon 15 Mar 2021,2679,1005,0,479558,175263,89,479647,175352,9.99572993250626,3.65429416867996,408
-7.6926,53.28823,2021/03/16 00:00:00+00,Tue 16 Mar 2021,8977,3833,2,488535,179096,91,488626,179187,10.1828501668952,3.73421466081514,409
-7.6926,53.28823,2021/03/17 00:00:00+00,Wed 17 Mar 2021,4913,2430,8,493448,181526,99,493547,181625,10.2854026419401,3.78502200366405,410
-7.6926,53.28823,2021/03/18 00:00:00+00,Thu 18 Mar 2021,11751,4692,7,505199,186218,106,505305,186324,10.5304365784526,3.88294805126332,411
-7.6926,53.28823,2021/03/19 00:00:00+00,Fri 19 Mar 2021,10398,6143,2,515597,192361,108,515705,192469,10.7471701164463,4.01100839654902,412
-7.6926,53.28823,2021/03/20 00:00:00+00,Sat 20 Mar 2021,5262,3131,4,520859,195492,112,520971,195604,10.8569123098189,4.07634105439616,413
-7.6926,53.28823,2021/03/21 00:00:00+00,Sun 21 Mar 2021,3662,59,3,524521,195551,115,524636,195666,10.9332900421984,4.07763311971881,414
-7.6926,53.28823,2021/03/22 00:00:00+00,Mon 22 Mar 2021,7436,2420,1,531957,197971,116,532073,198087,11.0882753616272,4.12808618659215,415
-7.6926,53.28823,2021/03/23 00:00:00+00,Tue 23 Mar 2021,12584,7411,6,544541,205382,122,544663,205504,11.3506479811792,4.28265471075555,416
-7.6926,53.28823,2021/03/24 00:00:00+00,Wed 24 Mar 2021,13651,9787,2,558192,215169,124,558316,215293,11.6351732690857,4.48665515339212,417
-7.6926,53.28823,2021/03/25 00:00:00+00,Thu 25 Mar 2021,20896,10234,3,579088,225403,127,579215,225530,12.0707034816367,4.69999180997304,418
-7.6926,53.28823,2021/03/26 00:00:00+00,Fri 26 Mar 2021,19722,9517,1,598810,234920,128,598938,235048,12.4817261325838,4.89834467676381,419
-7.6926,53.28823,2021/03/27 00:00:00+00,Sat 27 Mar 2021,11775,5365,3,610585,240285,131,610716,240416,12.7271768643617,5.01021252598979,420
-7.6926,53.28823,2021/03/28 00:00:00+00,Sun 28 Mar 2021,2504,490,0,613089,240775,131,613220,240906,12.7793596315863,5.02042400999142,421
-7.6926,53.28823,2021/03/28 23:00:00+00,Mon 29 Mar 2021,9295,3133,3,622384,243908,134,622518,244042,12.973127750458,5.08577750760182,422
-7.6926,53.28823,2021/03/29 23:00:00+00,Tue 30 Mar 2021,13352,8684,4,635736,252592,138,635874,252730,13.2514636286738,5.26683337087964,423
-7.6926,53.28823,2021/03/30 23:00:00+00,Wed 31 Mar 2021,15858,10519,4,651594,263111,142,651736,263253,13.5820239536407,5.48613019975538,424
-7.6926,53.28823,2021/03/31 23:00:00+00,Thu 01 Apr 2021,19736,11595,9,671330,274706,151,671481,274857,13.9935050793797,5.72795481272451,425
-7.6926,53.28823,2021/04/01 23:00:00+00,Fri 02 Apr 2021,20166,13731,9,691496,288437,160,691656,288597,14.4139473033242,6.01429316003542,426
-7.6926,53.28823,2021/04/02 23:00:00+00,Sat 03 Apr 2021,7560,4644,7,699056,293081,167,699223,293248,14.5716417919779,6.1112188989978,427
-7.6926,53.28823,2021/04/03 23:00:00+00,Sun 04 Apr 2021,3050,175,3,702106,293256,170,702276,293426,14.635265589237,6.11492837685961,428
-7.6926,53.28823,2021/04/04 23:00:00+00,Mon 05 Apr 2021,3456,618,6,705562,293874,176,705738,294050,14.707412849673,6.12793238913923,429
-7.6926,53.28823,2021/04/05 23:00:00+00,Tue 06 Apr 2021,12013,8164,13,717575,302038,189,717764,302227,14.9580318427415,6.29833913338678,430
-7.6926,53.28823,2021/04/06 23:00:00+00,Wed 07 Apr 2021,18386,10499,12,735961,312537,201,736162,312738,15.3414418073576,6.5173858851033,431
-7.6926,53.28823,2021/04/07 23:00:00+00,Thu 08 Apr 2021,20207,10584,18,756168,323121,219,756387,323340,15.7629260194656,6.73832905527726,432
-7.6926,53.28823,2021/04/08 23:00:00+00,Fri 09 Apr 2021,20691,9174,16,776859,332295,235,777094,332530,16.194454997469,6.92984647971593,433
-7.6926,53.28823,2021/04/09 23:00:00+00,Sat 10 Apr 2021,11194,4188,12,788053,336483,247,788300,336730,16.4279853846572,7.01737348544415,434
-7.6926,53.28823,2021/04/10 23:00:00+00,Sun 11 Apr 2021,2878,370,9,790931,336853,256,791187,337109,16.4881497812137,7.02527175572296,435
-7.6926,53.28823,2021/04/11 23:00:00+00,Mon 12 Apr 2021,7797,2811,14,798728,339664,270,798998,339934,16.650929172105,7.08414408695683,436
-7.6926,53.28823,2021/04/12 23:00:00+00,Tue 13 Apr 2021,11536,8598,1,810264,348262,271,810535,348533,16.8913575209351,7.26334521130374,437
-7.6926,53.28823,2021/04/13 23:00:00+00,Wed 14 Apr 2021,20359,6603,2,830623,354865,273,830896,355138,17.3156759408476,7.40099184769301,438
-7.6926,53.28823,2021/04/14 23:00:00+00,Thu 15 Apr 2021,27122,10825,1,857745,365690,274,858019,365964,17.8809128399825,7.62660312483914,439
-7.6926,53.28823,2021/04/15 23:00:00+00,Fri 16 Apr 2021,27981,9852,1,885726,375542,275,886001,375817,18.4640510957652,7.83193731232491,440
-7.6926,53.28823,2022/07/01 23:00:00+00,Sat 02 Jul 2022,182,228,0,3856048,3809323,241172,4097220,4050495,85.3850948594764,84.4113569207499,441
-7.6926,53.28823,2022/07/02 23:00:00+00,Sun 03 Jul 2022,108,273,0,3856156,3809596,241172,4097328,4050768,85.3873455539094,84.4170461761223,442
-7.6926,53.28823,2022/07/03 23:00:00+00,Mon 04 Jul 2022,15,15,0,3856171,3809611,241172,4097343,4050783,85.3876581503585,84.4173587725713,443
-7.6926,53.28823,2022/07/04 23:00:00+00,Tue 05 Jul 2022,51,70,0,3856222,3809681,241172,4097394,4050853,85.3887209782852,84.4188175560001,444
-7.6926,53.28823,2022/07/05 23:00:00+00,Wed 06 Jul 2022,60,83,0,3856282,3809764,241172,4097454,4050936,85.3899713640813,84.4205472563514,445
-7.6926,53.28823,2022/07/06 23:00:00+00,Thu 07 Jul 2022,77,77,0,3856359,3809841,241172,4097531,4051013,85.391576025853,84.4221519181231,446
-7.6926,53.28823,2022/07/07 23:00:00+00,Fri 08 Jul 2022,99,91,0,3856458,3809932,241172,4097630,4051104,85.3936391624166,84.4240483365805,447
-7.6926,53.28823,2022/07/08 23:00:00+00,Sat 09 Jul 2022,119,144,0,3856577,3810076,241172,4097749,4051248,85.3961190942455,84.4270492624912,448
-7.6926,53.28823,2022/07/09 23:00:00+00,Sun 10 Jul 2022,134,219,0,3856711,3810295,241172,4097883,4051467,85.3989116225235,84.431613170647,449
-7.6926,53.28823,2022/07/10 23:00:00+00,Mon 11 Jul 2022,11,16,0,3856722,3810311,241172,4097894,4051483,85.3991408599195,84.4319466068593,450
-7.6926,53.28823,2022/07/11 23:00:00+00,Tue 12 Jul 2022,44,81,0,3856766,3810392,241172,4097938,4051564,85.4000578095033,84.4336346276841,451
-7.6926,53.28823,2022/07/12 23:00:00+00,Wed 13 Jul 2022,99,74,0,3856865,3810466,241172,4098037,4051638,85.4021209460669,84.435176770166,452
-7.6926,53.28823,2022/07/13 23:00:00+00,Thu 14 Jul 2022,72,39,0,3856937,3810505,241172,4098109,4051677,85.4036214090223,84.4359895209334,453
-7.6926,53.28823,2022/07/14 23:00:00+00,Fri 15 Jul 2022,80,118,1,3857017,3810623,241173,4098190,4051796,85.405309429847,84.4384694527624,454
-7.6926,53.28823,2022/07/15 23:00:00+00,Sat 16 Jul 2022,124,209,0,3857141,3810832,241173,4098314,4052005,85.4078935604923,84.4428249632855,455
-7.6926,53.28823,2022/07/16 23:00:00+00,Sun 17 Jul 2022,119,165,0,3857260,3810997,241173,4098433,4052170,85.4103734923213,84.4462635242249,456
-7.6926,53.28823,2022/07/17 23:00:00+00,Mon 18 Jul 2022,14,18,0,3857274,3811015,241173,4098447,4052188,85.410665249007,84.4466386399637,457
-7.6926,53.28823,2022/07/18 23:00:00+00,Tue 19 Jul 2022,30,34,0,3857304,3811049,241173,4098477,4052222,85.4112904419051,84.4473471919148,458
-7.6926,53.28823,2022/07/19 23:00:00+00,Wed 20 Jul 2022,78,66,0,3857382,3811115,241173,4098555,4052288,85.4129159434401,84.4487226162906,459
-7.6926,53.28823,2022/07/20 23:00:00+00,Thu 21 Jul 2022,52,30,0,3857434,3811145,241173,4098607,4052318,85.41399961113,84.4493478091886,460
-7.6926,53.28823,2022/07/21 23:00:00+00,Fri 22 Jul 2022,75,70,0,3857509,3811215,241173,4098682,4052388,85.4155625933752,84.4508065926174,461
-7.6926,53.28823,2022/07/22 23:00:00+00,Sat 23 Jul 2022,99,175,0,3857608,3811390,241173,4098781,4052563,85.4176257299388,84.4544535511894,462
-7.6926,53.28823,2022/07/23 23:00:00+00,Sun 24 Jul 2022,108,230,0,3857716,3811620,241173,4098889,4052793,85.4198764243718,84.4592466967412,463
-7.6926,53.28823,2022/07/24 23:00:00+00,Mon 25 Jul 2022,14,23,0,3857730,3811643,241173,4098903,4052816,85.4201681810575,84.4597260112964,464
-7.6926,53.28823,2022/07/25 23:00:00+00,Tue 26 Jul 2022,18,16,0,3857748,3811659,241173,4098921,4052832,85.4205432967964,84.4600594475087,465
-7.6926,53.28823,2022/07/26 23:00:00+00,Wed 27 Jul 2022,61,72,1,3857809,3811731,241174,4098983,4052905,85.421835362119,84.4615807502273,466
-7.6926,53.28823,2022/07/27 23:00:00+00,Thu 28 Jul 2022,49,71,0,3857858,3811802,241174,4099032,4052976,85.4228565105192,84.4630603734194,467
-7.6926,53.28823,2022/07/28 23:00:00+00,Fri 29 Jul 2022,71,105,0,3857929,3811907,241174,4099103,4053081,85.4243361337113,84.4652485485626,468
-7.6926,53.28823,2022/07/29 23:00:00+00,Sat 30 Jul 2022,100,119,0,3858029,3812026,241174,4099203,4053200,85.4264201100381,84.4677284803916,469
-7.6926,53.28823,2022/07/30 23:00:00+00,Sun 31 Jul 2022,32,57,0,3858061,3812083,241174,4099235,4053257,85.4270869824627,84.4689163468979,470
-7.6926,53.28823,2022/07/31 23:00:00+00,Mon 01 Aug 2022,10,15,0,3858071,3812098,241174,4099245,4053272,85.4272953800954,84.4692289433469,471
-7.6926,53.28823,2022/08/01 23:00:00+00,Tue 02 Aug 2022,36,30,0,3858107,3812128,241174,4099281,4053302,85.4280456115731,84.4698541362449,472
-7.6926,53.28823,2022/08/02 23:00:00+00,Wed 03 Aug 2022,93,139,0,3858200,3812267,241174,4099374,4053441,85.429983709557,84.4727508633393,473
-7.6926,53.28823,2022/08/03 23:00:00+00,Thu 04 Aug 2022,45,53,0,3858245,3812320,241174,4099419,4053494,85.4309214989041,84.4738553707925,474
-7.6926,53.28823,2022/08/04 23:00:00+00,Fri 05 Aug 2022,96,91,0,3858341,3812411,241174,4099515,4053585,85.4329221161779,84.47575178925,475
-7.6926,53.28823,2022/08/05 23:00:00+00,Sat 06 Aug 2022,74,130,0,3858415,3812541,241174,4099589,4053715,85.4344642586598,84.4784609584749,476
-7.6926,53.28823,2022/08/06 23:00:00+00,Sun 07 Aug 2022,28,80,0,3858443,3812621,241174,4099617,4053795,85.4350477720313,84.4801281395364,477
-7.6926,53.28823,2022/08/07 23:00:00+00,Mon 08 Aug 2022,11,15,0,3858454,3812636,241174,4099628,4053810,85.4352770094273,84.4804407359854,478
-7.6926,53.28823,2022/08/08 23:00:00+00,Tue 09 Aug 2022,48,41,0,3858502,3812677,241174,4099676,4053851,85.4362773180642,84.4812951662794,479
-7.6926,53.28823,2022/08/09 23:00:00+00,Wed 10 Aug 2022,55,94,1,3858557,3812771,241175,4099732,4053946,85.4374443448072,84.4832749437899,480
-7.6926,53.28823,2022/08/10 23:00:00+00,Thu 11 Aug 2022,45,42,0,3858602,3812813,241175,4099777,4053988,85.4383821341543,84.4841502138472,481
-7.6926,53.28823,2022/08/11 23:00:00+00,Fri 12 Aug 2022,69,75,0,3858671,3812888,241175,4099846,4054063,85.4398200778198,84.4857131960924,482
-7.6926,53.28823,2022/08/12 23:00:00+00,Sat 13 Aug 2022,103,151,0,3858774,3813039,241175,4099949,4054214,85.4419665734365,84.4888600003459,483
-7.6926,53.28823,2022/08/13 23:00:00+00,Sun 14 Aug 2022,17,26,0,3858791,3813065,241175,4099966,4054240,85.4423208494121,84.4894018341909,484
-7.6926,53.28823,2022/08/14 23:00:00+00,Mon 15 Aug 2022,7,11,0,3858798,3813076,241175,4099973,4054251,85.442466727755,84.4896310715869,485
-7.6926,53.28823,2022/08/15 23:00:00+00,Tue 16 Aug 2022,41,28,0,3858839,3813104,241175,4100014,4054279,85.443321158049,84.4902145849584,486
-7.6926,53.28823,2022/08/16 23:00:00+00,Wed 17 Aug 2022,51,58,0,3858890,3813162,241175,4100065,4054337,85.4443839859757,84.491423291228,487
-7.6926,53.28823,2022/08/17 23:00:00+00,Thu 18 Aug 2022,55,39,0,3858945,3813201,241175,4100120,4054376,85.4455301729555,84.4922360419955,488
-7.6926,53.28823,2022/08/18 23:00:00+00,Fri 19 Aug 2022,74,56,0,3859019,3813257,241175,4100194,4054432,85.4470723154373,84.4934030687385,489
-7.6926,53.28823,2022/08/19 23:00:00+00,Sat 20 Aug 2022,109,127,0,3859128,3813384,241175,4100303,4054559,85.4493438496336,84.4960497186736,490
-7.6926,53.28823,2022/08/20 23:00:00+00,Sun 21 Aug 2022,39,36,0,3859167,3813420,241175,4100342,4054595,85.4501566004011,84.4967999501513,491
-7.6926,53.28823,2022/08/21 23:00:00+00,Mon 22 Aug 2022,12,13,0,3859179,3813433,241175,4100354,4054608,85.4504066775603,84.4970708670738,492
-7.6926,53.28823,2022/08/22 23:00:00+00,Tue 23 Aug 2022,78,73,0,3859257,3813506,241175,4100432,4054681,85.4520321790953,84.4985921697924,493
-7.6926,53.28823,2022/08/23 23:00:00+00,Wed 24 Aug 2022,53,56,0,3859310,3813562,241175,4100485,4054737,85.4531366865485,84.4997591965354,494
-7.6926,53.28823,2022/08/24 23:00:00+00,Thu 25 Aug 2022,40,49,0,3859350,3813611,241175,4100525,4054786,85.4539702770792,84.5007803449356,495
-7.6926,53.28823,2022/08/25 23:00:00+00,Fri 26 Aug 2022,99,90,0,3859449,3813701,241175,4100624,4054876,85.4560334136428,84.5026559236298,496
-7.6926,53.28823,2022/08/26 23:00:00+00,Sat 27 Aug 2022,86,119,0,3859535,3813820,241175,4100710,4054995,85.4578256332839,84.5051358554587,497
-7.6926,53.28823,2022/08/27 23:00:00+00,Sun 28 Aug 2022,44,21,0,3859579,3813841,241175,4100754,4055016,85.4587425828678,84.5055734904874,498
-7.6926,53.28823,2022/08/28 23:00:00+00,Mon 29 Aug 2022,13,12,0,3859592,3813853,241175,4100767,4055028,85.4590134997902,84.5058235676466,499
-7.6926,53.28823,2022/08/29 23:00:00+00,Tue 30 Aug 2022,41,44,1,3859633,3813897,241176,4100809,4055073,85.4598887698475,84.5067613569937,500
-7.6926,53.28823,2022/08/30 23:00:00+00,Wed 31 Aug 2022,28,29,0,3859661,3813926,241176,4100837,4055102,85.460472283219,84.5073657101285,501
-7.6926,53.28823,2022/08/31 23:00:00+00,Thu 01 Sep 2022,33,30,0,3859694,3813956,241176,4100870,4055132,85.4611599954069,84.5079909030265,502
-7.6926,53.28823,2022/09/01 23:00:00+00,Fri 02 Sep 2022,48,51,0,3859742,3814007,241176,4100918,4055183,85.4621603040438,84.5090537309532,503
-7.6926,53.28823,2022/09/02 23:00:00+00,Sat 03 Sep 2022,73,101,0,3859815,3814108,241176,4100991,4055284,85.4636816067624,84.5111585470434,504
-7.6926,53.28823,2022/09/03 23:00:00+00,Sun 04 Sep 2022,58,82,0,3859873,3814190,241176,4101049,4055366,85.464890313032,84.5128674076314,505
-7.6926,53.28823,2022/09/04 23:00:00+00,Mon 05 Sep 2022,9,5,0,3859882,3814195,241176,4101058,4055371,85.4650778709014,84.5129716064477,506
-7.6926,53.28823,2022/09/05 23:00:00+00,Tue 06 Sep 2022,42,22,0,3859924,3814217,241176,4101100,4055393,85.4659531409587,84.5134300812396,507
-7.6926,53.28823,2022/09/06 23:00:00+00,Wed 07 Sep 2022,48,42,0,3859972,3814259,241176,4101148,4055435,85.4669534495956,84.5143053512969,508
-7.6926,53.28823,2022/09/07 23:00:00+00,Thu 08 Sep 2022,39,51,2,3860011,3814310,241178,4101189,4055488,85.4678078798896,84.5154098587502,509
-7.6926,53.28823,2022/09/08 23:00:00+00,Fri 09 Sep 2022,64,60,0,3860075,3814370,241178,4101253,4055548,85.4691416247388,84.5166602445463,510
-7.6926,53.28823,2022/09/09 23:00:00+00,Sat 10 Sep 2022,94,135,0,3860169,3814505,241178,4101347,4055683,85.471100562486,84.5194736125875,511
-7.6926,53.28823,2022/09/10 23:00:00+00,Sun 11 Sep 2022,58,58,0,3860227,3814563,241178,4101405,4055741,85.4723092687556,84.5206823188571,512
-7.6926,53.28823,2022/09/11 23:00:00+00,Mon 12 Sep 2022,13,13,0,3860240,3814576,241178,4101418,4055754,85.4725801856781,84.5209532357796,513
-7.6926,53.28823,2022/09/12 23:00:00+00,Tue 13 Sep 2022,29,25,0,3860269,3814601,241178,4101447,4055779,85.4731845388129,84.5214742298613,514
-7.6926,53.28823,2022/09/13 23:00:00+00,Wed 14 Sep 2022,36,33,0,3860305,3814634,241178,4101483,4055812,85.4739347702906,84.5221619420492,515
-7.6926,53.28823,2022/09/14 23:00:00+00,Thu 15 Sep 2022,51,36,0,3860356,3814670,241178,4101534,4055848,85.4749975982173,84.5229121735269,516
-7.6926,53.28823,2022/09/15 23:00:00+00,Fri 16 Sep 2022,38,56,0,3860394,3814726,241178,4101572,4055904,85.4757895092215,84.5240792002699,517
-7.6926,53.28823,2022/09/16 23:00:00+00,Sat 17 Sep 2022,66,149,0,3860460,3814875,241178,4101638,4056053,85.4771649335972,84.5271843249969,518
-7.6926,53.28823,2022/09/17 23:00:00+00,Sun 18 Sep 2022,30,53,0,3860490,3814928,241178,4101668,4056106,85.4777901264953,84.5282888324502,519
-7.6926,53.28823,2022/09/18 23:00:00+00,Mon 19 Sep 2022,11,11,0,3860501,3814939,241178,4101679,4056117,85.4780193638912,84.5285180698461,520
-7.6926,53.28823,2022/09/19 23:00:00+00,Tue 20 Sep 2022,39,37,0,3860540,3814976,241178,4101718,4056154,85.4788321146587,84.5292891410871,521
-7.6926,53.28823,2022/09/20 23:00:00+00,Wed 21 Sep 2022,42,32,0,3860582,3815008,241178,4101760,4056186,85.479707384716,84.5299560135117,522
-7.6926,53.28823,2022/09/21 23:00:00+00,Thu 22 Sep 2022,61,34,0,3860643,3815042,241178,4101821,4056220,85.4809786102754,84.5306645654628,523
-7.6926,53.28823,2022/09/22 23:00:00+00,Fri 23 Sep 2022,38,39,0,3860681,3815081,241178,4101859,4056259,85.4817705212796,84.5314773162303,524
-7.6926,53.28823,2022/09/23 23:00:00+00,Sat 24 Sep 2022,56,104,0,3860737,3815185,241178,4101915,4056363,85.4829375480226,84.5336446516102,525
-7.6926,53.28823,2022/09/24 23:00:00+00,Sun 25 Sep 2022,42,75,0,3860779,3815260,241178,4101957,4056438,85.4838128180799,84.5352076338554,526
-7.6926,53.28823,2022/09/25 23:00:00+00,Mon 26 Sep 2022,24,10,0,3860803,3815270,241178,4101981,4056448,85.4843129723984,84.5354160314881,527
-7.6926,53.28823,2022/09/26 23:00:00+00,Tue 27 Sep 2022,30,33,2,3860833,3815303,241180,4102013,4056483,85.4849798448229,84.5361454232024,528
-7.6926,53.28823,2022/09/27 23:00:00+00,Wed 28 Sep 2022,43,28,0,3860876,3815331,241180,4102056,4056511,85.4858759546435,84.536728936574,529
-7.6926,53.28823,2022/09/28 23:00:00+00,Thu 29 Sep 2022,31,23,0,3860907,3815354,241180,4102087,4056534,85.4865219873048,84.5372082511291,530
-7.6926,53.28823,2022/09/29 23:00:00+00,Fri 30 Sep 2022,39,58,0,3860946,3815412,241180,4102126,4056592,85.4873347380723,84.5384169573987,531
-7.6926,53.28823,2022/09/30 23:00:00+00,Sat 01 Oct 2022,53,105,0,3860999,3815517,241180,4102179,4056697,85.4884392455256,84.5406051325419,532
-7.6926,53.28823,2022/10/01 23:00:00+00,Sun 02 Oct 2022,26,47,0,3861025,3815564,241180,4102205,4056744,85.4889810793705,84.5415846014156,533
-7.6926,53.28823,2022/10/02 23:00:00+00,Mon 03 Oct 2022,22,1,0,3861047,3815565,241180,4102227,4056745,85.4894395541624,84.5416054411788,534
-7.6926,53.28823,2022/10/03 23:00:00+00,Tue 04 Oct 2022,29,17,0,3861076,3815582,241180,4102256,4056762,85.4900439072972,84.5419597171544,535
-7.6926,53.28823,2022/10/04 23:00:00+00,Wed 05 Oct 2022,50,37,0,3861126,3815619,241180,4102306,4056799,85.4910858954607,84.5427307883953,536
-7.6926,53.28823,2022/10/05 23:00:00+00,Thu 06 Oct 2022,56,27,0,3861182,3815646,241180,4102362,4056826,85.4922529222037,84.5432934620036,537
-7.6926,53.28823,2022/10/06 23:00:00+00,Fri 07 Oct 2022,80,40,0,3861262,3815686,241180,4102442,4056866,85.4939201032652,84.5441270525343,538
-7.6926,53.28823,2022/10/07 23:00:00+00,Sat 08 Oct 2022,100,102,0,3861362,3815788,241180,4102542,4056968,85.4960040795921,84.5462527083877,539
-7.6926,53.28823,2022/10/08 23:00:00+00,Sun 09 Oct 2022,37,29,0,3861399,3815817,241180,4102579,4056997,85.496775150833,84.5468570615225,540
-7.6926,53.28823,2022/10/09 23:00:00+00,Mon 10 Oct 2022,19,3,0,3861418,3815820,241180,4102598,4057000,85.4971711063351,84.5469195808123,541
-7.6926,53.28823,2022/10/10 23:00:00+00,Tue 11 Oct 2022,76,16,0,3861494,3815836,241180,4102674,4057016,85.4987549283435,84.5472530170246,542
-7.6926,53.28823,2022/10/11 23:00:00+00,Wed 12 Oct 2022,56,36,0,3861550,3815872,241180,4102730,4057052,85.4999219550865,84.5480032485023,543
-7.6926,53.28823,2022/10/12 23:00:00+00,Thu 13 Oct 2022,80,29,0,3861630,3815901,241180,4102810,4057081,85.5015891361481,84.5486076016371,544
-7.6926,53.28823,2022/10/13 23:00:00+00,Fri 14 Oct 2022,120,21,0,3861750,3815922,241180,4102930,4057102,85.5040899077403,84.5490452366657,545
-7.6926,53.28823,2022/10/14 23:00:00+00,Sat 15 Oct 2022,98,120,0,3861848,3816042,241180,4103028,4057222,85.5061322045406,84.551546008258,546
-7.6926,53.28823,2022/10/15 23:00:00+00,Sun 16 Oct 2022,26,37,1,3861874,3816079,241181,4103055,4057260,85.5066948781489,84.5523379192622,547
-7.6926,53.28823,2022/10/16 23:00:00+00,Mon 17 Oct 2022,51,3,0,3861925,3816082,241181,4103106,4057263,85.5077577060756,84.552400438552,548
-7.6926,53.28823,2022/10/17 23:00:00+00,Tue 18 Oct 2022,117,17,0,3862042,3816099,241181,4103223,4057280,85.510195958378,84.5527547145275,549
-7.6926,53.28823,2022/10/18 23:00:00+00,Wed 19 Oct 2022,87,40,0,3862129,3816139,241181,4103310,4057320,85.5120090177824,84.5535883050583,550
-7.6926,53.28823,2021/04/16 23:00:00+00,Sat 17 Apr 2021,15863,4569,3,901589,380111,278,901867,380389,18.7946947797852,7.92721670998906,551
-7.6926,53.28823,2021/04/17 23:00:00+00,Sun 18 Apr 2021,1081,490,0,902670,380601,278,902948,380879,18.8172225638786,7.93742819399069,552
-7.6926,53.28823,2021/04/18 23:00:00+00,Mon 19 Apr 2021,6772,2271,0,909442,382872,278,909720,383150,18.9583494407337,7.98475529637374,553
-7.6926,53.28823,2021/04/19 23:00:00+00,Tue 20 Apr 2021,15106,7334,1,924548,390206,279,924827,390485,19.2731757444328,8.1376149599491,554
-7.6926,53.28823,2021/04/20 23:00:00+00,Wed 21 Apr 2021,26749,9908,4,951297,400114,283,951580,400397,19.8307019311583,8.34417869346771,555
-7.6926,53.28823,2021/04/21 23:00:00+00,Thu 22 Apr 2021,31647,12199,1,982944,412313,284,983228,412597,20.4902387590838,8.59842380534494,556
-7.6926,53.28823,2021/04/22 23:00:00+00,Fri 23 Apr 2021,33627,12367,3,1016571,424680,287,1016858,424967,21.1910799978077,8.85621167697784,557
-7.6926,53.28823,2021/04/23 23:00:00+00,Sat 24 Apr 2021,23713,7014,2,1040284,431694,289,1040573,431983,21.6852949837231,9.00242345607051,558
-7.6926,53.28823,2021/04/24 23:00:00+00,Sun 25 Apr 2021,9759,312,3,1050043,432006,292,1050335,432298,21.8887327527514,9.00898798150013,559
-7.6926,53.28823,2021/04/25 23:00:00+00,Mon 26 Apr 2021,15607,3064,4,1065650,435070,296,1065946,435366,22.2140622971379,9.07292437520827,560
-7.6926,53.28823,2021/04/26 23:00:00+00,Tue 27 Apr 2021,25935,7827,9,1091585,442897,305,1091890,443202,22.7547291153791,9.23622476018121,561
-7.6926,53.28823,2021/04/27 23:00:00+00,Wed 28 Apr 2021,26061,8631,6,1117646,451528,311,1117957,451839,23.2979592245024,9.41621779553233,562
-7.6926,53.28823,2021/04/28 23:00:00+00,Thu 29 Apr 2021,31707,11339,7,1149353,462867,318,1149671,463185,23.9588714768036,9.65266574957815,563
-7.6926,53.28823,2021/04/29 23:00:00+00,Fri 30 Apr 2021,36120,13547,8,1185473,476414,326,1185799,476740,24.7117704441725,9.93514874068437,564
-7.6926,53.28823,2021/04/30 23:00:00+00,Sat 01 May 2021,16640,6704,21,1202113,483118,347,1202460,483465,25.058981739991,10.0752961486659,565
-7.6926,53.28823,2021/05/01 23:00:00+00,Sun 02 May 2021,12482,915,16,1214595,484033,363,1214958,484396,25.3194371013223,10.094697968269,566
-7.6926,53.28823,2021/05/02 23:00:00+00,Mon 03 May 2021,14283,940,21,1228878,484973,384,1229262,485357,25.6175290751167,10.1147249807701,567
-7.6926,53.28823,2021/05/03 23:00:00+00,Tue 04 May 2021,26682,6811,11,1255560,491784,395,1255955,492179,26.1738048760461,10.2568938457887,568
-7.6926,53.28823,2021/05/04 23:00:00+00,Wed 05 May 2021,32150,13474,70,1287710,505258,465,1288175,505723,26.8452620485612,10.5391475994989,569
-7.6926,53.28823,2021/05/05 23:00:00+00,Thu 06 May 2021,37312,14388,133,1325022,519646,598,1325620,520244,27.6256069841549,10.8417618019226,570
-7.6926,53.28823,2021/05/06 23:00:00+00,Fri 07 May 2021,40615,15103,99,1365637,534749,697,1366334,535446,28.4740771058737,11.1585678831323,571
-7.6926,53.28823,2021/05/07 23:00:00+00,Sat 08 May 2021,25645,7070,10,1391282,541819,707,1391989,542526,29.0087212325303,11.3061134070741,572
-7.6926,53.28823,2021/05/08 23:00:00+00,Sun 09 May 2021,19686,936,5,1410968,542755,712,1411680,543467,29.4190770110528,11.3257236243099,573
-7.6926,53.28823,2021/05/09 23:00:00+00,Mon 10 May 2021,28868,4667,172,1439836,547422,884,1440720,548306,30.0242637363737,11.4265672387668,574
-7.6926,53.28823,2021/05/10 23:00:00+00,Tue 11 May 2021,33931,14826,153,1473767,562248,1037,1474804,563285,30.7345662276215,11.7387260527675,575
-7.6926,53.28823,2021/05/11 23:00:00+00,Wed 12 May 2021,31316,20939,175,1505083,583187,1212,1506295,584399,31.3908312127138,12.1787368144213,576
-7.6926,53.28823,2021/05/12 23:00:00+00,Thu 13 May 2021,36022,25490,153,1541105,608677,1365,1542470,610042,32.1447096489563,12.7131308639186,577
-7.6926,53.28823,2021/05/13 23:00:00+00,Fri 14 May 2021,38246,27960,237,1579351,636637,1602,1580953,638239,32.9466862588228,13.3007496688041,578
-7.6926,53.28823,2021/05/14 23:00:00+00,Sat 15 May 2021,28894,12470,22,1608245,649107,1624,1609869,650731,33.5492888534983,13.5610799915557,579
-7.6926,53.28823,2021/05/15 23:00:00+00,Sun 16 May 2021,23199,1184,11,1631444,650291,1635,1633079,651926,34.0329797589631,13.5859835086617,580
-7.6926,53.28823,2021/05/16 23:00:00+00,Mon 17 May 2021,35408,3967,120,1666852,654258,1755,1668607,656013,34.7733748683708,13.6711556211406,581
-7.6926,53.28823,2021/05/17 23:00:00+00,Tue 18 May 2021,39045,12518,127,1705897,666776,1882,1707779,668658,35.5897100751294,13.9346744276724,582
-7.6926,53.28823,2021/05/18 23:00:00+00,Wed 19 May 2021,37054,17620,212,1742951,684396,2094,1745045,686490,36.366324693098,14.3062890862785,583
-7.6926,53.28823,2021/05/19 23:00:00+00,Thu 20 May 2021,39115,19649,138,1782066,704045,2232,1784298,706277,37.1843479206814,14.7186454820748,584
-7.6926,53.28823,2021/05/20 23:00:00+00,Fri 21 May 2021,25861,23271,14936,1807927,727316,17168,1825095,744484,38.0345477427515,15.5148703172791,585
-7.6926,53.28823,2021/05/21 23:00:00+00,Sat 22 May 2021,16613,10263,13524,1824540,737579,30692,1855232,768271,38.662595688378,16.0105857661499,586
-7.6926,53.28823,2021/05/22 23:00:00+00,Sun 23 May 2021,8237,5544,10205,1832777,743123,40897,1873674,784020,39.046922602578,16.3387911978675,587
-7.6926,53.28823,2021/05/23 23:00:00+00,Mon 24 May 2021,22572,8251,8453,1855349,751374,49350,1904699,800724,39.6934762579871,16.6868986035066,588
-7.6926,53.28823,2021/05/24 23:00:00+00,Tue 25 May 2021,30385,16530,3225,1885734,767904,52575,1938309,820479,40.3939007014456,17.0985881268783,589
-7.6926,53.28823,2021/05/25 23:00:00+00,Wed 26 May 2021,20002,25492,3055,1905736,793396,55630,1961366,849026,40.8744031231303,17.6935008489078,590
-7.6926,53.28823,2021/05/26 23:00:00+00,Thu 27 May 2021,17041,36069,550,1922777,829465,56180,1978957,885645,41.2409953987887,18.4566321400415,591
-7.6926,53.28823,2021/05/27 23:00:00+00,Fri 28 May 2021,27067,31851,1562,1949844,861316,57742,2007586,919058,41.8376169814061,19.1529511501361,592
-7.6926,53.28823,2021/05/28 23:00:00+00,Sat 29 May 2021,24510,7407,538,1974354,868723,58280,2032634,927003,42.3596113717587,19.3185230693053,593
-7.6926,53.28823,2021/05/29 23:00:00+00,Sun 30 May 2021,24274,1695,210,1998628,870418,58490,2057118,928908,42.8698521356277,19.3582228183321,594
-7.6926,53.28823,2021/05/30 23:00:00+00,Mon 31 May 2021,22618,7323,3445,2021246,877741,61935,2083181,939676,43.4129988856979,19.5826253892086,595
-7.6926,53.28823,2021/05/31 23:00:00+00,Tue 01 Jun 2021,27636,11542,3657,2048882,889283,65592,2114474,954875,44.0651375976629,19.8993689511285,596
-7.6926,53.28823,2021/06/01 23:00:00+00,Wed 02 Jun 2021,18733,20925,4009,2067615,910208,69601,2137216,979809,44.539075493918,20.4189876084684,597
-7.6926,53.28823,2021/06/02 23:00:00+00,Thu 03 Jun 2021,16720,30719,1978,2084335,940927,71579,2155914,1012506,44.9287373875148,21.1003853480626,598
-7.6926,53.28823,2021/06/03 23:00:00+00,Fri 04 Jun 2021,29024,23358,155,2113359,964285,71734,2185093,1036019,45.53682083993,21.5903907017978,599
-7.6926,53.28823,2021/06/04 23:00:00+00,Sat 05 Jun 2021,20985,11512,36,2134344,975797,71770,2206114,1047567,45.9748935035998,21.8310482880239,600
-7.6926,53.28823,2021/06/05 23:00:00+00,Sun 06 Jun 2021,19970,3926,47,2154314,979723,71817,2226131,1051540,46.3920430449478,21.9138446674901,601
-7.6926,53.28823,2021/06/06 23:00:00+00,Mon 07 Jun 2021,19856,4614,47,2174170,984337,71864,2246034,1056201,46.8068168532833,22.0109788040852,602
-7.6926,53.28823,2021/06/07 23:00:00+00,Tue 08 Jun 2021,26441,18356,48,2200611,1002693,71912,2272523,1074605,47.3588413425059,22.394513807281,603
-7.6926,53.28823,2021/06/08 23:00:00+00,Wed 09 Jun 2021,32844,20140,177,2233455,1022833,72089,2305544,1094922,48.0469911653992,22.8179152776096,604
-7.6926,53.28823,2021/06/09 23:00:00+00,Thu 10 Jun 2021,27727,27515,273,2261182,1050348,72362,2333544,1122710,48.6305045369207,23.3970106193182,605
-7.6926,53.28823,2021/06/10 23:00:00+00,Fri 11 Jun 2021,26476,32919,44,2287658,1083267,72406,2360064,1155673,49.1831750588046,24.0839517359419,606
-7.6926,53.28823,2021/06/11 23:00:00+00,Sat 12 Jun 2021,12239,19739,105,2299897,1103006,72511,2372408,1175517,49.4404210965925,24.4974959982445,607
-7.6926,53.28823,2021/06/12 23:00:00+00,Sun 13 Jun 2021,8566,18186,835,2308463,1121192,73346,2381809,1194538,49.6363357110809,24.893889135377,608
-7.6926,53.28823,2021/06/13 23:00:00+00,Mon 14 Jun 2021,16046,31324,55,2324509,1152516,73401,2397910,1225917,49.971876739469,25.5478200669832,609
-7.6926,53.28823,2021/06/14 23:00:00+00,Tue 15 Jun 2021,14733,41606,206,2339242,1194122,73607,2412849,1267729,50.283201962939,26.4191722487709,610
-7.6926,53.28823,2021/06/15 23:00:00+00,Wed 16 Jun 2021,13502,48413,220,2352744,1242535,73827,2426571,1316362,50.5691651945111,27.432672455814,611
-7.6926,53.28823,2021/06/16 23:00:00+00,Thu 17 Jun 2021,21602,42711,535,2374346,1285246,74362,2448708,1359608,51.0304950339886,28.3339088581289,612
-7.6926,53.28823,2021/06/17 23:00:00+00,Fri 18 Jun 2021,12035,50044,555,2386381,1335290,74917,2461298,1410207,51.2928676535406,29.3883800397581,613
-7.6926,53.28823,2021/06/18 23:00:00+00,Sat 19 Jun 2021,6345,32827,434,2392726,1368117,75351,2468077,1443468,51.4341404087386,30.0815314058358,614
-7.6926,53.28823,2021/06/19 23:00:00+00,Sun 20 Jun 2021,8535,26157,178,2401261,1394274,75529,2476790,1469803,51.6157172660982,30.6303465715151,615
-7.6926,53.28823,2021/06/20 23:00:00+00,Mon 21 Jun 2021,15509,32363,575,2416770,1426637,76104,2492874,1502741,51.9509040185107,31.3167666940571,616
-7.6926,53.28823,2021/06/21 23:00:00+00,Tue 22 Jun 2021,15166,43580,723,2431936,1470217,76827,2508763,1547044,52.2820270170859,32.240030726147,617
-7.6926,53.28823,2021/06/22 23:00:00+00,Wed 23 Jun 2021,20111,39417,886,2452047,1509634,77713,2529760,1587347,52.7195995264372,33.0799357051624,618
-7.6926,53.28823,2021/06/23 23:00:00+00,Thu 24 Jun 2021,19050,44288,1033,2471097,1553922,78746,2549843,1632668,53.138124492161,34.0244146162597,619
-7.6926,53.28823,2021/06/24 23:00:00+00,Fri 25 Jun 2021,15235,50145,844,2486332,1604067,79590,2565922,1683657,53.4732070457572,35.0870133055637,620
-7.6926,53.28823,2021/06/25 23:00:00+00,Sat 26 Jun 2021,9091,30595,513,2495423,1634662,80103,2575526,1714765,53.6733521321891,35.735296661324,621
-7.6926,53.28823,2021/06/26 23:00:00+00,Sun 27 Jun 2021,8748,30495,59,2504171,1665157,80162,2584333,1745319,53.8568879272959,36.3720347882336,622
-7.6926,53.28823,2021/06/27 23:00:00+00,Mon 28 Jun 2021,24258,24683,528,2528429,1689840,80690,2609119,1770530,54.3734222996721,36.8974260599989,623
-7.6926,53.28823,2021/06/28 23:00:00+00,Tue 29 Jun 2021,28167,31072,812,2556596,1720912,81502,2638098,1802414,54.9773377994335,37.5618810720558,624
-7.6926,53.28823,2021/06/29 23:00:00+00,Wed 30 Jun 2021,22609,36901,593,2579205,1757813,82095,2661300,1839908,55.4608619867922,38.3432471560496,625
-7.6926,53.28823,2021/06/30 23:00:00+00,Thu 01 Jul 2021,15071,48335,644,2594276,1806148,82739,2677015,1888887,55.7883588665586,39.3639579211836,626
-7.6926,53.28823,2021/07/01 23:00:00+00,Fri 02 Jul 2021,13711,47299,819,2607987,1853447,83558,2691545,1937005,56.0911606268517,40.3667256501433,627
-7.6926,53.28823,2021/07/02 23:00:00+00,Sat 03 Jul 2021,9334,30503,506,2617321,1883950,84064,2701385,1968014,56.296223897415,41.0129458693401,628
-7.6926,53.28823,2021/07/03 23:00:00+00,Sun 04 Jul 2021,6466,27796,233,2623787,1911746,84297,2708084,1996043,56.4358294715515,41.5970635939964,629
-7.6926,53.28823,2021/07/04 23:00:00+00,Mon 05 Jul 2021,15649,33491,5344,2639436,1945237,89641,2729077,2034878,56.8733186218498,42.4063758005335,630
-7.6926,53.28823,2021/07/05 23:00:00+00,Tue 06 Jul 2021,12420,48321,5490,2651856,1993558,95131,2746987,2088689,57.2465587819909,43.5277843017814,631
-7.6926,53.28823,2021/07/06 23:00:00+00,Wed 07 Jul 2021,19727,43783,5060,2671583,2037341,100191,2771774,2137532,57.7631139941303,44.5456608591109,632
-7.6926,53.28823,2021/07/07 23:00:00+00,Thu 08 Jul 2021,17808,45631,6003,2689391,2082972,106194,2795585,2189166,58.2593295973195,45.6217011957231,633
-7.6926,53.28823,2021/07/08 23:00:00+00,Fri 09 Jul 2021,13537,45120,6533,2702928,2128092,112727,2815655,2240819,58.6775836461208,46.6981374878374,634
-7.6926,53.28823,2021/07/09 23:00:00+00,Sat 10 Jul 2021,8662,23898,4365,2711590,2151990,117092,2828682,2269082,58.9490632422212,47.2871317170985,635
-7.6926,53.28823,2021/07/10 23:00:00+00,Sun 11 Jul 2021,15248,16135,2153,2726838,2168125,119245,2846083,2287370,59.3116959628585,47.6682493077552,636
-7.6926,53.28823,2021/07/11 23:00:00+00,Mon 12 Jul 2021,17137,31788,6095,2743975,2199913,125340,2869315,2325253,59.7958453431152,48.4577220596605,637
-7.6926,53.28823,2021/07/12 23:00:00+00,Tue 13 Jul 2021,20126,36597,8490,2764101,2236510,133830,2897931,2370340,60.3921960088102,49.397324466153,638
-7.6926,53.28823,2021/07/13 23:00:00+00,Wed 14 Jul 2021,20809,35743,9335,2784910,2272253,143165,2928075,2415418,61.0203898327797,50.3367393147761,639
-7.6926,53.28823,2021/07/14 23:00:00+00,Thu 15 Jul 2021,23676,28868,9587,2808586,2301121,152752,2961338,2453873,61.7135828783839,51.1381324112711,640
-7.6926,53.28823,2021/07/15 23:00:00+00,Fri 16 Jul 2021,23533,27454,9169,2832119,2328575,161921,2994040,2490496,62.3950848167945,51.9013470614579,641
-7.6926,53.28823,2021/07/16 23:00:00+00,Sat 17 Jul 2021,11523,19453,4678,2843642,2348028,166599,3010241,2514627,62.7327098215095,52.4042313888931,642
-7.6926,53.28823,2021/07/17 23:00:00+00,Sun 18 Jul 2021,16876,15842,1933,2860518,2363870,168532,3029050,2532402,63.1246849288291,52.7746581809929,643
-7.6926,53.28823,2021/07/18 23:00:00+00,Mon 19 Jul 2021,24924,18471,6253,2885442,2382341,174785,3060227,2557126,63.774406228255,53.2899004880464,644
-7.6926,53.28823,2021/07/19 23:00:00+00,Tue 20 Jul 2021,30614,18204,7700,2916056,2400545,182485,3098541,2583030,64.5728609181291,53.8297337157569,645
-7.6926,53.28823,2021/07/20 23:00:00+00,Wed 21 Jul 2021,30385,19865,6895,2946441,2420410,189380,3135821,2609790,65.3497672927835,54.3874057808253,646
-7.6926,53.28823,2021/07/21 23:00:00+00,Thu 22 Jul 2021,33558,15952,6938,2979999,2436362,196318,3176317,2632680,66.1936943461097,54.8644279620441,647
-7.6926,53.28823,2021/07/22 23:00:00+00,Fri 23 Jul 2021,27103,20868,5616,3007102,2457230,201934,3209036,2659164,66.8755505604959,55.4163482524504,648
-7.6926,53.28823,2021/07/23 23:00:00+00,Sat 24 Jul 2021,15453,14831,2277,3022555,2472061,204211,3226766,2676272,67.2450395632486,55.77287492245,649
-7.6926,53.28823,2021/07/24 23:00:00+00,Sun 25 Jul 2021,14746,13658,1046,3037301,2485719,205257,3242558,2690976,67.5741411047867,56.0793028015519,650
-7.6926,53.28823,2021/07/25 23:00:00+00,Mon 26 Jul 2021,23866,18335,3422,3061167,2504054,208679,3269846,2712733,68.142816564861,56.5327135309874,651
-7.6926,53.28823,2021/07/26 23:00:00+00,Tue 27 Jul 2021,25540,23934,3672,3086707,2527988,212351,3299058,2740339,68.751587729464,57.108016035781,652
-7.6926,53.28823,2021/07/27 23:00:00+00,Wed 28 Jul 2021,23458,25319,3265,3110165,2553307,215616,3325781,2768923,69.3084887232915,57.7036998290514,653
-7.6926,53.28823,2021/07/28 23:00:00+00,Thu 29 Jul 2021,19304,27893,2966,3129469,2581200,218582,3348051,2799782,69.7725902512838,58.3467940837579,654
-7.6926,53.28823,2021/07/29 23:00:00+00,Fri 30 Jul 2021,21976,22973,2125,3151445,2604173,220707,3372152,2824880,70.2748493858209,58.8698304622739,655
-7.6926,53.28823,2021/07/30 23:00:00+00,Sat 31 Jul 2021,13764,12511,907,3165209,2616684,221614,3386823,2838298,70.5805895527349,59.1494584058123,656
-7.6926,53.28823,2021/07/31 23:00:00+00,Sun 01 Aug 2021,11162,9363,369,3176371,2626047,221983,3398354,2848030,70.8208928629854,59.3522709819426,657
-7.6926,53.28823,2021/08/01 23:00:00+00,Mon 02 Aug 2021,15044,16066,431,3191415,2642113,222414,3413829,2864527,71.1433881995674,59.6960645565851,658
-7.6926,53.28823,2021/08/02 23:00:00+00,Tue 03 Aug 2021,17366,25471,1111,3208781,2667584,223525,3432306,2891109,71.5284445054818,60.2500271437917,659
-7.6926,53.28823,2021/08/03 23:00:00+00,Wed 04 Aug 2021,22143,17339,1576,3230924,2684923,225101,3456025,2910024,72.0227428504503,60.6442112660177,660
-7.6926,53.28823,2022/10/19 23:00:00+00,Thu 20 Oct 2022,97,10,0,3862226,3816149,241181,4103407,4057330,85.5140304748194,84.553796702691,661
-7.6926,53.28823,2022/10/20 23:00:00+00,Fri 21 Oct 2022,124,21,0,3862350,3816170,241181,4103531,4057351,85.5166146054647,84.5542343377196,662
-7.6926,53.28823,2022/10/21 23:00:00+00,Sat 22 Oct 2022,95,58,0,3862445,3816228,241181,4103626,4057409,85.5185943829752,84.5554430439892,663
-7.6926,53.28823,2022/10/22 23:00:00+00,Sun 23 Oct 2022,80,48,0,3862525,3816276,241181,4103706,4057457,85.5202615640367,84.5564433526261,664
-7.6926,53.28823,2022/10/23 23:00:00+00,Mon 24 Oct 2022,65,4,0,3862590,3816280,241181,4103771,4057461,85.5216161486492,84.5565267116792,665
-7.6926,53.28823,2022/10/24 23:00:00+00,Tue 25 Oct 2022,75,28,0,3862665,3816308,241181,4103846,4057489,85.5231791308943,84.5571102250507,666
-7.6926,53.28823,2022/10/25 23:00:00+00,Wed 26 Oct 2022,45,25,0,3862710,3816333,241181,4103891,4057514,85.5241169202414,84.5576312191324,667
-7.6926,53.28823,2022/10/26 23:00:00+00,Thu 27 Oct 2022,64,35,0,3862774,3816368,241181,4103955,4057549,85.5254506650906,84.5583606108468,668
-7.6926,53.28823,2022/10/27 23:00:00+00,Fri 28 Oct 2022,50,19,0,3862824,3816387,241181,4104005,4057568,85.5264926532541,84.5587565663489,669
-7.6926,53.28823,2022/10/28 23:00:00+00,Sat 29 Oct 2022,87,64,0,3862911,3816451,241181,4104092,4057632,85.5283057126584,84.5600903111981,670
-7.6926,53.28823,2022/10/29 23:00:00+00,Sun 30 Oct 2022,11,6,0,3862922,3816457,241181,4104103,4057638,85.5285349500544,84.5602153497777,671
-7.6926,53.28823,2022/11/01 00:00:00+00,Tue 01 Nov 2022,96,25,0,3863018,3816482,241181,4104199,4057663,85.5305355673282,84.5607363438594,672
-7.6926,53.28823,2022/11/02 00:00:00+00,Wed 02 Nov 2022,107,13,0,3863125,3816495,241181,4104306,4057676,85.5327654219979,84.5610072607819,673
-7.6926,53.28823,2022/11/03 00:00:00+00,Thu 03 Nov 2022,91,28,0,3863216,3816523,241181,4104397,4057704,85.5346618404554,84.5615907741534,674
-7.6926,53.28823,2022/11/04 00:00:00+00,Fri 04 Nov 2022,61,22,0,3863277,3816545,241181,4104458,4057726,85.5359330660147,84.5620492489453,675
-7.6926,53.28823,2022/11/05 00:00:00+00,Sat 05 Nov 2022,46,54,0,3863323,3816599,241181,4104504,4057780,85.5368916951251,84.5631745961619,676
-7.6926,53.28823,2022/11/06 00:00:00+00,Sun 06 Nov 2022,56,78,0,3863379,3816677,241181,4104560,4057858,85.5380587218681,84.5648000976968,677
-7.6926,53.28823,2022/11/07 00:00:00+00,Mon 07 Nov 2022,43,3,0,3863422,3816680,241181,4104603,4057861,85.5389548316887,84.5648626169866,678
-7.6926,53.28823,2022/11/08 00:00:00+00,Tue 08 Nov 2022,66,32,0,3863488,3816712,241181,4104669,4057893,85.5403302560644,84.5655294894112,679
-7.6926,53.28823,2022/11/09 00:00:00+00,Wed 09 Nov 2022,92,32,0,3863580,3816744,241181,4104761,4057925,85.5422475142851,84.5661963618358,680
-7.6926,53.28823,2022/11/10 00:00:00+00,Thu 10 Nov 2022,48,15,0,3863628,3816759,241181,4104809,4057940,85.543247822922,84.5665089582848,681
-7.6926,53.28823,2022/11/11 00:00:00+00,Fri 11 Nov 2022,49,17,0,3863677,3816776,241181,4104858,4057957,85.5442689713222,84.5668632342604,682
-7.6926,53.28823,2022/11/12 00:00:00+00,Sat 12 Nov 2022,74,87,0,3863751,3816863,241181,4104932,4058044,85.5458111138041,84.5686762936648,683
-7.6926,53.28823,2022/11/13 00:00:00+00,Sun 13 Nov 2022,42,62,1,3863793,3816925,241182,4104975,4058107,85.5467072236246,84.5699891987507,684
-7.6926,53.28823,2022/11/14 00:00:00+00,Mon 14 Nov 2022,15,2,0,3863808,3816927,241182,4104990,4058109,85.5470198200737,84.5700308782772,685
-7.6926,53.28823,2022/11/15 00:00:00+00,Tue 15 Nov 2022,57,8,0,3863865,3816935,241182,4105047,4058117,85.54820768658,84.5701975963834,686
-7.6926,53.28823,2022/11/16 00:00:00+00,Wed 16 Nov 2022,46,20,0,3863911,3816955,241182,4105093,4058137,85.5491663156903,84.5706143916488,687
-7.6926,53.28823,2022/11/17 00:00:00+00,Thu 17 Nov 2022,64,9,1,3863975,3816964,241183,4105158,4058147,85.5505209003028,84.5708227892814,688
-7.6926,53.28823,2022/11/18 00:00:00+00,Fri 18 Nov 2022,28,22,0,3864003,3816986,241183,4105186,4058169,85.5511044136743,84.5712812640733,689
-7.6926,53.28823,2022/11/19 00:00:00+00,Sat 19 Nov 2022,55,57,0,3864058,3817043,241183,4105241,4058226,85.5522506006541,84.5724691305797,690
-7.6926,53.28823,2022/11/20 00:00:00+00,Sun 20 Nov 2022,40,56,0,3864098,3817099,241183,4105281,4058282,85.5530841911848,84.5736361573227,691
-7.6926,53.28823,2022/11/21 00:00:00+00,Mon 21 Nov 2022,17,3,0,3864115,3817102,241183,4105298,4058285,85.5534384671604,84.5736986766125,692
-7.6926,53.28823,2022/11/22 00:00:00+00,Tue 22 Nov 2022,48,22,0,3864163,3817124,241183,4105346,4058307,85.5544387757973,84.5741571514044,693
-7.6926,53.28823,2022/11/23 00:00:00+00,Wed 23 Nov 2022,23,16,0,3864186,3817140,241183,4105369,4058323,85.5549180903525,84.5744905876167,694
-7.6926,53.28823,2022/11/24 00:00:00+00,Thu 24 Nov 2022,25,18,0,3864211,3817158,241183,4105394,4058341,85.5554390844342,84.5748657033556,695
-7.6926,53.28823,2022/11/25 00:00:00+00,Fri 25 Nov 2022,18,11,0,3864229,3817169,241183,4105412,4058352,85.555814200173,84.5750949407515,696
-7.6926,53.28823,2022/11/26 00:00:00+00,Sat 26 Nov 2022,65,63,0,3864294,3817232,241183,4105477,4058415,85.5571687847855,84.5764078458374,697
-7.6926,53.28823,2022/11/27 00:00:00+00,Sun 27 Nov 2022,36,42,0,3864330,3817274,241183,4105513,4058457,85.5579190162631,84.5772831158947,698
-7.6926,53.28823,2022/11/28 00:00:00+00,Mon 28 Nov 2022,16,1,0,3864346,3817275,241183,4105529,4058458,85.5582524524754,84.577303955658,699
-7.6926,53.28823,2022/11/29 00:00:00+00,Tue 29 Nov 2022,32,18,0,3864378,3817293,241183,4105561,4058476,85.5589193249,84.5776790713968,700
-7.6926,53.28823,2022/11/30 00:00:00+00,Wed 30 Nov 2022,46,13,0,3864424,3817306,241183,4105607,4058489,85.5598779540104,84.5779499883193,701
-7.6926,53.28823,2022/12/01 00:00:00+00,Thu 01 Dec 2022,20,11,0,3864444,3817317,241183,4105627,4058500,85.5602947492758,84.5781792257153,702
-7.6926,53.28823,2022/12/02 00:00:00+00,Fri 02 Dec 2022,17,18,0,3864461,3817335,241183,4105644,4058518,85.5606490252513,84.5785543414541,703
-7.6926,53.28823,2022/12/03 00:00:00+00,Sat 03 Dec 2022,41,71,0,3864502,3817406,241183,4105685,4058589,85.5615034555453,84.5800339646462,704
-7.6926,53.28823,2022/12/04 00:00:00+00,Sun 04 Dec 2022,44,47,0,3864546,3817453,241183,4105729,4058636,85.5624204051292,84.5810134335198,705
-7.6926,53.28823,2022/12/05 00:00:00+00,Mon 05 Dec 2022,20,5,0,3864566,3817458,241183,4105749,4058641,85.5628372003945,84.5811176323361,706
-7.6926,53.28823,2022/12/06 00:00:00+00,Tue 06 Dec 2022,35,29,0,3864601,3817487,241183,4105784,4058670,85.5635665921089,84.5817219854709,707
-7.6926,53.28823,2022/12/07 00:00:00+00,Wed 07 Dec 2022,21,23,0,3864622,3817510,241183,4105805,4058693,85.5640042271376,84.5822013000261,708
-7.6926,53.28823,2022/12/08 00:00:00+00,Thu 08 Dec 2022,16,13,1,3864638,3817523,241184,4105822,4058707,85.5643585031131,84.5824930567119,709
-7.6926,53.28823,2022/12/09 00:00:00+00,Fri 09 Dec 2022,24,17,0,3864662,3817540,241184,4105846,4058724,85.5648586574316,84.5828473326874,710
-7.6926,53.28823,2022/12/10 00:00:00+00,Sat 10 Dec 2022,49,44,0,3864711,3817584,241184,4105895,4058768,85.5658798058318,84.5837642822713,711
-7.6926,53.28823,2022/12/11 00:00:00+00,Sun 11 Dec 2022,28,42,0,3864739,3817626,241184,4105923,4058810,85.5664633192033,84.5846395523285,712
-7.6926,53.28823,2022/12/12 00:00:00+00,Mon 12 Dec 2022,15,2,0,3864754,3817628,241184,4105938,4058812,85.5667759156523,84.5846812318551,713
-7.6926,53.28823,2022/12/13 00:00:00+00,Tue 13 Dec 2022,29,15,0,3864783,3817643,241184,4105967,4058827,85.5673802687871,84.5849938283041,714
-7.6926,53.28823,2022/12/14 00:00:00+00,Wed 14 Dec 2022,19,20,0,3864802,3817663,241184,4105986,4058847,85.5677762242892,84.5854106235695,715
-7.6926,53.28823,2022/12/15 00:00:00+00,Thu 15 Dec 2022,13,9,0,3864815,3817672,241184,4105999,4058856,85.5680471412117,84.5855981814389,716
-7.6926,53.28823,2022/12/16 00:00:00+00,Fri 16 Dec 2022,15,4,0,3864830,3817676,241184,4106014,4058860,85.5683597376607,84.585681540492,717
-7.6926,53.28823,2022/12/17 00:00:00+00,Sat 17 Dec 2022,20,43,0,3864850,3817719,241184,4106034,4058903,85.5687765329261,84.5865776503125,718
-7.6926,53.28823,2022/12/18 00:00:00+00,Sun 18 Dec 2022,29,35,0,3864879,3817754,241184,4106063,4058938,85.5693808860609,84.5873070420269,719
-7.6926,53.28823,2022/12/19 00:00:00+00,Mon 19 Dec 2022,9,1,0,3864888,3817755,241184,4106072,4058939,85.5695684439303,84.5873278817902,720
-7.6926,53.28823,2022/12/20 00:00:00+00,Tue 20 Dec 2022,20,18,0,3864908,3817773,241184,4106092,4058957,85.5699852391957,84.587702997529,721
-7.6926,53.28823,2022/12/21 00:00:00+00,Wed 21 Dec 2022,17,29,0,3864925,3817802,241184,4106109,4058986,85.5703395151712,84.5883073506638,722
-7.6926,53.28823,2022/12/22 00:00:00+00,Thu 22 Dec 2022,7,15,0,3864932,3817817,241184,4106116,4059001,85.5704853935141,84.5886199471128,723
-7.6926,53.28823,2022/12/23 00:00:00+00,Fri 23 Dec 2022,20,6,0,3864952,3817823,241184,4106136,4059007,85.5709021887795,84.5887449856925,724
-7.6926,53.28823,2022/12/28 00:00:00+00,Wed 28 Dec 2022,20,24,0,3864972,3817847,241184,4106156,4059031,85.5713189840449,84.5892451400109,725
-7.6926,53.28823,2022/12/29 00:00:00+00,Thu 29 Dec 2022,18,12,0,3864990,3817859,241184,4106174,4059043,85.5716940997837,84.5894952171701,726
-7.6926,53.28823,2022/12/30 00:00:00+00,Fri 30 Dec 2022,71,31,0,3865061,3817890,241184,4106245,4059074,85.5731737229758,84.5901412498315,727
-7.6926,53.28823,2022/12/31 00:00:00+00,Sat 31 Dec 2022,36,26,0,3865097,3817916,241184,4106281,4059100,85.5739239544534,84.5906830836764,728
-7.6926,53.28823,2023/01/03 00:00:00+00,Tue 03 Jan 2023,16,14,0,3865113,3817930,241184,4106297,4059114,85.5742573906657,84.5909748403622,729
-7.6926,53.28823,2023/01/04 00:00:00+00,Wed 04 Jan 2023,56,28,0,3865169,3817958,241184,4106353,4059142,85.5754244174088,84.5915583537337,730
-7.6926,53.28823,2023/01/05 00:00:00+00,Thu 05 Jan 2023,26,16,0,3865195,3817974,241184,4106379,4059158,85.5759662512538,84.591891789946,731
-7.6926,53.28823,2023/01/06 00:00:00+00,Fri 06 Jan 2023,37,21,0,3865232,3817995,241184,4106416,4059179,85.5767373224947,84.5923294249747,732
-7.6926,53.28823,2023/01/07 00:00:00+00,Sat 07 Jan 2023,138,74,0,3865370,3818069,241184,4106554,4059253,85.5796132098258,84.5938715674565,733
-7.6926,53.28823,2023/01/08 00:00:00+00,Sun 08 Jan 2023,51,45,0,3865421,3818114,241184,4106605,4059298,85.5806760377525,84.5948093568036,734
-7.6926,53.28823,2023/01/09 00:00:00+00,Mon 09 Jan 2023,1,1,0,3865422,3818115,241184,4106606,4059299,85.5806968775157,84.5948301965669,735
-7.6926,53.28823,2023/01/10 00:00:00+00,Tue 10 Jan 2023,43,13,0,3865465,3818128,241184,4106649,4059312,85.5815929873363,84.5951011134894,736
-7.6926,53.28823,2023/01/11 00:00:00+00,Wed 11 Jan 2023,59,31,0,3865524,3818159,241184,4106708,4059343,85.5828225333692,84.5957471461507,737
-7.6926,53.28823,2023/01/12 00:00:00+00,Thu 12 Jan 2023,14,12,0,3865538,3818171,241184,4106722,4059355,85.5831142900549,84.5959972233099,738
-7.6926,53.28823,2023/01/13 00:00:00+00,Fri 13 Jan 2023,30,12,0,3865568,3818183,241184,4106752,4059367,85.583739482953,84.5962473004692,739
-7.6926,53.28823,2023/01/14 00:00:00+00,Sat 14 Jan 2023,72,39,0,3865640,3818222,241184,4106824,4059406,85.5852399459083,84.5970600512366,740
-7.6926,53.28823,2023/01/15 00:00:00+00,Sun 15 Jan 2023,60,30,0,3865700,3818252,241184,4106884,4059436,85.5864903317044,84.5976852441347,741
-7.6926,53.28823,2023/01/16 00:00:00+00,Mon 16 Jan 2023,6,2,0,3865706,3818254,241184,4106890,4059438,85.586615370284,84.5977269236612,742
-7.6926,53.28823,2023/01/17 00:00:00+00,Tue 17 Jan 2023,13,18,0,3865719,3818272,241184,4106903,4059456,85.5868862872065,84.5981020394001,743
-7.6926,53.28823,2023/01/18 00:00:00+00,Wed 18 Jan 2023,35,14,0,3865754,3818286,241184,4106938,4059470,85.5876156789209,84.5983937960858,744
-7.6926,53.28823,2023/01/19 00:00:00+00,Thu 19 Jan 2023,23,7,0,3865777,3818293,241184,4106961,4059477,85.5880949934761,84.5985396744287,745
-7.6926,53.28823,2023/01/20 00:00:00+00,Fri 20 Jan 2023,20,8,0,3865797,3818301,241184,4106981,4059485,85.5885117887415,84.5987063925349,746
-7.6926,53.28823,2023/01/21 00:00:00+00,Sat 21 Jan 2023,75,26,0,3865872,3818327,241184,4107056,4059511,85.5900747709866,84.5992482263799,747
-7.6926,53.28823,2023/01/22 00:00:00+00,Sun 22 Jan 2023,21,13,0,3865893,3818340,241184,4107077,4059524,85.5905124060153,84.5995191433023,748
-7.6926,53.28823,2023/01/23 00:00:00+00,Mon 23 Jan 2023,8,1,0,3865901,3818341,241184,4107085,4059525,85.5906791241214,84.5995399830656,749
-7.6926,53.28823,2023/01/24 00:00:00+00,Tue 24 Jan 2023,17,13,0,3865918,3818354,241184,4107102,4059538,85.591033400097,84.5998108999881,750
-7.6926,53.28823,2023/01/25 00:00:00+00,Wed 25 Jan 2023,21,17,0,3865939,3818371,241184,4107123,4059555,85.5914710351256,84.6001651759637,751
-7.6926,53.28823,2023/01/26 00:00:00+00,Thu 26 Jan 2023,11,12,0,3865950,3818383,241184,4107134,4059567,85.5917002725216,84.6004152531229,752
-7.6926,53.28823,2023/01/27 00:00:00+00,Fri 27 Jan 2023,12,8,0,3865962,3818391,241184,4107146,4059575,85.5919503496808,84.600581971229,753
-7.6926,53.28823,2023/01/28 00:00:00+00,Sat 28 Jan 2023,23,58,0,3865985,3818449,241184,4107169,4059633,85.592429664236,84.6017906774986,754
-7.6926,53.28823,2023/01/29 00:00:00+00,Sun 29 Jan 2023,28,28,0,3866013,3818477,241184,4107197,4059661,85.5930131776075,84.6023741908702,755
-7.6926,53.28823,2023/01/30 00:00:00+00,Mon 30 Jan 2023,4,2,0,3866017,3818479,241184,4107201,4059663,85.5930965366606,84.6024158703967,756
-7.6926,53.28823,2023/01/31 00:00:00+00,Tue 31 Jan 2023,22,15,0,3866039,3818494,241184,4107223,4059678,85.5935550114525,84.6027284668457,757
-7.6926,53.28823,2023/02/01 00:00:00+00,Wed 01 Feb 2023,14,37,0,3866053,3818531,241184,4107237,4059715,85.5938467681382,84.6034995380867,758
-7.6926,53.28823,2023/02/02 00:00:00+00,Thu 02 Feb 2023,13,11,0,3866066,3818542,241184,4107250,4059726,85.5941176850607,84.6037287754826,759
-7.6926,53.28823,2023/02/03 00:00:00+00,Fri 03 Feb 2023,14,10,0,3866080,3818552,241184,4107264,4059736,85.5944094417465,84.6039371731153,760
-7.6926,53.28823,2023/02/04 00:00:00+00,Sat 04 Feb 2023,39,43,0,3866119,3818595,241184,4107303,4059779,85.595222192514,84.6048332829358,761
-7.6926,53.28823,2023/02/05 00:00:00+00,Sun 05 Feb 2023,29,22,0,3866148,3818617,241184,4107332,4059801,85.5958265456488,84.6052917577278,762
-7.6926,53.28823,2023/02/06 00:00:00+00,Mon 06 Feb 2023,12,7,0,3866160,3818624,241184,4107344,4059808,85.596076622808,84.6054376360706,763
-7.6926,53.28823,2023/02/07 00:00:00+00,Tue 07 Feb 2023,20,13,0,3866180,3818637,241184,4107364,4059821,85.5964934180734,84.6057085529931,764
