X,Y,VaccinationDate,VaccineText,Dose1,Dose2,SingleDose,Dose1Cum,Dose2Cum,SingleDoseCum,PartiallyVacc,FullyVacc,PartialPercent,FullyPercent,ObjectId
-7.6926,53.28823,2021/08/10 23:00:00+00,Wed 11 Aug 2021,7007,31239,664,3288234,2836738,229940,3518174,3066678,74.7131765396938,65.1250491886971,1
-7.6926,53.28823,2020/12/28 00:00:00+00,Mon 28 Dec 2020,219,16,0,219,16,0,219,16,0.00465076078164211,0.000339781609617688,2
-7.6926,53.28823,2021/08/11 23:00:00+00,Thu 12 Aug 2021,6766,38287,862,3295000,2875025,230802,3525802,3105827,74.875167422079,65.9564310783798,3
-7.6926,53.28823,2021/12/02 00:00:00+00,Thu 02 Dec 2021,1766,1410,0,3663141,3600231,240723,3903864,3840954,82.9038246030342,81.5678457867187,4
-7.6926,53.28823,2020/12/29 00:00:00+00,Tue 29 Dec 2020,77,2,0,296,18,0,296,18,0.00628595977792723,0.000382254310819899,5
-7.6926,53.28823,2021/08/12 23:00:00+00,Fri 13 Aug 2021,10924,28243,870,3305924,2903268,231672,3537596,3134940,75.1256289410685,66.5746849534297,6
-7.6926,53.28823,2020/12/30 00:00:00+00,Wed 30 Dec 2020,1057,1,0,1353,19,0,1353,19,0.0287327823632958,0.000403490661421005,7
-7.6926,53.28823,2021/12/03 00:00:00+00,Fri 03 Dec 2021,1042,1184,2,3664183,3601415,240725,3904908,3842140,82.9259953530618,81.5930320985316,8
-7.6926,53.28823,2021/08/13 23:00:00+00,Sat 14 Aug 2021,18129,5838,280,3324053,2909106,231952,3556005,3141058,75.5165689192842,66.7046089464073,9
-7.6926,53.28823,2020/12/31 00:00:00+00,Thu 31 Dec 2020,1033,1,0,2386,20,0,2386,20,0.0506699325342378,0.00042472701202211,10
-7.6926,53.28823,2021/12/04 00:00:00+00,Sat 04 Dec 2021,1204,1700,1,3665387,3603115,240726,3906113,3843841,82.9515851555361,81.6291551309041,11
-7.6926,53.28823,2021/08/14 23:00:00+00,Sun 15 Aug 2021,16998,3726,50,3341051,2912832,232002,3573053,3144834,75.8786062243319,66.7847974062771,12
-7.6926,53.28823,2021/01/01 00:00:00+00,Fri 01 Jan 2021,815,0,0,3201,20,0,3201,20,0.0679775582741388,0.00042472701202211,13
-7.6926,53.28823,2021/12/05 00:00:00+00,Sun 05 Dec 2021,1347,1773,2,3666734,3604888,240728,3907462,3845616,82.980232992497,81.666849653221,14
-7.6926,53.28823,2021/08/15 23:00:00+00,Mon 16 Aug 2021,10180,23152,384,3351231,2935984,232386,3583617,3168370,76.102947032082,67.2846161540247,15
-7.6926,53.28823,2021/01/02 00:00:00+00,Sat 02 Jan 2021,1016,0,0,4217,20,0,4217,20,0.089553690484862,0.00042472701202211,16
-7.6926,53.28823,2021/12/06 00:00:00+00,Mon 06 Dec 2021,934,1291,0,3667668,3606179,240728,3908396,3846907,83.0000677439584,81.694265781847,17
-7.6926,53.28823,2021/08/16 23:00:00+00,Tue 17 Aug 2021,12863,26859,528,3364094,2962843,232914,3597008,3195757,76.3873230029814,67.8662160879372,18
-7.6926,53.28823,2021/01/03 00:00:00+00,Sun 03 Jan 2021,20,2,1,4237,22,1,4238,23,0.0899996538474852,0.000488436063825427,19
-7.6926,53.28823,2021/12/07 00:00:00+00,Tue 07 Dec 2021,487,739,2,3668155,3606918,240730,3908885,3847648,83.0104523194024,81.7100019176425,20
-7.6926,53.28823,2021/08/17 23:00:00+00,Wed 18 Aug 2021,15230,25761,658,3379324,2988604,233572,3612896,3222176,76.7247261413317,68.4272592344678,21
-7.6926,53.28823,2021/01/04 00:00:00+00,Mon 04 Jan 2021,1188,3,0,5425,25,1,5426,26,0.115228438361599,0.000552145115628744,22
-7.6926,53.28823,2021/12/08 00:00:00+00,Wed 08 Dec 2021,800,1515,2,3668955,3608433,240732,3909687,3849165,83.0274838725844,81.7422174615043,23
-7.6926,53.28823,2021/08/18 23:00:00+00,Thu 19 Aug 2021,11360,25701,544,3390684,3014305,234116,3624800,3248421,76.9775236588873,68.9846072559938,24
-7.6926,53.28823,2021/01/05 00:00:00+00,Tue 05 Jan 2021,3530,12,0,8955,37,1,8956,38,0.190192755983501,0.00080698132284201,25
-7.6926,53.28823,2021/12/09 00:00:00+00,Thu 09 Dec 2021,798,1208,0,3669753,3609641,240732,3910485,3850373,83.0444304803641,81.7678709730305,26
-7.6926,53.28823,2021/08/19 23:00:00+00,Fri 20 Aug 2021,14840,22248,686,3405524,3036553,234802,3640326,3271355,77.3072392383201,69.4716417206796,27
-7.6926,53.28823,2021/01/06 00:00:00+00,Wed 06 Jan 2021,6777,12,0,15732,49,1,15733,50,0.334111504007193,0.00106181753005528,28
-7.6926,53.28823,2021/12/10 00:00:00+00,Fri 10 Dec 2021,891,1612,1,3670644,3611253,240733,3911377,3851986,83.0633733051003,81.8021252065501,29
-7.6926,53.28823,2022/03/26 00:00:00+00,Sat 26 Mar 2022,874,1848,0,3835131,3775394,240784,4075915,4016178,86.557559960305,85.2889640844468,30
-7.6926,53.28823,2021/08/20 23:00:00+00,Sat 21 Aug 2021,11885,7973,245,3417409,3044526,235047,3652456,3279573,77.5648361711115,69.6461620499194,31
-7.6926,53.28823,2022/03/27 00:00:00+00,Sun 27 Mar 2022,380,802,0,3835511,3776196,240784,4076295,4016980,86.5656297735334,85.3059956376289,32
-7.6926,53.28823,2021/01/07 00:00:00+00,Thu 07 Jan 2021,11725,8,0,27457,57,1,27458,58,0.583107714805155,0.00123170833486412,33
-7.6926,53.28823,2021/12/11 00:00:00+00,Sat 11 Dec 2021,641,841,2,3671285,3612094,240735,3912020,3852829,83.0770282785368,81.8200274501068,34
-7.6926,53.28823,2022/03/27 23:00:00+00,Mon 28 Mar 2022,45,52,1,3835556,3776248,240785,4076341,4017033,86.5666066456611,85.3071211642107,35
-7.6926,53.28823,2021/08/21 23:00:00+00,Sun 22 Aug 2021,8004,12251,161,3425413,3056777,235208,3660621,3291985,77.7382309737695,69.9097476335804,36
-7.6926,53.28823,2021/01/08 00:00:00+00,Fri 08 Jan 2021,12681,5,0,40138,62,1,40139,63,0.852405876777774,0.00133789008786965,37
-7.6926,53.28823,2022/03/28 23:00:00+00,Tue 29 Mar 2022,140,192,3,3835696,3776440,240788,4076484,4017228,86.569643443797,85.3112622525779,38
-7.6926,53.28823,2021/12/12 00:00:00+00,Sun 12 Dec 2021,689,1192,0,3671974,3613286,240735,3912709,3854021,83.091660124101,81.8453411800233,39
-7.6926,53.28823,2021/08/22 23:00:00+00,Mon 23 Aug 2021,10863,15373,289,3436276,3072150,235497,3671773,3307647,77.975058755673,70.2423513566949,40
-7.6926,53.28823,2021/01/09 00:00:00+00,Sat 09 Jan 2021,8075,7,0,48213,69,1,48214,70,1.0238894078817,0.00148654454207739,41
-7.6926,53.28823,2022/03/29 23:00:00+00,Wed 30 Mar 2022,109,135,0,3835805,3776575,240788,4076593,4017363,86.5719582060126,85.3141291599091,42
-7.6926,53.28823,2021/12/13 00:00:00+00,Mon 13 Dec 2021,726,1066,1,3672700,3614352,240736,3913436,3855088,83.107098950988,81.8680003661147,43
-7.6926,53.28823,2021/08/23 23:00:00+00,Tue 24 Aug 2021,9708,22918,383,3445984,3095068,235880,3681864,3330948,78.1893547695888,70.7371795620512,44
-7.6926,53.28823,2021/01/10 00:00:00+00,Sun 10 Jan 2021,4781,4,1,52994,73,2,52996,75,1.12544163645619,0.00159272629508291,45
-7.6926,53.28823,2022/03/30 23:00:00+00,Thu 31 Mar 2022,227,358,0,3836032,3776933,240788,4076820,4017721,86.576778857599,85.3217317734243,46
-7.6926,53.28823,2021/12/14 00:00:00+00,Tue 14 Dec 2021,629,1202,2,3673329,3615554,240738,3914067,3856292,83.1204990882173,81.8935689322384,47
-7.6926,53.28823,2021/08/24 23:00:00+00,Wed 25 Aug 2021,9414,19519,314,3455398,3114587,236194,3691592,3350781,78.3959419882363,71.158360103523,48
-7.6926,53.28823,2021/01/11 00:00:00+00,Mon 11 Jan 2021,8343,6,0,61337,79,2,61339,81,1.30261650952121,0.00172014439868955,49
-7.6926,53.28823,2022/03/31 23:00:00+00,Fri 01 Apr 2022,308,903,0,3836340,3777836,240788,4077128,4018624,86.5833196535842,85.3409081980171,50
-7.6926,53.28823,2021/12/15 00:00:00+00,Wed 15 Dec 2021,796,1253,1,3674125,3616807,240739,3914864,3857546,83.1374244596464,81.9201993158922,51
-7.6926,53.28823,2021/08/25 23:00:00+00,Thu 26 Aug 2021,8582,19432,368,3463980,3134019,236562,3700542,3370581,78.5860073261162,71.5788398454249,52
-7.6926,53.28823,2021/08/26 23:00:00+00,Fri 27 Aug 2021,9722,19206,430,3473702,3153225,236992,3710694,3390217,78.8015987574187,71.9958368258282,53
-7.6926,53.28823,2021/08/27 23:00:00+00,Sat 28 Aug 2021,9919,7920,153,3483621,3161145,237145,3720766,3398290,79.015491280673,72.1672778842309,54
-7.6926,53.28823,2021/08/28 23:00:00+00,Sun 29 Aug 2021,8797,9187,30,3492418,3170332,237175,3729593,3407507,79.2029445474289,72.3630133277213,55
-7.6926,53.28823,2021/08/29 23:00:00+00,Mon 30 Aug 2021,5059,11130,84,3497477,3181462,237259,3734736,3418721,79.3121630985704,72.6011577633621,56
-7.6926,53.28823,2021/08/30 23:00:00+00,Tue 31 Aug 2021,4059,12886,142,3501536,3194348,237401,3738937,3431749,79.4013770074457,72.8778249389933,57
-7.6926,53.28823,2021/08/31 23:00:00+00,Wed 01 Sep 2021,4962,12522,181,3506498,3206870,237582,3744080,3444452,79.5105955585872,73.1475903006791,58
-7.6926,53.28823,2021/09/01 23:00:00+00,Thu 02 Sep 2021,5006,12359,247,3511504,3219229,237829,3749333,3457058,79.6221501082948,73.4152957363567,59
-7.6926,53.28823,2021/09/02 23:00:00+00,Fri 03 Sep 2021,4774,16064,166,3516278,3235293,237995,3754273,3473288,79.7270576802642,73.7599617066126,60
-7.6926,53.28823,2021/09/03 23:00:00+00,Sat 04 Sep 2021,4628,10580,133,3520906,3245873,238128,3759034,3484001,79.8281639454761,73.9874667306022,61
-7.6926,53.28823,2021/09/04 23:00:00+00,Sun 05 Sep 2021,5305,11900,1,3526211,3257773,238129,3764340,3495902,79.9408440217656,74.240200539106,62
-7.6926,53.28823,2021/09/05 23:00:00+00,Mon 06 Sep 2021,2154,9667,75,3528365,3267440,238204,3766569,3505644,79.9881798472554,74.447085066662,63
-7.6926,53.28823,2021/09/06 23:00:00+00,Tue 07 Sep 2021,3028,10017,158,3531393,3277457,238362,3769755,3515819,80.0558388602705,74.6631649340282,64
-7.6926,53.28823,2021/09/07 23:00:00+00,Wed 08 Sep 2021,2610,14801,187,3534003,3292258,238549,3772552,3530807,80.1152369329018,74.9814553568376,65
-7.6926,53.28823,2021/09/08 23:00:00+00,Thu 09 Sep 2021,3114,14807,138,3537117,3307065,238687,3775804,3545752,80.1842975450566,75.2988326165711,66
-7.6926,53.28823,2021/09/09 23:00:00+00,Fri 10 Sep 2021,3377,13944,115,3540494,3321009,238802,3779296,3559811,80.2584548813557,75.5973944696721,67
-7.6926,53.28823,2021/09/10 23:00:00+00,Sat 11 Sep 2021,2558,11332,62,3543052,3332341,238864,3781916,3571205,80.3140941199306,75.839361448421,68
-7.6926,53.28823,2021/09/11 23:00:00+00,Sun 12 Sep 2021,2041,12882,1,3545093,3345223,238865,3783958,3584088,80.357458747858,76.1129493532151,69
-7.6926,53.28823,2021/09/12 23:00:00+00,Mon 13 Sep 2021,1613,7735,52,3546706,3352958,238917,3785623,3591875,80.3928172716089,76.2783168153459,70
-7.6926,53.28823,2021/09/13 23:00:00+00,Tue 14 Sep 2021,1546,10781,82,3548252,3363739,238999,3787251,3602738,80.4273900503875,76.5090072919257,71
-7.6926,53.28823,2021/09/14 23:00:00+00,Wed 15 Sep 2021,3280,12383,137,3551532,3376122,239136,3790668,3615258,80.4999546603915,76.7748864014516,72
-7.6926,53.28823,2021/09/15 23:00:00+00,Thu 16 Sep 2021,1912,10584,115,3553444,3386706,239251,3792695,3625957,80.5430007430599,77.0020941165328,73
-7.6926,53.28823,2021/09/16 23:00:00+00,Fri 17 Sep 2021,2561,14613,94,3556005,3401319,239345,3795350,3640664,80.5993832539058,77.3144171248232,74
-7.6926,53.28823,2021/09/17 23:00:00+00,Sat 18 Sep 2021,2287,11230,47,3558292,3412549,239392,3797684,3651941,80.6489488962088,77.5538994505519,75
-7.6926,53.28823,2021/09/18 23:00:00+00,Sun 19 Sep 2021,1862,8490,15,3560154,3421039,239407,3799561,3660446,80.6888095262871,77.7345146124143,76
-7.6926,53.28823,2021/09/19 23:00:00+00,Mon 20 Sep 2021,955,5618,35,3561109,3426657,239442,3800551,3666099,80.7098335133822,77.8545637023624,77
-7.6926,53.28823,2021/09/20 23:00:00+00,Tue 21 Sep 2021,1462,6665,90,3562571,3433322,239532,3802103,3672854,80.7427923295151,77.9980152506728,78
-7.6926,53.28823,2021/09/21 23:00:00+00,Wed 22 Sep 2021,1896,8151,97,3564467,3441473,239629,3804096,3681102,80.7851163762631,78.1731726704307,79
-7.6926,53.28823,2021/09/22 23:00:00+00,Thu 23 Sep 2021,1702,8733,89,3566169,3450206,239718,3805887,3689924,80.8231506801897,78.3605197554337,80
-7.6926,53.28823,2021/09/23 23:00:00+00,Fri 24 Sep 2021,1910,7383,79,3568079,3457589,239797,3807876,3697386,80.8653897815353,78.5189854036191,81
-7.6926,53.28823,2021/09/24 23:00:00+00,Sat 25 Sep 2021,2421,6597,53,3570500,3464186,239850,3810350,3704036,80.9179285129224,78.6602071351165,82
-7.6926,53.28823,2021/09/25 23:00:00+00,Sun 26 Sep 2021,1548,7097,0,3572048,3471283,239850,3811898,3711133,80.9508023836529,78.8109215153325,83
-7.6926,53.28823,2021/09/26 23:00:00+00,Mon 27 Sep 2021,1178,3821,45,3573226,3475104,239895,3813121,3714999,80.9767744404381,78.8930212467564,84
-7.6926,53.28823,2021/09/27 23:00:00+00,Tue 28 Sep 2021,1451,5134,93,3574677,3480238,239988,3814665,3720226,81.0095633657662,79.0040236513484,85
-7.6926,53.28823,2021/09/28 23:00:00+00,Wed 29 Sep 2021,1652,3621,79,3576329,3483859,240067,3816396,3723926,81.0463234886567,79.0825981485725,86
-7.6926,53.28823,2021/09/29 23:00:00+00,Thu 30 Sep 2021,1281,3965,78,3577610,3487824,240145,3817755,3727969,81.0751836891236,79.1684567140528,87
-7.6926,53.28823,2021/09/30 23:00:00+00,Fri 01 Oct 2021,1852,5184,41,3579462,3493008,240186,3819648,3733194,81.1153841008115,79.2794166459435,88
-7.6926,53.28823,2021/10/01 23:00:00+00,Sat 02 Oct 2021,1710,4088,40,3581172,3497096,240226,3821398,3737322,81.1525477143634,79.3670803012249,89
-7.6926,53.28823,2021/10/02 23:00:00+00,Sun 03 Oct 2021,1196,3018,9,3582368,3500114,240235,3822603,3740349,81.1781375168378,79.4313627344944,90
-7.6926,53.28823,2021/10/03 23:00:00+00,Mon 04 Oct 2021,337,1238,18,3582705,3501352,240253,3822958,3741605,81.1856764213012,79.4580355908494,91
-7.6926,53.28823,2021/10/04 23:00:00+00,Tue 05 Oct 2021,964,2824,70,3583669,3504176,240323,3823992,3744499,81.2076348078227,79.519493589489,92
-7.6926,53.28823,2021/10/05 23:00:00+00,Wed 06 Oct 2021,981,2572,40,3584650,3506748,240363,3825013,3747111,81.2293171217864,79.5749629372591,93
-7.6926,53.28823,2021/10/06 23:00:00+00,Thu 07 Oct 2021,1216,2698,44,3585866,3509446,240407,3826273,3749853,81.2560749235438,79.6331930106073,94
-7.6926,53.28823,2021/10/07 23:00:00+00,Fri 08 Oct 2021,961,2791,48,3586827,3512237,240455,3827282,3752692,81.2775024013003,79.6934830099639,95
-7.6926,53.28823,2021/10/08 23:00:00+00,Sat 09 Oct 2021,733,2380,23,3587560,3514617,240478,3828038,3755095,81.2935570823548,79.7445139604583,96
-7.6926,53.28823,2021/10/09 23:00:00+00,Sun 10 Oct 2021,1503,3915,2,3589063,3518532,240480,3829543,3759012,81.3255177900094,79.8276967457629,97
-7.6926,53.28823,2021/10/10 23:00:00+00,Mon 11 Oct 2021,332,1126,19,3589395,3519658,240499,3829894,3760157,81.3329717490704,79.8520123672011,98
-7.6926,53.28823,2021/10/11 23:00:00+00,Tue 12 Oct 2021,559,1610,20,3589954,3521268,240519,3830473,3761787,81.3452675960685,79.8866276186809,99
-7.6926,53.28823,2021/10/12 23:00:00+00,Wed 13 Oct 2021,996,2073,11,3590950,3523341,240530,3831480,3763871,81.3666526011238,79.9308841733336,100
-7.6926,53.28823,2021/10/13 23:00:00+00,Thu 14 Oct 2021,681,1601,8,3591631,3524942,240538,3832169,3765480,81.381284446688,79.9650534614508,101
-7.6926,53.28823,2021/10/14 23:00:00+00,Fri 15 Oct 2021,950,2069,8,3592581,3527011,240546,3833127,3767557,81.4016288705638,80.0091613616493,102
-7.6926,53.28823,2021/10/15 23:00:00+00,Sat 16 Oct 2021,1369,2642,14,3593950,3529653,240560,3834510,3770213,81.4309987434451,80.0655651088458,103
-7.6926,53.28823,2021/10/16 23:00:00+00,Sun 17 Oct 2021,1702,2891,2,3595652,3532544,240562,3836214,3773106,81.4671854848694,80.1270018711349,104
-7.6926,53.28823,2021/10/17 23:00:00+00,Mon 18 Oct 2021,670,1244,6,3596322,3533788,240568,3836890,3774356,81.4815412578758,80.1535473093862,105
-7.6926,53.28823,2021/10/18 23:00:00+00,Tue 19 Oct 2021,1333,1798,13,3597655,3535586,240581,3838236,3776167,81.5101253857849,80.1920063403248,106
-7.6926,53.28823,2021/10/19 23:00:00+00,Wed 20 Oct 2021,2257,2323,0,3599912,3537909,240581,3840493,3778490,81.5580558290915,80.2413383827712,107
-7.6926,53.28823,2021/10/20 23:00:00+00,Thu 21 Oct 2021,1741,1838,11,3601653,3539747,240592,3842245,3780339,81.5952619153447,80.2806043950327,108
-7.6926,53.28823,2021/10/21 23:00:00+00,Fri 22 Oct 2021,1504,1924,3,3603157,3541671,240595,3843752,3782266,81.6272650957006,80.321526842641,109
-7.6926,53.28823,2021/10/22 23:00:00+00,Sat 23 Oct 2021,2012,1698,1,3605169,3543369,240596,3845765,3783965,81.6700138694606,80.3576074023123,110
-7.6926,53.28823,2021/10/23 23:00:00+00,Sun 24 Oct 2021,1949,2184,2,3607118,3545553,240598,3847716,3786151,81.7114459894833,80.4040300647263,111
-7.6926,53.28823,2021/10/24 23:00:00+00,Mon 25 Oct 2021,1219,847,2,3608337,3546400,240600,3848937,3787000,81.7373755735673,80.4220597263866,112
-7.6926,53.28823,2021/10/25 23:00:00+00,Tue 26 Oct 2021,1240,1221,6,3609577,3547621,240606,3850183,3788227,81.7638360664163,80.4481167285742,113
-7.6926,53.28823,2021/10/26 23:00:00+00,Wed 27 Oct 2021,1556,1420,5,3611133,3549041,240611,3851744,3789652,81.7969860097046,80.4783785281807,114
-7.6926,53.28823,2021/10/27 23:00:00+00,Thu 28 Oct 2021,2151,1686,4,3613284,3550727,240615,3853899,3791342,81.84275034525,80.5142679606966,115
-7.6926,53.28823,2021/10/28 23:00:00+00,Fri 29 Oct 2021,2133,1358,2,3615417,3552085,240617,3856034,3792702,81.8880899537833,80.5431493975141,116
-7.6926,53.28823,2021/10/29 23:00:00+00,Sat 30 Oct 2021,2014,1446,1,3617431,3553531,240618,3858049,3794149,81.9308812002446,80.5738783968339,117
-7.6926,53.28823,2021/10/30 23:00:00+00,Sun 31 Oct 2021,1593,1319,0,3619024,3554850,240618,3859642,3795468,81.9647107067521,80.6018891432768,118
-7.6926,53.28823,2021/11/01 00:00:00+00,Mon 01 Nov 2021,270,279,2,3619294,3555129,240620,3859914,3795749,81.9704869941156,80.6078565577957,119
-7.6926,53.28823,2021/11/02 00:00:00+00,Tue 02 Nov 2021,1095,1092,10,3620389,3556221,240630,3861019,3796851,81.9939531615298,80.6312590161581,120
-7.6926,53.28823,2021/11/03 00:00:00+00,Wed 03 Nov 2021,2533,1873,6,3622922,3558094,240636,3863558,3798730,82.047872255706,80.6711621189376,121
-7.6926,53.28823,2021/11/04 00:00:00+00,Thu 04 Nov 2021,1538,1278,1,3624460,3559372,240637,3865097,3800009,82.0805549992811,80.6983234113564,122
-7.6926,53.28823,2021/11/05 00:00:00+00,Fri 05 Nov 2021,1629,1088,3,3626089,3560460,240640,3866729,3801100,82.1152127234622,80.7214922698622,123
-7.6926,53.28823,2021/11/06 00:00:00+00,Sat 06 Nov 2021,1813,1348,6,3627902,3561808,240646,3868548,3802454,82.1538416452056,80.7502462885761,124
-7.6926,53.28823,2021/11/07 00:00:00+00,Sun 07 Nov 2021,695,774,0,3628597,3562582,240646,3869243,3803228,82.1686009088733,80.7666832239413,125
-7.6926,53.28823,2021/11/08 00:00:00+00,Mon 08 Nov 2021,517,529,3,3629114,3563111,240649,3869763,3803760,82.1796438111859,80.7779809624611,126
-7.6926,53.28823,2021/11/09 00:00:00+00,Tue 09 Nov 2021,1369,1059,3,3630483,3564170,240652,3871135,3804822,82.2087800842106,80.8005339667995,127
-7.6926,53.28823,2021/11/10 00:00:00+00,Wed 10 Nov 2021,1618,1358,1,3632101,3565528,240653,3872754,3806181,82.2431617358338,80.8293941672664,128
-7.6926,53.28823,2021/11/11 00:00:00+00,Thu 11 Nov 2021,1389,1110,2,3633490,3566638,240655,3874145,3807293,82.27270149952,80.8530089891348,129
-7.6926,53.28823,2021/11/12 00:00:00+00,Fri 12 Nov 2021,1144,1154,6,3634634,3567792,240661,3875295,3808453,82.2971233027112,80.8776431558321,130
-7.6926,53.28823,2021/11/13 00:00:00+00,Sat 13 Nov 2021,1400,1371,0,3636034,3569163,240661,3876695,3809824,82.3268541935528,80.9067581925062,131
-7.6926,53.28823,2021/11/14 00:00:00+00,Sun 14 Nov 2021,1647,1803,0,3637681,3570966,240661,3878342,3811627,82.3618304629928,80.94504733264,132
-7.6926,53.28823,2021/11/15 00:00:00+00,Mon 15 Nov 2021,1243,586,1,3638924,3571552,240662,3879586,3812214,82.3882484831406,80.9575130704429,133
-7.6926,53.28823,2021/11/16 00:00:00+00,Tue 16 Nov 2021,1317,1068,5,3640241,3572620,240667,3880908,3813287,82.4163229386352,80.9802996746379,134
-7.6926,53.28823,2021/11/17 00:00:00+00,Wed 17 Nov 2021,1510,1108,0,3641751,3573728,240667,3882418,3814395,82.4483898280429,81.0038295511039,135
-7.6926,53.28823,2021/11/18 00:00:00+00,Thu 18 Nov 2021,1652,2502,5,3643403,3576230,240672,3884075,3816902,82.4835784609889,81.0570690820609,136
-7.6926,53.28823,2021/11/19 00:00:00+00,Fri 19 Nov 2021,1168,1549,0,3644571,3577779,240672,3885243,3818451,82.508382518491,81.089964189142,137
-7.6926,53.28823,2021/11/20 00:00:00+00,Sat 20 Nov 2021,1546,2936,12,3646117,3580715,240684,3886801,3821399,82.5414687527275,81.152568950714,138
-7.6926,53.28823,2021/11/21 00:00:00+00,Sun 21 Nov 2021,1786,2760,0,3647903,3583475,240684,3888587,3824159,82.5793968749011,81.2111812783731,139
-7.6926,53.28823,2021/11/22 00:00:00+00,Mon 22 Nov 2021,716,511,2,3648619,3583986,240686,3889305,3824672,82.5946445746327,81.2220755262315,140
-7.6926,53.28823,2021/11/23 00:00:00+00,Tue 23 Nov 2021,2160,1587,7,3650779,3585573,240693,3891472,3826266,82.6406637463853,81.2559262690896,141
-7.6926,53.28823,2021/11/24 00:00:00+00,Wed 24 Nov 2021,1622,3138,2,3652401,3588711,240695,3893096,3829406,82.6751515797615,81.3226084099771,142
-7.6926,53.28823,2021/11/25 00:00:00+00,Thu 25 Nov 2021,987,1180,1,3653388,3589891,240696,3894084,3830587,82.6961330941554,81.347688540037,143
-7.6926,53.28823,2021/11/26 00:00:00+00,Fri 26 Nov 2021,1290,1103,12,3654678,3590994,240708,3895386,3831702,82.723782822638,81.3713670709572,144
-7.6926,53.28823,2021/11/27 00:00:00+00,Sat 27 Nov 2021,1202,1563,6,3655880,3592557,240714,3896594,3833271,82.7494363341642,81.4046869050504,145
-7.6926,53.28823,2021/11/28 00:00:00+00,Sun 28 Nov 2021,1959,2256,0,3657839,3594813,240714,3898553,3835527,82.7910383449917,81.4525961120065,146
-7.6926,53.28823,2021/11/29 00:00:00+00,Mon 29 Nov 2021,539,990,1,3658378,3595803,240715,3899093,3836518,82.8025059743163,81.4736413354522,147
-7.6926,53.28823,2021/11/30 00:00:00+00,Tue 30 Nov 2021,1919,1643,6,3660297,3597446,240721,3901018,3838167,82.8433859492235,81.5086600775934,148
-7.6926,53.28823,2021/12/01 00:00:00+00,Wed 01 Dec 2021,1078,1375,2,3661375,3598821,240723,3902098,3839544,82.8663212078726,81.5379025323711,149
-7.6926,53.28823,2022/04/01 23:00:00+00,Sat 02 Apr 2022,729,1539,0,3837069,3779375,240788,4077857,4020163,86.5988009531724,85.3735909415922,150
-7.6926,53.28823,2021/12/16 00:00:00+00,Thu 16 Dec 2021,1057,1539,7,3675182,3618346,240746,3915928,3859092,83.1600199366859,81.9530307139215,151
-7.6926,53.28823,2021/12/17 00:00:00+00,Fri 17 Dec 2021,1215,2457,1,3676397,3620803,240747,3917144,3861550,83.1858433390169,82.005229663699,152
-7.6926,53.28823,2021/01/12 00:00:00+00,Tue 12 Jan 2021,8885,10,0,70222,89,2,70224,91,1.49130148461203,0.0019325079047006,153
-7.6926,53.28823,2022/04/02 23:00:00+00,Sun 03 Apr 2022,537,816,0,3837606,3780191,240788,4078394,4020979,86.6102048734452,85.3909198036827,154
-7.6926,53.28823,2021/12/18 00:00:00+00,Sat 18 Dec 2021,1257,1184,0,3677654,3621987,240747,3918401,3862734,83.2125374317225,82.0303735028107,155
-7.6926,53.28823,2021/01/13 00:00:00+00,Wed 13 Jan 2021,9878,4,0,80100,93,2,80102,95,1.70107415584975,0.00201745330710502,156
-7.6926,53.28823,2022/04/03 23:00:00+00,Mon 04 Apr 2022,49,53,0,3837655,3780244,240788,4078443,4021032,86.6112454546246,85.3920453302645,157
-7.6926,53.28823,2021/12/19 00:00:00+00,Sun 19 Dec 2021,551,887,1,3678205,3622874,240748,3918953,3863622,83.2242598972543,82.0492313821445,158
-7.6926,53.28823,2021/01/14 00:00:00+00,Thu 14 Jan 2021,8083,4,0,88183,97,2,88185,99,1.87272757775849,0.00210239870950945,159
-7.6926,53.28823,2022/04/04 23:00:00+00,Tue 05 Apr 2022,130,166,0,3837785,3780410,240788,4078573,4021198,86.6140061802028,85.3955705644643,160
-7.6926,53.28823,2021/12/20 00:00:00+00,Mon 20 Dec 2021,526,613,0,3678731,3623487,240748,3919479,3864235,83.2354302176705,82.062249265063,161
-7.6926,53.28823,2021/01/15 00:00:00+00,Fri 15 Jan 2021,7691,2,0,95874,99,2,95876,101,2.03605635023159,0.00214487141071166,162
-7.6926,53.28823,2022/04/05 23:00:00+00,Wed 06 Apr 2022,159,209,0,3837944,3780619,240788,4078732,4021407,86.6173827599483,85.4000089617399,163
-7.6926,53.28823,2021/12/21 00:00:00+00,Tue 21 Dec 2021,1442,1815,3,3680173,3625302,240751,3920924,3866053,83.2661167442891,82.1008569504558,164
-7.6926,53.28823,2021/01/16 00:00:00+00,Sat 16 Jan 2021,5236,3,0,101110,102,2,101112,104,2.14724988197898,0.00220858046251497,165
-7.6926,53.28823,2022/04/06 23:00:00+00,Thu 07 Apr 2022,120,178,0,3838064,3780797,240788,4078852,4021585,86.6199311220205,85.4037890321469,166
-7.6926,53.28823,2021/12/22 00:00:00+00,Wed 22 Dec 2021,1200,1589,2,3681373,3626891,240753,3922126,3867644,83.2916428377116,82.1346439842622,167
-7.6926,53.28823,2021/01/17 00:00:00+00,Sun 17 Jan 2021,1113,4,0,102223,106,2,102225,108,2.17088594019801,0.0022935258649194,168
-7.6926,53.28823,2022/04/07 23:00:00+00,Fri 08 Apr 2022,268,420,2,3838332,3781217,240790,4079122,4022007,86.6256649366828,85.4127507721006,169
-7.6926,53.28823,2021/12/23 00:00:00+00,Thu 23 Dec 2021,949,1389,0,3682322,3628280,240753,3923075,3869033,83.311796134432,82.1641412752471,170
-7.6926,53.28823,2021/01/18 00:00:00+00,Mon 18 Jan 2021,8715,8,1,110938,114,3,110941,117,2.35598197203725,0.00248465302032935,171
-7.6926,53.28823,2022/04/08 23:00:00+00,Sat 09 Apr 2022,561,1018,0,3838893,3782235,240790,4079683,4023025,86.63757852937,85.4343693770125,172
-7.6926,53.28823,2021/12/24 00:00:00+00,Fri 24 Dec 2021,104,155,0,3682426,3628435,240753,3923179,3869188,83.3140047148946,82.1674329095903,173
-7.6926,53.28823,2021/01/19 00:00:00+00,Tue 19 Jan 2021,8381,19,0,119319,133,3,119322,136,2.53396382642511,0.00288814368175035,174
-7.6926,53.28823,2022/04/09 23:00:00+00,Sun 10 Apr 2022,413,719,0,3839306,3782954,240790,4080096,4023744,86.6463491421682,85.4496383130947,175
-7.6926,53.28823,2021/12/25 00:00:00+00,Sat 25 Dec 2021,1,5,0,3682427,3628440,240753,3923180,3869193,83.3140259512452,82.1675390913433,176
-7.6926,53.28823,2021/01/20 00:00:00+00,Wed 20 Jan 2021,8446,962,0,127765,1095,3,127768,1098,2.71332604360205,0.0233175129600139,177
-7.6926,53.28823,2022/04/10 23:00:00+00,Mon 11 Apr 2022,71,93,1,3839377,3783047,240791,4080168,4023838,86.6478781594115,85.4516345300513,178
-7.6926,53.28823,2021/12/26 00:00:00+00,Sun 26 Dec 2021,11,10,0,3682438,3628450,240753,3923191,3869203,83.3142595511018,82.1677514548493,179
-7.6926,53.28823,2021/01/21 00:00:00+00,Thu 21 Jan 2021,9006,962,0,136771,2057,3,136774,2060,2.90458061711561,0.0437468822382774,180
-7.6926,53.28823,2022/04/11 23:00:00+00,Tue 12 Apr 2022,197,177,0,3839574,3783224,240791,4080365,4024015,86.6520617204799,85.4553933641076,181
-7.6926,53.28823,2021/12/27 00:00:00+00,Mon 27 Dec 2021,390,587,0,3682828,3629037,240753,3923581,3869790,83.3225417278362,82.1802171926521,182
-7.6926,53.28823,2021/01/22 00:00:00+00,Fri 22 Jan 2021,6780,967,0,143551,3024,3,143554,3027,3.0485630741911,0.0642824332695464,183
-7.6926,53.28823,2022/04/12 23:00:00+00,Wed 13 Apr 2022,145,232,0,3839719,3783456,240791,4080510,4024247,86.6551409913171,85.4603201974471,184
-7.6926,53.28823,2021/12/28 00:00:00+00,Tue 28 Dec 2021,471,744,0,3683299,3629781,240753,3924052,3870534,83.3325440489693,82.1960170374994,185
-7.6926,53.28823,2021/01/23 00:00:00+00,Sat 23 Jan 2021,4185,460,0,147736,3484,3,147739,3487,3.13743720145673,0.074051154546055,186
-7.6926,53.28823,2022/04/13 23:00:00+00,Thu 14 Apr 2022,361,429,0,3840080,3783885,240791,4080871,4024676,86.6628073138841,85.469430591855,187
-7.6926,53.28823,2021/12/29 00:00:00+00,Wed 29 Dec 2021,1073,1304,0,3684372,3631085,240753,3925125,3871838,83.3553306531643,82.2237092386832,188
-7.6926,53.28823,2021/01/24 00:00:00+00,Sun 24 Jan 2021,1182,398,0,148918,3882,3,148921,3885,3.16253856786724,0.082503222085295,189
-7.6926,53.28823,2022/04/14 23:00:00+00,Fri 15 Apr 2022,447,991,0,3840527,3784876,240791,4081318,4025667,86.6722999626028,85.4904758153007,190
-7.6926,53.28823,2021/12/30 00:00:00+00,Thu 30 Dec 2021,1065,1193,1,3685437,3632278,240754,3926191,3873032,83.3779686029051,82.2490654413009,191
-7.6926,53.28823,2021/01/25 00:00:00+00,Mon 25 Jan 2021,1359,1289,0,150277,5171,3,150280,5174,3.19139876833414,0.10987687801012,192
-7.6926,53.28823,2022/04/15 23:00:00+00,Sat 16 Apr 2022,42,88,0,3840569,3784964,240791,4081360,4025755,86.673191889328,85.4923446141536,193
-7.6926,53.28823,2021/12/31 00:00:00+00,Fri 31 Dec 2021,717,1680,0,3686154,3633958,240754,3926908,3874712,83.3931950662861,82.2847425103108,194
-7.6926,53.28823,2021/01/26 00:00:00+00,Tue 26 Jan 2021,1002,3500,0,151279,8671,3,151282,8674,3.21267759163645,0.184204105113989,195
-7.6926,53.28823,2021/01/27 00:00:00+00,Wed 27 Jan 2021,2175,6700,0,153454,15371,3,153457,15374,3.25886665419385,0.326487654141396,196
-7.6926,53.28823,2021/01/28 00:00:00+00,Thu 28 Jan 2021,1006,11540,0,154460,26911,3,154463,26914,3.28023042289856,0.571555140078154,197
-7.6926,53.28823,2021/01/29 00:00:00+00,Fri 29 Jan 2021,1576,11527,0,156036,38438,3,156039,38441,3.3136989114459,0.816346553457097,198
-7.6926,53.28823,2021/01/30 00:00:00+00,Sat 30 Jan 2021,640,7793,0,156676,46231,3,156679,46234,3.32729017583061,0.981841433691513,199
-7.6926,53.28823,2021/01/31 00:00:00+00,Sun 31 Jan 2021,227,4086,0,156903,50317,3,156906,50320,3.33211082741706,1.06861316224763,200
-7.6926,53.28823,2021/02/01 00:00:00+00,Mon 01 Feb 2021,1027,8334,1,157930,58651,4,157934,58655,3.353941795835,1.24561814450784,201
-7.6926,53.28823,2021/02/02 00:00:00+00,Tue 02 Feb 2021,828,5109,0,158758,63760,4,158762,63764,3.37152549413271,1.35411465972889,202
-7.6926,53.28823,2021/02/03 00:00:00+00,Wed 03 Feb 2021,1399,6865,0,160157,70625,4,160161,70629,3.40123514862366,1.49990220660548,203
-7.6926,53.28823,2021/02/04 00:00:00+00,Thu 04 Feb 2021,1432,10541,1,161589,81166,5,161594,81171,3.43166683903505,1.72377581464234,204
-7.6926,53.28823,2021/02/05 00:00:00+00,Fri 05 Feb 2021,3393,8613,0,164982,89779,5,164987,89784,3.5037217766246,1.90668450236966,205
-7.6926,53.28823,2021/02/06 00:00:00+00,Sat 06 Feb 2021,900,3869,0,165882,93648,5,165887,93653,3.52283449216559,1.98884794284534,206
-7.6926,53.28823,2021/02/07 00:00:00+00,Sun 07 Feb 2021,330,1300,2,166212,94948,7,166219,94955,3.52988496056516,2.01649767132797,207
-7.6926,53.28823,2021/02/08 00:00:00+00,Mon 08 Feb 2021,1185,879,0,167397,95827,7,167404,95834,3.55505003602747,2.03516442350635,208
-7.6926,53.28823,2021/02/09 00:00:00+00,Tue 09 Feb 2021,4262,543,3,171659,96370,10,171669,96380,3.64562307134118,2.04675947093455,209
-7.6926,53.28823,2021/02/10 00:00:00+00,Wed 10 Feb 2021,8824,579,0,180483,96949,10,180493,96959,3.83301262904534,2.05905531793259,210
-7.6926,53.28823,2021/02/11 00:00:00+00,Thu 11 Feb 2021,6181,445,0,186664,97394,10,186674,97404,3.96427451211077,2.06850549395008,211
-7.6926,53.28823,2021/02/12 00:00:00+00,Fri 12 Feb 2021,4395,524,0,191059,97918,10,191069,97928,4.05760827300263,2.07963334166506,212
-7.6926,53.28823,2021/02/13 00:00:00+00,Sat 13 Feb 2021,1209,1914,0,192268,99832,10,192278,99842,4.08328302087937,2.12027971671558,213
-7.6926,53.28823,2021/02/14 00:00:00+00,Sun 14 Feb 2021,2700,27,0,194968,99859,10,194978,99869,4.14062116750235,2.12085309818181,214
-7.6926,53.28823,2021/02/15 00:00:00+00,Mon 15 Feb 2021,1963,7890,0,196931,107749,10,196941,107759,4.18230812373232,2.28840790442453,215
-7.6926,53.28823,2021/02/16 00:00:00+00,Tue 16 Feb 2021,5649,8160,0,202580,115909,10,202590,115919,4.30227226827797,2.46169652532955,216
-7.6926,53.28823,2021/02/17 00:00:00+00,Wed 17 Feb 2021,9745,8465,0,212325,124374,10,212335,124384,4.50922050488574,2.64146223316791,217
-7.6926,53.28823,2021/02/18 00:00:00+00,Thu 18 Feb 2021,8462,8353,1,220787,132727,11,220798,132738,4.6889437400229,2.81887070608955,218
-7.6926,53.28823,2021/02/19 00:00:00+00,Fri 19 Feb 2021,9385,6582,0,230172,139309,11,230183,139320,4.88824689041427,2.95864836574602,219
-7.6926,53.28823,2021/02/20 00:00:00+00,Sat 20 Feb 2021,5886,3568,2,236058,142877,13,236071,142890,5.01328652275358,3.03446213739197,220
-7.6926,53.28823,2021/02/21 00:00:00+00,Sun 21 Feb 2021,1110,1024,6,237168,143901,19,237187,143920,5.03698629002441,3.05633557851111,221
-7.6926,53.28823,2021/02/22 00:00:00+00,Mon 22 Feb 2021,3942,1122,1,241110,145023,20,241130,145043,5.12072122044458,3.08018400023615,222
-7.6926,53.28823,2021/02/23 00:00:00+00,Tue 23 Feb 2021,13362,1066,1,254472,146089,21,254493,146110,5.40450257352715,3.10284318632753,223
-7.6926,53.28823,2021/02/24 00:00:00+00,Wed 24 Feb 2021,16937,2104,3,271409,148193,24,271433,148217,5.76424635270988,3.14758817704406,224
-7.6926,53.28823,2021/02/25 00:00:00+00,Thu 25 Feb 2021,18094,1756,2,289503,149949,26,289529,149975,6.14853935318748,3.1849216814008,225
-7.6926,53.28823,2021/02/26 00:00:00+00,Fri 26 Feb 2021,16079,2769,0,305582,152718,26,305608,152744,6.48999863450266,3.24372513621526,226
-7.6926,53.28823,2021/02/27 00:00:00+00,Sat 27 Feb 2021,8994,704,1,314576,153422,27,314603,153449,6.6810196081596,3.25869676338904,227
-7.6926,53.28823,2021/02/28 00:00:00+00,Sun 28 Feb 2021,2444,57,2,317020,153479,29,317049,153508,6.7329637217299,3.25994970807451,228
-7.6926,53.28823,2021/03/01 00:00:00+00,Mon 01 Mar 2021,5598,794,0,322618,154273,29,322647,154302,6.85184481239489,3.27681137045178,229
-7.6926,53.28823,2021/03/02 00:00:00+00,Tue 02 Mar 2021,12179,1610,0,334797,155883,29,334826,155912,7.11048232636576,3.31100189491956,230
-7.6926,53.28823,2021/03/03 00:00:00+00,Wed 03 Mar 2021,12908,1505,1,347705,157388,30,347735,157418,7.38462237627543,3.34298383892483,231
-7.6926,53.28823,2021/03/04 00:00:00+00,Thu 04 Mar 2021,18740,1688,5,366445,159076,35,366480,159111,7.78269776829315,3.3789369804925,232
-7.6926,53.28823,2021/03/05 00:00:00+00,Fri 05 Mar 2021,18443,2396,6,384888,161472,41,384929,161513,8.17448720053295,3.42994669463636,233
-7.6926,53.28823,2021/03/06 00:00:00+00,Sat 06 Mar 2021,10397,140,4,395285,161612,45,395330,161657,8.39536648313505,3.43300472912292,234
-7.6926,53.28823,2021/03/07 00:00:00+00,Sun 07 Mar 2021,1520,13,3,396805,161625,48,396853,161673,8.42770944510053,3.43334451073253,235
-7.6926,53.28823,2021/03/08 00:00:00+00,Mon 08 Mar 2021,6667,1497,5,403472,163122,53,403525,163175,8.56939837631111,3.46524150933539,236
-7.6926,53.28823,2021/03/09 00:00:00+00,Tue 09 Mar 2021,13827,3104,6,417299,166226,59,417358,166285,8.8631608141762,3.53128655970483,237
-7.6926,53.28823,2021/03/10 00:00:00+00,Wed 10 Mar 2021,13735,3990,3,431034,170216,62,431096,170278,9.15490579873419,3.61608330765505,238
-7.6926,53.28823,2021/03/11 00:00:00+00,Thu 11 Mar 2021,18480,2102,3,449514,172318,65,449579,172383,9.54741726689442,3.66078582567037,239
-7.6926,53.28823,2021/03/12 00:00:00+00,Fri 12 Mar 2021,17328,1338,4,466842,173656,69,466911,173725,9.91548569551278,3.68928500817706,240
-7.6926,53.28823,2021/03/13 00:00:00+00,Sat 13 Mar 2021,8306,174,0,475148,173830,69,475217,173899,10.0918748236056,3.69298013318165,241
-7.6926,53.28823,2021/03/14 00:00:00+00,Sun 14 Mar 2021,383,20,2,475531,173850,71,475602,173921,10.100050818587,3.69344733289487,242
-7.6926,53.28823,2021/03/15 00:00:00+00,Mon 15 Mar 2021,2653,992,0,478184,174842,71,478255,174913,10.1563908567317,3.71451379269117,243
-7.6926,53.28823,2021/03/16 00:00:00+00,Tue 16 Mar 2021,8943,3823,2,487127,178665,73,487200,178738,10.3463500128586,3.7957428337404,244
-7.6926,53.28823,2021/03/17 00:00:00+00,Wed 17 Mar 2021,4898,2415,6,492025,181080,79,492104,181159,10.4504930762064,3.84715603854568,245
-7.6926,53.28823,2021/03/18 00:00:00+00,Thu 18 Mar 2021,11730,4682,5,503755,185762,84,503839,185846,10.6997016505104,3.94669081381306,246
-7.6926,53.28823,2021/03/19 00:00:00+00,Fri 19 Mar 2021,10368,6130,2,514123,191892,86,514209,191978,10.9199226062439,4.07691211569904,247
-7.6926,53.28823,2021/03/20 00:00:00+00,Sat 20 Mar 2021,5242,3117,4,519365,195009,90,519455,195099,11.0313285014973,4.14319076592509,248
-7.6926,53.28823,2021/03/21 00:00:00+00,Sun 21 Mar 2021,3637,55,3,523002,195064,93,523095,195157,11.1086288176853,4.14442247425995,249
-7.6926,53.28823,2021/03/22 00:00:00+00,Mon 22 Mar 2021,7413,2405,1,530415,197469,94,530509,197563,11.2660751210419,4.19551713380621,250
-7.6926,53.28823,2021/03/23 00:00:00+00,Tue 23 Mar 2021,12561,7392,4,542976,204861,98,543074,204959,11.5329098663448,4.35258118285199,251
-7.6926,53.28823,2021/03/24 00:00:00+00,Wed 24 Mar 2021,13623,9778,2,556599,214639,100,556699,214739,11.8222551432848,4.5602726917308,252
-7.6926,53.28823,2021/03/25 00:00:00+00,Thu 25 Mar 2021,20870,10226,3,577469,224865,103,577572,224968,12.2655214893817,4.77749932202951,253
-7.6926,53.28823,2021/03/26 00:00:00+00,Fri 26 Mar 2021,19697,9499,1,597166,234364,104,597270,234468,12.6838351235223,4.97924465274001,254
-7.6926,53.28823,2021/03/27 00:00:00+00,Sat 27 Mar 2021,11753,5353,3,608919,239717,107,609026,239824,12.9334896611889,5.09298654655953,255
-7.6926,53.28823,2021/03/28 00:00:00+00,Sun 28 Mar 2021,2492,483,0,611411,240200,107,611518,240307,12.9864106468868,5.10324370389986,256
-7.6926,53.28823,2021/03/28 23:00:00+00,Mon 29 Mar 2021,9273,3120,3,620684,243320,110,620794,243430,13.1833990350627,5.16956482682712,257
-7.6926,53.28823,2021/03/29 23:00:00+00,Tue 30 Mar 2021,13325,8668,4,634009,251988,114,634123,252102,13.4664583522248,5.3537264592399,258
-7.6926,53.28823,2021/03/30 23:00:00+00,Wed 31 Mar 2021,15838,10515,4,649847,262503,118,649965,262621,13.8028846184475,5.57711163121293,259
-7.6926,53.28823,2021/03/31 23:00:00+00,Thu 01 Apr 2021,19706,11577,8,669553,274080,126,669679,274206,14.2215380341977,5.82313475292674,260
-7.6926,53.28823,2021/04/01 23:00:00+00,Fri 02 Apr 2021,20141,13722,9,689694,287802,135,689829,287937,14.64945049881,6.11473108303052,261
-7.6926,53.28823,2021/04/02 23:00:00+00,Sat 03 Apr 2021,7545,4636,6,697239,292438,141,697380,292579,14.809806182199,6.21331022252085,262
-7.6926,53.28823,2021/04/03 23:00:00+00,Sun 04 Apr 2021,3038,169,3,700277,292607,144,700421,292751,14.8743859243769,6.21696287482424,263
-7.6926,53.28823,2021/04/04 23:00:00+00,Mon 05 Apr 2021,3431,608,4,703708,293215,148,703856,293363,14.9473327886917,6.22995952139212,264
-7.6926,53.28823,2021/04/05 23:00:00+00,Tue 06 Apr 2021,11990,8149,11,715698,301364,159,715857,301523,15.2021902322556,6.40324814229714,265
-7.6926,53.28823,2021/04/06 23:00:00+00,Wed 07 Apr 2021,18361,10470,10,734059,311834,169,734228,312003,15.5923232291485,6.62580509659673,266
-7.6926,53.28823,2021/04/07 23:00:00+00,Thu 08 Apr 2021,20178,10561,16,754237,322395,185,754422,322580,16.0211700931872,6.85042197690462,267
-7.6926,53.28823,2021/04/08 23:00:00+00,Fri 09 Apr 2021,20675,9156,16,774912,331551,201,775113,331752,16.4605714234747,7.04520178461796,268
-7.6926,53.28823,2021/04/09 23:00:00+00,Sat 10 Apr 2021,11172,4172,12,786084,335723,213,786297,335936,16.6980787685975,7.13405467553298,269
-7.6926,53.28823,2021/04/10 23:00:00+00,Sun 11 Apr 2021,2860,362,8,788944,336085,221,789165,336306,16.7589846221214,7.14191212525539,270
-7.6926,53.28823,2021/04/11 23:00:00+00,Mon 12 Apr 2021,7777,2796,13,796721,338881,234,796955,339115,16.924415793304,7.2015650340939,271
-7.6926,53.28823,2021/04/12 23:00:00+00,Tue 13 Apr 2021,11513,8597,1,808234,347478,235,808469,347713,17.1689311341252,7.3841551765622,272
-7.6926,53.28823,2021/04/13 23:00:00+00,Wed 14 Apr 2021,20352,6595,2,828586,354073,237,828823,354310,17.6011758142601,7.5242513814777,273
-7.6926,53.28823,2021/04/14 23:00:00+00,Thu 15 Apr 2021,27126,10812,1,855712,364885,238,855950,365123,18.1772542970163,7.75388004052745,274
-7.6926,53.28823,2021/04/15 23:00:00+00,Fri 16 Apr 2021,27975,9834,1,883687,374719,239,883926,374958,18.7713624414328,7.96273954868932,275
-7.6926,53.28823,2021/04/16 23:00:00+00,Sat 17 Apr 2021,15845,4554,3,899532,379273,242,899774,379515,19.1079161257591,8.05951359837856,276
-7.6926,53.28823,2021/04/17 23:00:00+00,Sun 18 Apr 2021,1071,482,0,900603,379755,242,900845,379997,19.1306602572529,8.0697495193683,277
-7.6926,53.28823,2021/04/18 23:00:00+00,Mon 19 Apr 2021,6742,2258,0,907345,382013,242,907587,382255,19.2738357330056,8.11770119902559,278
-7.6926,53.28823,2021/04/19 23:00:00+00,Tue 20 Apr 2021,15086,7316,1,922431,389329,243,922674,389572,19.5942285545244,8.27308757637388,279
-7.6926,53.28823,2022/01/01 00:00:00+00,Sat 01 Jan 2022,66,97,0,3686220,3634055,240754,3926974,3874809,83.3945966654258,82.2868024363191,280
-7.6926,53.28823,2022/01/02 00:00:00+00,Sun 02 Jan 2022,270,627,0,3686490,3634682,240754,3927244,3875436,83.4003304800881,82.300117628146,281
-7.6926,53.28823,2022/01/03 00:00:00+00,Mon 03 Jan 2022,3630,724,1,3690120,3635406,240755,3930875,3876161,83.4774396691207,82.3155139823318,282
-7.6926,53.28823,2022/04/16 23:00:00+00,Sun 17 Apr 2022,1,0,0,3840570,3784964,240791,4081361,4025755,86.6732131256786,85.4923446141536,283
-7.6926,53.28823,2022/01/04 00:00:00+00,Tue 04 Jan 2022,1192,777,0,3691312,3636183,240755,3932067,3876938,83.5027533990372,82.3320146267488,284
-7.6926,53.28823,2022/04/17 23:00:00+00,Mon 18 Apr 2022,36,61,0,3840606,3785025,240791,4081397,4025816,86.6739776343003,85.4936400315402,285
-7.6926,53.28823,2022/01/05 00:00:00+00,Wed 05 Jan 2022,2146,898,0,3693458,3637081,240755,3934213,3877836,83.5483266074272,82.3510848695886,286
-7.6926,53.28823,2022/04/18 23:00:00+00,Tue 19 Apr 2022,219,269,1,3840825,3785294,240792,4081617,4026086,86.6786496314325,85.4993738462025,287
-7.6926,53.28823,2022/01/06 00:00:00+00,Thu 06 Jan 2022,2462,1693,1,3695920,3638774,240756,3936676,3879530,83.6006317389577,82.3870592475069,288
-7.6926,53.28823,2022/04/19 23:00:00+00,Wed 20 Apr 2022,251,607,0,3841076,3785901,240792,4081868,4026693,86.6839799554334,85.5122643110174,289
-7.6926,53.28823,2022/01/07 00:00:00+00,Fri 07 Jan 2022,4856,784,2,3700776,3639558,240758,3941534,3880316,83.7037979301778,82.4037510190794,290
-7.6926,53.28823,2022/04/20 23:00:00+00,Thu 21 Apr 2022,172,237,0,3841248,3786138,240792,4082040,4026930,86.6876326077368,85.5172973261099,291
-7.6926,53.28823,2022/04/21 23:00:00+00,Fri 22 Apr 2022,198,254,0,3841446,3786392,240792,4082238,4027184,86.6918374051558,85.5226913591625,292
-7.6926,53.28823,2022/04/22 23:00:00+00,Sat 23 Apr 2022,324,1010,0,3841770,3787402,240792,4082562,4028194,86.6987179827506,85.5441400732697,293
-7.6926,53.28823,2022/04/23 23:00:00+00,Sun 24 Apr 2022,181,253,0,3841951,3787655,240792,4082743,4028447,86.7025617622094,85.5495128699717,294
-7.6926,53.28823,2022/04/24 23:00:00+00,Mon 25 Apr 2022,42,58,0,3841993,3787713,240792,4082785,4028505,86.7034536889346,85.5507445783066,295
-7.6926,53.28823,2022/04/25 23:00:00+00,Tue 26 Apr 2022,144,238,0,3842137,3787951,240792,4082929,4028743,86.7065117234212,85.5557988297497,296
-7.6926,53.28823,2022/04/26 23:00:00+00,Wed 27 Apr 2022,122,208,0,3842259,3788159,240792,4083051,4028951,86.7091025581945,85.5602159906747,297
-7.6926,53.28823,2022/04/27 23:00:00+00,Thu 28 Apr 2022,104,129,0,3842363,3788288,240792,4083155,4029080,86.711311138657,85.5629554799022,298
-7.6926,53.28823,2022/04/28 23:00:00+00,Fri 29 Apr 2022,176,222,0,3842539,3788510,240792,4083331,4029302,86.7150487363628,85.5676699497357,299
-7.6926,53.28823,2022/04/29 23:00:00+00,Sat 30 Apr 2022,281,723,0,3842820,3789233,240792,4083612,4030025,86.7210161508817,85.5830238312203,300
-7.6926,53.28823,2022/04/30 23:00:00+00,Sun 01 May 2022,186,746,0,3843006,3789979,240792,4083798,4030771,86.7249661120935,85.5988661487687,301
-7.6926,53.28823,2022/05/01 23:00:00+00,Mon 02 May 2022,11,26,0,3843017,3790005,240792,4083809,4030797,86.7251997119501,85.5994182938843,302
-7.6926,53.28823,2022/05/02 23:00:00+00,Tue 03 May 2022,101,117,0,3843118,3790122,240792,4083910,4030914,86.7273445833609,85.6019029469047,303
-7.6926,53.28823,2022/05/03 23:00:00+00,Wed 04 May 2022,119,128,0,3843237,3790250,240792,4084029,4031042,86.7298717090824,85.6046211997816,304
-7.6926,53.28823,2022/05/04 23:00:00+00,Thu 05 May 2022,117,164,0,3843354,3790414,240792,4084146,4031206,86.7323563621027,85.6081039612802,305
-7.6926,53.28823,2022/05/05 23:00:00+00,Fri 06 May 2022,144,257,0,3843498,3790671,240792,4084290,4031463,86.7354143965893,85.6135617033847,306
-7.6926,53.28823,2022/05/06 23:00:00+00,Sat 07 May 2022,440,1087,0,3843938,3791758,240792,4084730,4032550,86.7447583908538,85.6366456164881,307
-7.6926,53.28823,2022/05/07 23:00:00+00,Sun 08 May 2022,275,437,0,3844213,3792195,240792,4085005,4032987,86.7505983872691,85.6459259017008,308
-7.6926,53.28823,2022/05/08 23:00:00+00,Mon 09 May 2022,27,32,0,3844240,3792227,240792,4085032,4033019,86.7511717687353,85.64660546492,309
-7.6926,53.28823,2022/05/09 23:00:00+00,Tue 10 May 2022,90,99,1,3844330,3792326,240793,4085123,4033119,86.75310427664,85.6487290999801,310
-7.6926,53.28823,2022/05/10 23:00:00+00,Wed 11 May 2022,126,132,0,3844456,3792458,240793,4085249,4033251,86.7557800568157,85.6515322982595,311
-7.6926,53.28823,2022/05/11 23:00:00+00,Thu 12 May 2022,250,397,0,3844706,3792855,240793,4085499,4033648,86.761089144466,85.6599631294481,312
-7.6926,53.28823,2022/05/12 23:00:00+00,Fri 13 May 2022,185,326,0,3844891,3793181,240793,4085684,4033974,86.7650178693272,85.6668861797441,313
-7.6926,53.28823,2022/05/13 23:00:00+00,Sat 14 May 2022,334,632,0,3845225,3793813,240793,4086018,4034606,86.772110810428,85.6803075533239,314
-7.6926,53.28823,2022/05/14 23:00:00+00,Sun 15 May 2022,169,254,0,3845394,3794067,240793,4086187,4034860,86.7756997536796,85.6857015863766,315
-7.6926,53.28823,2022/05/15 23:00:00+00,Mon 16 May 2022,31,41,0,3845425,3794108,240793,4086218,4034901,86.7763580805482,85.6865722767513,316
-7.6926,53.28823,2022/05/16 23:00:00+00,Tue 17 May 2022,102,96,0,3845527,3794204,240793,4086320,4034997,86.7785241883095,85.688610966409,317
-7.6926,53.28823,2022/05/17 23:00:00+00,Wed 18 May 2022,106,121,0,3845633,3794325,240793,4086426,4035118,86.7807752414732,85.6911805648317,318
-7.6926,53.28823,2022/05/18 23:00:00+00,Thu 19 May 2022,101,104,0,3845734,3794429,240793,4086527,4035222,86.7829201128839,85.6933891452942,319
-7.6926,53.28823,2022/05/19 23:00:00+00,Fri 20 May 2022,130,207,0,3845864,3794636,240793,4086657,4035429,86.7856808384621,85.6977850698687,320
-7.6926,53.28823,2022/05/20 23:00:00+00,Sat 21 May 2022,393,761,0,3846257,3795397,240793,4087050,4036190,86.7940267242483,85.7139459326761,321
-7.6926,53.28823,2022/05/21 23:00:00+00,Sun 22 May 2022,233,409,0,3846490,3795806,240793,4087283,4036599,86.7989747939384,85.7226316000719,322
-7.6926,53.28823,2022/05/22 23:00:00+00,Mon 23 May 2022,30,35,0,3846520,3795841,240793,4087313,4036634,86.7996118844564,85.723374872343,323
-7.6926,53.28823,2022/05/23 23:00:00+00,Tue 24 May 2022,79,82,0,3846599,3795923,240793,4087392,4036716,86.8012895561539,85.7251162530923,324
-7.6926,53.28823,2022/05/24 23:00:00+00,Wed 25 May 2022,89,133,0,3846688,3796056,240793,4087481,4036849,86.8031795913574,85.7279406877222,325
-7.6926,53.28823,2022/05/25 23:00:00+00,Thu 26 May 2022,135,156,0,3846823,3796212,240793,4087616,4037005,86.8060464986885,85.731253558416,326
-7.6926,53.28823,2022/05/26 23:00:00+00,Fri 27 May 2022,98,151,0,3846921,3796363,240793,4087714,4037156,86.8081276610475,85.7344602473568,327
-7.6926,53.28823,2022/05/27 23:00:00+00,Sat 28 May 2022,335,578,0,3847256,3796941,240793,4088049,4037734,86.8152418384988,85.7467348580042,328
-7.6926,53.28823,2022/05/28 23:00:00+00,Sun 29 May 2022,181,348,0,3847437,3797289,240793,4088230,4038082,86.8190856179576,85.7541251080134,329
-7.6926,53.28823,2022/05/29 23:00:00+00,Mon 30 May 2022,14,21,0,3847451,3797310,240793,4088244,4038103,86.819382926866,85.754571071376,330
-7.6926,53.28823,2022/05/30 23:00:00+00,Tue 31 May 2022,66,79,1,3847517,3797389,240794,4088311,4038183,86.8208057623563,85.7562699794241,331
-7.6926,53.28823,2022/05/31 23:00:00+00,Wed 01 Jun 2022,70,101,0,3847587,3797490,240794,4088381,4038284,86.8222923068984,85.7584148508348,332
-7.6926,53.28823,2022/06/01 23:00:00+00,Thu 02 Jun 2022,122,138,0,3847709,3797628,240794,4088503,4038422,86.8248831416717,85.7613454672178,333
-7.6926,53.28823,2022/06/02 23:00:00+00,Fri 03 Jun 2022,65,144,0,3847774,3797772,240794,4088568,4038566,86.8262635044608,85.7644035017043,334
-7.6926,53.28823,2022/06/03 23:00:00+00,Sat 04 Jun 2022,306,606,0,3848080,3798378,240794,4088874,4039172,86.8327618277447,85.7772727301686,335
-7.6926,53.28823,2022/06/04 23:00:00+00,Sun 05 Jun 2022,142,273,0,3848222,3798651,240794,4089016,4039445,86.8357773895301,85.7830702538827,336
-7.6926,53.28823,2022/06/05 23:00:00+00,Mon 06 Jun 2022,3,6,0,3848225,3798657,240794,4089019,4039451,86.8358410985819,85.7831976719863,337
-7.6926,53.28823,2021/04/20 23:00:00+00,Wed 21 Apr 2021,26719,9881,4,949150,399210,247,949397,399457,20.1617275516378,8.48300890206581,338
-7.6926,53.28823,2022/06/06 23:00:00+00,Tue 07 Jun 2022,30,50,0,3848255,3798707,240794,4089049,4039501,86.8364781890999,85.7842594895164,339
-7.6926,53.28823,2022/06/07 23:00:00+00,Wed 08 Jun 2022,41,76,0,3848296,3798783,240794,4089090,4039577,86.8373488794746,85.785873452162,340
-7.6926,53.28823,2022/06/08 23:00:00+00,Thu 09 Jun 2022,83,123,0,3848379,3798906,240794,4089173,4039700,86.8391114965745,85.788485523286,341
-7.6926,53.28823,2022/06/09 23:00:00+00,Fri 10 Jun 2022,58,107,0,3848437,3799013,240794,4089231,4039807,86.8403432049093,85.7907578128003,342
-7.6926,53.28823,2022/06/10 23:00:00+00,Sat 11 Jun 2022,191,559,0,3848628,3799572,240794,4089422,4040366,86.8443993478741,85.8026289327863,343
-7.6926,53.28823,2022/06/11 23:00:00+00,Sun 12 Jun 2022,143,287,0,3848771,3799859,240794,4089565,4040653,86.8474361460101,85.8087237654088,344
-7.6926,53.28823,2022/06/12 23:00:00+00,Mon 13 Jun 2022,20,45,0,3848791,3799904,240794,4089585,4040698,86.8478608730221,85.8096794011859,345
-7.6926,53.28823,2022/06/13 23:00:00+00,Tue 14 Jun 2022,39,53,0,3848830,3799957,240794,4089624,4040751,86.8486890906956,85.8108049277677,346
-7.6926,53.28823,2022/06/14 23:00:00+00,Wed 15 Jun 2022,70,122,0,3848900,3800079,240794,4089694,4040873,86.8501756352376,85.8133957625411,347
-7.6926,53.28823,2022/06/15 23:00:00+00,Thu 16 Jun 2022,82,85,0,3848982,3800164,240794,4089776,4040958,86.8519170159869,85.8152008523422,348
-7.6926,53.28823,2022/06/16 23:00:00+00,Fri 17 Jun 2022,63,93,0,3849045,3800257,240794,4089839,4041051,86.8532549060748,85.8171758329481,349
-7.6926,53.28823,2022/06/17 23:00:00+00,Sat 18 Jun 2022,223,487,0,3849268,3800744,240794,4090062,4041538,86.8579906122588,85.8275179356908,350
-7.6926,53.28823,2022/06/18 23:00:00+00,Sun 19 Jun 2022,78,129,0,3849346,3800873,240794,4090140,4041667,86.8596470476057,85.8302574249184,351
-7.6926,53.28823,2022/06/19 23:00:00+00,Mon 20 Jun 2022,8,27,0,3849354,3800900,240794,4090148,4041694,86.8598169384105,85.8308308063846,352
-7.6926,53.28823,2022/06/20 23:00:00+00,Tue 21 Jun 2022,78,167,1,3849432,3801067,240795,4090227,4041862,86.861494610108,85.8343985132856,353
-7.6926,53.28823,2022/06/21 23:00:00+00,Wed 22 Jun 2022,61,93,0,3849493,3801160,240795,4090288,4041955,86.8627900274947,85.8363734938915,354
-7.6926,53.28823,2022/06/22 23:00:00+00,Thu 23 Jun 2022,67,108,0,3849560,3801268,240795,4090355,4042063,86.864212862985,85.8386670197564,355
-7.6926,53.28823,2022/06/23 23:00:00+00,Fri 24 Jun 2022,59,88,1,3849619,3801356,240796,4090415,4042152,86.865487044021,85.8405570549599,356
-7.6926,53.28823,2022/06/24 23:00:00+00,Sat 25 Jun 2022,209,290,0,3849828,3801646,240796,4090624,4042442,86.8699254412967,85.8467155966342,357
-7.6926,53.28823,2022/06/25 23:00:00+00,Sun 26 Jun 2022,175,404,0,3850003,3802050,240796,4090799,4042846,86.8736418026519,85.8552950822771,358
-7.6926,53.28823,2022/06/26 23:00:00+00,Mon 27 Jun 2022,2,32,0,3850005,3802082,240796,4090801,4042878,86.8736842753531,85.8559746454963,359
-7.6926,53.28823,2022/06/27 23:00:00+00,Tue 28 Jun 2022,50,59,0,3850055,3802141,240796,4090851,4042937,86.8747460928831,85.8572275901818,360
-7.6926,53.28823,2022/06/28 23:00:00+00,Wed 29 Jun 2022,63,81,3,3850118,3802222,240799,4090917,4043021,86.8761476920228,85.8590114436323,361
-7.6926,53.28823,2022/06/29 23:00:00+00,Thu 30 Jun 2022,70,85,0,3850188,3802307,240799,4090987,4043106,86.8776342365649,85.8608165334333,362
-7.6926,53.28823,2022/06/30 23:00:00+00,Fri 01 Jul 2022,49,60,0,3850237,3802367,240799,4091036,4043166,86.8786748177443,85.8620907144694,363
-7.6926,53.28823,2022/07/01 23:00:00+00,Sat 02 Jul 2022,180,227,0,3850417,3802594,240799,4091216,4043393,86.8824973608525,85.8669113660559,364
-7.6926,53.28823,2022/07/02 23:00:00+00,Sun 03 Jul 2022,107,272,0,3850524,3802866,240799,4091323,4043665,86.8847696503668,85.8726876534193,365
-7.6926,53.28823,2022/07/03 23:00:00+00,Mon 04 Jul 2022,15,14,0,3850539,3802880,240799,4091338,4043679,86.8850881956259,85.8729849623278,366
-7.6926,53.28823,2022/07/04 23:00:00+00,Tue 05 Jul 2022,56,67,0,3850595,3802947,240799,4091394,4043746,86.8862774312595,85.8744077978181,367
-7.6926,53.28823,2022/07/05 23:00:00+00,Wed 06 Jul 2022,61,80,0,3850656,3803027,240799,4091455,4043826,86.8875728486462,85.8761067058661,368
-7.6926,53.28823,2022/07/06 23:00:00+00,Thu 07 Jul 2022,74,69,0,3850730,3803096,240799,4091529,4043895,86.8891443385907,85.8775720140576,369
-7.6926,53.28823,2022/07/07 23:00:00+00,Fri 08 Jul 2022,101,84,0,3850831,3803180,240799,4091630,4043979,86.8912892100014,85.8793558675081,370
-7.6926,53.28823,2022/07/08 23:00:00+00,Sat 09 Jul 2022,118,138,0,3850949,3803318,240799,4091748,4044117,86.8937950993723,85.8822864838911,371
-7.6926,53.28823,2022/07/09 23:00:00+00,Sun 10 Jul 2022,132,218,0,3851081,3803536,240799,4091880,4044335,86.8965982976517,85.8869160083221,372
-7.6926,53.28823,2022/07/10 23:00:00+00,Mon 11 Jul 2022,10,8,0,3851091,3803544,240799,4091890,4044343,86.8968106611577,85.8870858991269,373
-7.6926,53.28823,2022/07/11 23:00:00+00,Tue 12 Jul 2022,44,76,0,3851135,3803620,240799,4091934,4044419,86.8977450605841,85.8886998617726,374
-7.6926,53.28823,2022/07/12 23:00:00+00,Wed 13 Jul 2022,92,67,0,3851227,3803687,240799,4092026,4044486,86.8996988048394,85.8901226972629,375
-7.6926,53.28823,2022/07/13 23:00:00+00,Thu 14 Jul 2022,37,29,0,3851264,3803716,240799,4092063,4044515,86.9004845498117,85.8907385514303,376
-7.6926,53.28823,2022/01/08 00:00:00+00,Sat 08 Jan 2022,9791,738,1,3710567,3640296,240759,3951326,3881055,83.9117442752639,82.4194446821736,377
-7.6926,53.28823,2022/01/09 00:00:00+00,Sun 09 Jan 2022,7115,664,0,3717682,3640960,240759,3958441,3881719,84.0628409097908,82.4335456189727,378
-7.6926,53.28823,2022/01/10 00:00:00+00,Mon 10 Jan 2022,6659,504,0,3724341,3641464,240759,3965100,3882223,84.2042537684435,82.4442487396757,379
-7.6926,53.28823,2022/01/11 00:00:00+00,Tue 11 Jan 2022,4779,1364,1,3729120,3642828,240760,3969880,3883588,84.3057635243168,82.4732363582462,380
-7.6926,53.28823,2022/01/12 00:00:00+00,Wed 12 Jan 2022,7565,916,1,3736685,3643744,240761,3977446,3884505,84.4664377529648,82.4927100917474,381
-7.6926,53.28823,2022/01/13 00:00:00+00,Thu 13 Jan 2022,7328,813,0,3744013,3644557,240761,3984774,3885318,84.6220577301697,82.5099752447861,382
-7.6926,53.28823,2022/01/14 00:00:00+00,Fri 14 Jan 2022,10730,832,0,3754743,3645389,240761,3995504,3886150,84.8499237721195,82.5276438884862,383
-7.6926,53.28823,2022/01/15 00:00:00+00,Sat 15 Jan 2022,8358,651,2,3763101,3646040,240763,4003864,3886803,85.0274596631448,82.5415112254287,384
-7.6926,53.28823,2022/01/16 00:00:00+00,Sun 16 Jan 2022,6965,1215,1,3770066,3647255,240764,4010830,3888019,85.1753920814321,82.5673346277597,385
-7.6926,53.28823,2022/01/17 00:00:00+00,Mon 17 Jan 2022,2566,559,0,3772632,3647814,240764,4013396,3888578,85.2298845570745,82.5792057477457,386
-7.6926,53.28823,2022/01/18 00:00:00+00,Tue 18 Jan 2022,4057,447,3,3776689,3648261,240767,4017456,3889028,85.316104140515,82.5887621055162,387
-7.6926,53.28823,2022/01/19 00:00:00+00,Wed 19 Jan 2022,3490,622,0,3780179,3648883,240767,4020946,3889650,85.3902190041129,82.6019711155901,388
-7.6926,53.28823,2022/01/20 00:00:00+00,Thu 20 Jan 2022,3698,934,0,3783877,3649817,240767,4024644,3890584,85.4687510286357,82.6218058670515,389
-7.6926,53.28823,2022/01/21 00:00:00+00,Fri 21 Jan 2022,3257,976,0,3787134,3650793,240767,4027901,3891560,85.5379178225435,82.6425325452382,390
-7.6926,53.28823,2022/01/22 00:00:00+00,Sat 22 Jan 2022,4270,643,0,3791404,3651436,240767,4032171,3892203,85.6285970396103,82.6561875186747,391
-7.6926,53.28823,2022/01/23 00:00:00+00,Sun 23 Jan 2022,3092,677,0,3794496,3652113,240767,4035263,3892880,85.6942598356689,82.6705645280317,392
-7.6926,53.28823,2022/01/24 00:00:00+00,Mon 24 Jan 2022,647,461,0,3795143,3652574,240767,4035910,3893341,85.7079997545078,82.6803544856588,393
-7.6926,53.28823,2022/01/25 00:00:00+00,Tue 25 Jan 2022,694,1838,0,3795837,3654412,240767,4036604,3895179,85.7227377818249,82.7193868980636,394
-7.6926,53.28823,2022/01/26 00:00:00+00,Wed 26 Jan 2022,700,897,0,3796537,3655309,240767,4037304,3896076,85.7376032272457,82.7384359045528,395
-7.6926,53.28823,2022/01/27 00:00:00+00,Thu 27 Jan 2022,1275,1175,0,3797812,3656484,240767,4038579,3897251,85.7646795742621,82.7633886165091,396
-7.6926,53.28823,2022/01/28 00:00:00+00,Fri 28 Jan 2022,1032,3094,1,3798844,3659578,240768,4039612,3900346,85.7866167244331,82.8291151216195,397
-7.6926,53.28823,2022/01/29 00:00:00+00,Sat 29 Jan 2022,2328,3444,0,3801172,3663022,240768,4041940,3903790,85.8360549486325,82.9022531130897,398
-7.6926,53.28823,2022/01/30 00:00:00+00,Sun 30 Jan 2022,1636,7537,0,3802808,3670559,240768,4043576,3911327,85.8707976182159,83.0623114875703,399
-7.6926,53.28823,2022/01/31 00:00:00+00,Mon 31 Jan 2022,481,1392,0,3803289,3671951,240768,4044057,3912719,85.881012302855,83.091872487607,400
-7.6926,53.28823,2022/02/01 00:00:00+00,Tue 01 Feb 2022,753,3416,1,3804042,3675367,240769,4044811,3916136,85.8970245112082,83.164437097611,401
-7.6926,53.28823,2022/02/02 00:00:00+00,Wed 02 Feb 2022,650,2996,0,3804692,3678363,240769,4045461,3919132,85.910828139099,83.2280612040119,402
-7.6926,53.28823,2022/02/03 00:00:00+00,Thu 03 Feb 2022,905,2432,1,3805597,3680795,240770,4046367,3921565,85.9300682727435,83.2797292450244,403
-7.6926,53.28823,2022/02/04 00:00:00+00,Fri 04 Feb 2022,1173,6523,0,3806770,3687318,240770,4047540,3928088,85.9549785119986,83.4182539599954,404
-7.6926,53.28823,2022/02/05 00:00:00+00,Sat 05 Feb 2022,1777,5750,0,3808547,3693068,240770,4049317,3933838,85.9927155070168,83.5403629759517,405
-7.6926,53.28823,2022/02/06 00:00:00+00,Sun 06 Feb 2022,1408,7555,0,3809955,3700623,240770,4050725,3941393,86.0226162886632,83.7008036047431,406
-7.6926,53.28823,2022/02/07 00:00:00+00,Mon 07 Feb 2022,440,1350,0,3810395,3701973,240770,4051165,3942743,86.0319602829277,83.7294726780546,407
-7.6926,53.28823,2022/02/08 00:00:00+00,Tue 08 Feb 2022,902,1235,0,3811297,3703208,240770,4052067,3943978,86.0511154711699,83.7556995710469,408
-7.6926,53.28823,2022/02/09 00:00:00+00,Wed 09 Feb 2022,1332,1782,0,3812629,3704990,240770,4053399,3945760,86.0794022901705,83.7935427478181,409
-7.6926,53.28823,2022/02/10 00:00:00+00,Thu 10 Feb 2022,685,2548,0,3813314,3707538,240770,4054084,3948308,86.0939491903323,83.8476529691497,410
-7.6926,53.28823,2022/02/11 00:00:00+00,Fri 11 Feb 2022,551,4921,0,3813865,3712459,240770,4054635,3953229,86.1056504195135,83.9521570504578,411
-7.6926,53.28823,2022/02/12 00:00:00+00,Sat 12 Feb 2022,1399,5462,0,3815264,3717921,240770,4056034,3958691,86.1353600740044,84.068149997441,412
-7.6926,53.28823,2022/02/13 00:00:00+00,Sun 13 Feb 2022,1567,4706,0,3816831,3722627,240770,4057601,3963397,86.1686374353964,84.1680882633698,413
-7.6926,53.28823,2022/02/14 00:00:00+00,Mon 14 Feb 2022,172,952,0,3817003,3723579,240770,4057773,3964349,86.1722900876997,84.1883052691421,414
-7.6926,53.28823,2022/02/15 00:00:00+00,Tue 15 Feb 2022,650,818,1,3817653,3724397,240771,4058424,3965168,86.1861149519411,84.2056978402844,415
-7.6926,53.28823,2022/02/16 00:00:00+00,Wed 16 Feb 2022,801,1785,0,3818454,3726182,240771,4059225,3966953,86.2031252687726,84.2436047261074,416
-7.6926,53.28823,2022/02/17 00:00:00+00,Thu 17 Feb 2022,793,1191,2,3819247,3727373,240773,4060020,3968146,86.2200081675004,84.2689396923745,417
-7.6926,53.28823,2022/02/18 00:00:00+00,Fri 18 Feb 2022,793,3292,0,3820040,3730665,240773,4060813,3971438,86.2368485935271,84.3388497585533,418
-7.6926,53.28823,2022/02/19 00:00:00+00,Sat 19 Feb 2022,981,3555,0,3821021,3734220,240773,4061794,3974993,86.2576814534668,84.4143449849402,419
-7.6926,53.28823,2022/02/20 00:00:00+00,Sun 20 Feb 2022,1366,3587,0,3822387,3737807,240773,4063160,3978580,86.2866903083879,84.4905197745464,420
-7.6926,53.28823,2022/02/21 00:00:00+00,Mon 21 Feb 2022,252,994,1,3822639,3738801,240774,4063413,3979575,86.29206310509,84.5116499433945,421
-7.6926,53.28823,2022/02/22 00:00:00+00,Tue 22 Feb 2022,476,981,0,3823115,3739782,240774,4063889,3980556,86.3021716079761,84.5324828033342,422
-7.6926,53.28823,2022/02/23 00:00:00+00,Wed 23 Feb 2022,830,1271,1,3823945,3741053,240775,4064720,3981828,86.3198190153256,84.5594954412988,423
-7.6926,53.28823,2022/02/24 00:00:00+00,Thu 24 Feb 2022,659,1232,0,3824604,3742285,240775,4065379,3983060,86.3338137703718,84.5856586252394,424
-7.6926,53.28823,2022/02/25 00:00:00+00,Fri 25 Feb 2022,691,1226,0,3825295,3743511,240775,4066070,3984286,86.3484880886371,84.6116943910763,425
-7.6926,53.28823,2022/02/26 00:00:00+00,Sat 26 Feb 2022,959,2092,0,3826254,3745603,240775,4067029,3986378,86.3688537488636,84.6561208365338,426
-7.6926,53.28823,2022/02/27 00:00:00+00,Sun 27 Feb 2022,671,1783,0,3826925,3747386,240775,4067700,3988161,86.3831033401169,84.6939852496556,427
-7.6926,53.28823,2022/02/28 00:00:00+00,Mon 28 Feb 2022,81,428,0,3827006,3747814,240775,4067781,3988589,86.3848234845156,84.7030744077129,428
-7.6926,53.28823,2022/03/01 00:00:00+00,Tue 01 Mar 2022,129,939,1,3827135,3748753,240776,4067911,3989529,86.3875842100938,84.7230365772779,429
-7.6926,53.28823,2022/03/02 00:00:00+00,Wed 02 Mar 2022,207,996,2,3827342,3749749,240778,4068120,3990527,86.3920226073694,84.7442304551778,430
-7.6926,53.28823,2022/03/03 00:00:00+00,Thu 03 Mar 2022,279,1273,0,3827621,3751022,240778,4068399,3991800,86.3979475491871,84.771264329493,431
-7.6926,53.28823,2022/03/04 00:00:00+00,Fri 04 Mar 2022,734,1507,1,3828355,3752529,240779,4069134,3993308,86.4135562668789,84.8032887461995,432
-7.6926,53.28823,2021/04/21 23:00:00+00,Thu 22 Apr 2021,31622,12178,1,980772,411388,248,981020,411636,20.8332846666965,8.74164641603667,433
-7.6926,53.28823,2022/03/05 00:00:00+00,Sat 05 Mar 2022,963,3341,0,3829318,3755870,240779,4070097,3996649,86.4340068725078,84.8742393935578,434
-7.6926,53.28823,2022/03/06 00:00:00+00,Sun 06 Mar 2022,455,1915,0,3829773,3757785,240779,4070552,3998564,86.4436694120313,84.9149070049589,435
-7.6926,53.28823,2022/03/07 00:00:00+00,Mon 07 Mar 2022,113,123,1,3829886,3757908,240780,4070666,3998688,86.4460903559998,84.9175403124334,436
-7.6926,53.28823,2022/03/08 00:00:00+00,Tue 08 Mar 2022,120,492,0,3830006,3758400,240780,4070786,3999180,86.4486387180719,84.9279885969292,437
-7.6926,53.28823,2022/03/09 00:00:00+00,Wed 09 Mar 2022,128,345,1,3830134,3758745,240781,4070915,3999526,86.4513782072995,84.9353363742372,438
-7.6926,53.28823,2022/03/10 00:00:00+00,Thu 10 Mar 2022,258,507,0,3830392,3759252,240781,4071173,4000033,86.4568571857546,84.9461032039919,439
-7.6926,53.28823,2022/03/11 00:00:00+00,Fri 11 Mar 2022,493,2182,0,3830885,3761434,240781,4071666,4002215,86.4673267066009,84.9924409210035,440
-7.6926,53.28823,2022/03/12 00:00:00+00,Sat 12 Mar 2022,473,2390,2,3831358,3763824,240783,4072141,4004607,86.4774139731364,85.0432382716414,441
-7.6926,53.28823,2022/03/13 00:00:00+00,Sun 13 Mar 2022,358,1082,0,3831716,3764906,240783,4072499,4005689,86.4850165866516,85.0662160029918,442
-7.6926,53.28823,2022/03/14 00:00:00+00,Mon 14 Mar 2022,109,121,0,3831825,3765027,240783,4072608,4005810,86.4873313488672,85.0687856014145,443
-7.6926,53.28823,2022/03/15 00:00:00+00,Tue 15 Mar 2022,219,757,1,3832044,3765784,240784,4072828,4006568,86.4920033459994,85.0848827551701,444
-7.6926,53.28823,2022/03/16 00:00:00+00,Wed 16 Mar 2022,196,797,0,3832240,3766581,240784,4073024,4007365,86.4961656707172,85.1018081265992,445
-7.6926,53.28823,2022/03/18 00:00:00+00,Fri 18 Mar 2022,1,6,0,3832241,3766587,240784,4073025,4007371,86.4961869070678,85.1019355447028,446
-7.6926,53.28823,2022/03/19 00:00:00+00,Sat 19 Mar 2022,743,2779,0,3832984,3769366,240784,4073768,4010150,86.5119655155644,85.1609513630233,447
-7.6926,53.28823,2022/03/20 00:00:00+00,Sun 20 Mar 2022,395,1402,0,3833379,3770768,240784,4074163,4011552,86.5203538740519,85.1907247265661,448
-7.6926,53.28823,2022/03/21 00:00:00+00,Mon 21 Mar 2022,54,112,0,3833433,3770880,240784,4074217,4011664,86.5215006369843,85.1931031978334,449
-7.6926,53.28823,2022/03/22 00:00:00+00,Tue 22 Mar 2022,139,575,0,3833572,3771455,240784,4074356,4012239,86.5244524897179,85.205314099429,450
-7.6926,53.28823,2022/03/23 00:00:00+00,Wed 23 Mar 2022,102,221,0,3833674,3771676,240784,4074458,4012460,86.5266185974792,85.2100073329119,451
-7.6926,53.28823,2022/03/24 00:00:00+00,Thu 24 Mar 2022,148,245,0,3833822,3771921,240784,4074606,4012705,86.5297615773682,85.2152102388091,452
-7.6926,53.28823,2022/03/25 00:00:00+00,Fri 25 Mar 2022,435,1625,0,3834257,3773546,240784,4075041,4014330,86.5389993898796,85.2497193085359,453
-7.6926,53.28823,2021/04/22 23:00:00+00,Fri 23 Apr 2021,33611,12349,3,1014383,423737,251,1014634,423988,21.5471233558021,9.00395781866153,454
-7.6926,53.28823,2021/04/23 23:00:00+00,Sat 24 Apr 2021,23702,6992,2,1038085,430729,253,1038338,430982,22.0505098104507,9.15248485476566,455
-7.6926,53.28823,2021/04/24 23:00:00+00,Sun 25 Apr 2021,9751,300,2,1047836,431029,255,1048091,431284,22.2576279378633,9.15889823264719,456
-7.6926,53.28823,2021/04/25 23:00:00+00,Mon 26 Apr 2021,15593,3055,3,1063429,434084,258,1063687,434342,22.5888300618381,9.22383899278537,457
-7.6926,53.28823,2021/04/26 23:00:00+00,Tue 27 Apr 2021,25915,7811,9,1089344,441895,267,1089611,442162,23.1393612148212,9.38990725448602,458
-7.6926,53.28823,2021/04/27 23:00:00+00,Wed 28 Apr 2021,26036,8607,5,1115380,450502,272,1115652,450774,23.6923770208246,9.57279470586274,459
-7.6926,53.28823,2021/04/28 23:00:00+00,Thu 29 Apr 2021,31690,11331,6,1147070,461833,278,1147348,462111,24.3654843894772,9.81355121262747,460
-7.6926,53.28823,2021/04/29 23:00:00+00,Fri 30 Apr 2021,36112,13527,8,1183182,475360,286,1183468,475646,25.1325413731891,10.1009852180134,461
-7.6926,53.28823,2021/04/30 23:00:00+00,Sat 01 May 2021,16578,6689,18,1199760,482049,304,1200064,482353,25.4849798477651,10.2434174214951,462
-7.6926,53.28823,2021/05/01 23:00:00+00,Sun 02 May 2021,12463,909,15,1212223,482958,319,1212542,483277,25.7499670305657,10.2630398094505,463
-7.6926,53.28823,2021/05/02 23:00:00+00,Mon 03 May 2021,14262,922,21,1226485,483880,340,1226825,484220,26.0532858262013,10.2830656880673,464
-7.6926,53.28823,2021/05/03 23:00:00+00,Tue 04 May 2021,26659,6790,10,1253144,490670,350,1253494,491020,26.6196380603822,10.4274728721548,465
-7.6926,53.28823,2021/05/04 23:00:00+00,Wed 05 May 2021,32108,13456,69,1285252,504126,419,1285671,504545,27.3029601136739,10.7146945140348,466
-7.6926,53.28823,2021/05/05 23:00:00+00,Thu 06 May 2021,37286,14372,132,1322538,518498,551,1323089,519049,28.0975818804661,11.0227065431532,467
-7.6926,53.28823,2021/05/06 23:00:00+00,Fri 07 May 2021,40595,15071,97,1363133,533569,648,1363781,534217,28.9617314591263,11.3448195090708,468
-7.6926,53.28823,2021/05/07 23:00:00+00,Sat 08 May 2021,25620,7055,10,1388753,540624,658,1389411,541282,29.5060191250326,11.4948543260676,469
-7.6926,53.28823,2021/05/08 23:00:00+00,Sun 09 May 2021,19674,923,5,1408427,541547,663,1409090,542210,29.9239292685118,11.5145616594254,470
-7.6926,53.28823,2021/05/09 23:00:00+00,Mon 10 May 2021,28841,4646,171,1437268,546193,834,1438102,547027,30.5400382721511,11.6168571602709,471
-7.6926,53.28823,2021/05/10 23:00:00+00,Tue 11 May 2021,33922,14820,153,1471190,561013,987,1472177,562000,31.2636669188837,11.9348290378213,472
-7.6926,53.28823,2021/05/11 23:00:00+00,Wed 12 May 2021,31294,20940,173,1502484,581953,1160,1503644,583113,31.9319111632487,12.3831921080624,473
-7.6926,53.28823,2021/05/12 23:00:00+00,Thu 13 May 2021,35996,25479,152,1538480,607432,1312,1539792,608744,32.6995627647775,12.9275010103194,474
-7.6926,53.28823,2021/05/13 23:00:00+00,Fri 14 May 2021,38218,27943,236,1576698,635375,1548,1578246,636923,33.5161853907924,13.5259201339079,475
-7.6926,53.28823,2021/05/14 23:00:00+00,Sat 15 May 2021,28853,12450,22,1605551,647825,1570,1607121,649395,34.1293850143993,13.7907798986049,476
-7.6926,53.28823,2021/05/15 23:00:00+00,Sun 16 May 2021,23173,1173,9,1628724,648998,1579,1630303,650577,34.6216860940341,13.8158812650154,477
-7.6926,53.28823,2021/05/16 23:00:00+00,Mon 17 May 2021,35379,3947,118,1664103,652945,1697,1665800,654642,35.3755128313216,13.9022070302089,478
-7.6926,53.28823,2021/05/17 23:00:00+00,Tue 18 May 2021,39006,12493,127,1703109,665438,1824,1704933,667262,36.2065549393946,14.1702097747949,479
-7.6926,53.28823,2021/05/18 23:00:00+00,Wed 19 May 2021,37020,17589,209,1740129,683027,2033,1742162,685060,36.9971630359232,14.5481743427933,480
-7.6926,53.28823,2021/05/19 23:00:00+00,Thu 20 May 2021,39083,19643,136,1779212,702670,2169,1781381,704839,37.830031470148,14.9682081213326,481
-7.6926,53.28823,2021/05/20 23:00:00+00,Fri 21 May 2021,25835,23247,14934,1805047,725917,17103,1822150,743020,38.6958162478044,15.7790332236334,482
-7.6926,53.28823,2021/05/21 23:00:00+00,Sat 22 May 2021,16583,10247,13522,1821630,736164,30625,1852255,766789,39.3351365826507,16.2838000410711,483
-7.6926,53.28823,2021/05/22 23:00:00+00,Sun 23 May 2021,8215,5525,10205,1829845,741689,40830,1870675,782519,39.7263101607231,16.6178478360265,484
-7.6926,53.28823,2021/05/23 23:00:00+00,Mon 24 May 2021,22546,8213,8450,1852391,749902,49280,1901671,799182,40.3845520839549,16.9717091460927,485
-7.6926,53.28823,2021/05/24 23:00:00+00,Tue 25 May 2021,30339,16497,3222,1882730,766399,52502,1935232,818901,41.0972652464786,17.3904687435959,486
-7.6926,53.28823,2021/05/25 23:00:00+00,Wed 26 May 2021,19974,25444,3052,1902704,791843,55554,1958258,847397,41.5862534554197,17.995619790325,487
-7.6926,53.28823,2021/05/26 23:00:00+00,Thu 27 May 2021,17009,36034,550,1919713,827877,56104,1975817,883981,41.9591425356245,18.7725304407159,488
-7.6926,53.28823,2021/05/27 23:00:00+00,Fri 28 May 2021,27043,31822,1558,1946756,859699,57662,2004418,917361,42.5665233991667,19.4813998237808,489
-7.6926,53.28823,2021/05/28 23:00:00+00,Sat 29 May 2021,24474,7386,534,1971230,867085,58196,2029426,925281,43.0976020549992,19.6495917205415,490
-7.6926,53.28823,2021/05/29 23:00:00+00,Sun 30 May 2021,24247,1676,209,1995477,868761,58405,2053882,927166,43.6169582452998,19.6896222414246,491
-7.6926,53.28823,2021/05/30 23:00:00+00,Mon 31 May 2021,22583,7320,3443,2018060,876081,61848,2079908,937929,44.1696555060442,19.9181890829443,492
-7.6926,53.28823,2021/05/31 23:00:00+00,Tue 01 Jun 2021,27550,11511,3653,2045610,887592,65501,2111111,953093,44.8322933538505,20.2402171034595,493
-7.6926,53.28823,2021/06/01 23:00:00+00,Wed 02 Jun 2021,18691,20896,4008,2064301,908488,69509,2133810,977997,45.314337276145,20.7690871788294,494
-7.6926,53.28823,2021/06/02 23:00:00+00,Thu 03 Jun 2021,16687,30702,1977,2080988,939190,71486,2152474,1010676,45.710692523764,21.4630698801229,495
-7.6926,53.28823,2021/06/03 23:00:00+00,Fri 04 Jun 2021,28975,23343,153,2109963,962533,71639,2181602,1034172,46.329264944073,21.9620391738465,496
-7.6926,53.28823,2021/06/04 23:00:00+00,Sat 05 Jun 2021,20954,11491,33,2130917,974024,71672,2202589,1045696,46.7749522341384,22.2067668781736,497
-7.6926,53.28823,2021/06/05 23:00:00+00,Sun 06 Jun 2021,19940,3906,46,2150857,977930,71718,2222575,1049648,47.1993819372521,22.2906929357492,498
-7.6926,53.28823,2021/06/06 23:00:00+00,Mon 07 Jun 2021,19813,4588,45,2170670,982518,71763,2242433,1054281,47.6210933874889,22.3890809480841,499
-7.6926,53.28823,2021/06/07 23:00:00+00,Tue 08 Jun 2021,26401,18335,45,2197071,1000853,71808,2268879,1072661,48.1827099154857,22.7794050721324,500
-7.6926,53.28823,2021/06/08 23:00:00+00,Wed 09 Jun 2021,32794,20108,174,2229865,1020961,71982,2301847,1092943,48.8828299221029,23.2101207350241,501
-7.6926,53.28823,2021/06/09 23:00:00+00,Thu 10 Jun 2021,27689,27486,270,2257554,1048447,72252,2329806,1120699,49.4765770485592,23.7995568823084,502
-7.6926,53.28823,2021/06/10 23:00:00+00,Fri 11 Jun 2021,26434,32894,39,2283988,1081341,72291,2356279,1153632,50.0387669580223,24.4989336166546,503
-7.6926,53.28823,2021/06/11 23:00:00+00,Sat 12 Jun 2021,12212,19719,105,2296200,1101060,72396,2368596,1173456,50.3003350883761,24.9199230309709,504
-7.6926,53.28823,2021/06/12 23:00:00+00,Sun 13 Jun 2021,8549,18171,832,2304749,1119231,73228,2377977,1192459,50.4995532933651,25.3234774014437,505
-7.6926,53.28823,2021/06/13 23:00:00+00,Mon 14 Jun 2021,16017,31303,49,2320766,1150534,73277,2394043,1223811,50.8407365021225,25.9892794654896,506
-7.6926,53.28823,2021/06/14 23:00:00+00,Tue 15 Jun 2021,14693,41585,205,2335459,1192119,73482,2408941,1265601,51.1571156533777,26.8767465571097,507
-7.6926,53.28823,2021/06/15 23:00:00+00,Wed 16 Jun 2021,13466,48385,216,2348925,1240504,73698,2422623,1314202,51.4476714023021,27.9088544326741,508
-7.6926,53.28823,2021/06/16 23:00:00+00,Thu 17 Jun 2021,21567,42684,534,2370492,1283188,74232,2444724,1357420,51.9170159869371,28.8266470329527,509
-7.6926,53.28823,2021/06/17 23:00:00+00,Fri 18 Jun 2021,12013,50010,553,2382505,1333198,74785,2457290,1407983,52.1838719685906,29.9004206283964,510
-7.6926,53.28823,2021/06/18 23:00:00+00,Sat 19 Jun 2021,6310,32797,433,2388815,1365995,75218,2464033,1441213,52.3270686806938,30.6061045588711,511
-7.6926,53.28823,2021/06/19 23:00:00+00,Sun 20 Jun 2021,8514,26138,177,2397329,1392133,75395,2472724,1467528,52.5116338037681,31.1649391249392,512
-7.6926,53.28823,2021/06/20 23:00:00+00,Mon 21 Jun 2021,15468,32334,573,2412797,1424467,75968,2488765,1500435,52.8522861037604,31.8637637141698,513
-7.6926,53.28823,2021/06/21 23:00:00+00,Tue 22 Jun 2021,15139,43539,722,2427936,1468006,76690,2504626,1544696,53.1891158606445,32.8037058281253,514
-7.6926,53.28823,2021/06/22 23:00:00+00,Wed 23 Jun 2021,20081,39385,883,2448017,1507391,77573,2525590,1584964,53.6343147146461,33.6588511941306,515
-7.6926,53.28823,2021/06/23 23:00:00+00,Thu 24 Jun 2021,19020,44269,1032,2467037,1551660,78605,2545642,1630265,54.0601460168995,34.6208791127113,516
-7.6926,53.28823,2021/06/24 23:00:00+00,Fri 25 Jun 2021,15202,50117,843,2482239,1601777,79448,2561687,1681225,54.4008832622942,35.7030835393436,517
-7.6926,53.28823,2021/06/25 23:00:00+00,Sat 26 Jun 2021,9062,30556,510,2491301,1632333,79958,2571259,1712291,54.604157610248,36.3628120071176,518
-7.6926,53.28823,2021/06/26 23:00:00+00,Sun 27 Jun 2021,8727,30474,58,2500028,1662807,80016,2580044,1742823,54.7907189502787,37.0112002636705,519
-7.6926,53.28823,2021/06/27 23:00:00+00,Mon 28 Jun 2021,24228,24639,522,2524256,1687446,80538,2604794,1767984,55.3163186276561,37.5455280811449,520
-7.6926,53.28823,2021/06/28 23:00:00+00,Tue 29 Jun 2021,28139,31032,810,2552395,1718478,81348,2633743,1799826,55.9310897412075,38.2217359569853,521
-7.6926,53.28823,2021/06/29 23:00:00+00,Wed 30 Jun 2021,22569,36863,590,2574964,1755341,81938,2656902,1837279,56.4229023847785,39.0171009960486,522
-7.6926,53.28823,2021/06/30 23:00:00+00,Thu 01 Jul 2021,15016,48293,638,2589980,1803634,82576,2672556,1886210,56.7553362170882,40.0562168673112,523
-7.6926,53.28823,2021/07/01 23:00:00+00,Fri 02 Jul 2021,13669,47257,817,2603649,1850891,83393,2687042,1934284,57.0629659918958,41.0771331861088,524
-7.6926,53.28823,2021/07/02 23:00:00+00,Sat 03 Jul 2021,9310,30474,505,2612959,1881365,83898,2696857,1965263,57.2714007730456,41.7350140913804,525
-7.6926,53.28823,2021/07/03 23:00:00+00,Sun 04 Jul 2021,6447,27782,233,2619406,1909147,84131,2703537,1993278,57.413259595061,42.3299504534704,526
-7.6926,53.28823,2021/07/04 23:00:00+00,Mon 05 Jul 2021,15612,33454,5343,2635018,1942601,89474,2724492,2032075,57.8582673219072,43.1538571477415,527
-7.6926,53.28823,2021/07/05 23:00:00+00,Tue 06 Jul 2021,12407,48288,5486,2647425,1990889,94960,2742385,2085849,58.2382493432128,44.2958206649654,528
-7.6926,53.28823,2021/07/06 23:00:00+00,Wed 07 Jul 2021,19704,43753,5059,2667129,2034642,100019,2767148,2134661,58.7641250931479,45.3324094105065,529
-7.6926,53.28823,2021/07/07 23:00:00+00,Thu 08 Jul 2021,17769,45588,5997,2684898,2080230,106016,2790914,2186246,59.2688282015338,46.4278865562645,530
-7.6926,53.28823,2021/07/08 23:00:00+00,Fri 09 Jul 2021,13518,45084,6531,2698416,2125314,112547,2810963,2237861,59.6945957947354,47.5240007925406,531
-7.6926,53.28823,2021/07/09 23:00:00+00,Sat 10 Jul 2021,8629,23865,4364,2707045,2149179,116911,2823956,2266090,59.9705196980956,48.1234817336592,532
-7.6926,53.28823,2021/07/10 23:00:00+00,Sun 11 Jul 2021,15234,16108,2153,2722279,2165287,119064,2841343,2284351,60.339756125997,48.511278731986,533
-7.6926,53.28823,2021/07/11 23:00:00+00,Mon 12 Jul 2021,17105,31755,6091,2739384,2197042,125155,2864539,2322197,60.8323545145402,49.3149896568354,534
-7.6926,53.28823,2021/07/12 23:00:00+00,Tue 13 Jul 2021,20102,36565,8488,2759486,2233607,133643,2893129,2367250,61.4395017782258,50.271750960467,535
-7.6926,53.28823,2021/07/13 23:00:00+00,Wed 14 Jul 2021,20796,35704,9332,2780282,2269311,142975,2923257,2412286,62.0793105491359,51.2281512461384,536
-7.6926,53.28823,2021/07/14 23:00:00+00,Thu 15 Jul 2021,23631,28833,9583,2803913,2298144,152558,2956471,2450702,62.784654698001,52.0439668908305,537
-7.6926,53.28823,2021/07/15 23:00:00+00,Fri 16 Jul 2021,23527,27417,9165,2827440,2325561,161723,2989163,2487284,63.4789134718524,52.8208350685201,538
-7.6926,53.28823,2021/07/16 23:00:00+00,Sat 17 Jul 2021,11499,19421,4676,2838939,2344982,166399,3005338,2511381,63.8224114428253,53.332567408955,539
-7.6926,53.28823,2021/07/17 23:00:00+00,Sun 18 Jul 2021,16861,15814,1931,2855800,2360796,168330,3024130,2529126,64.2214849433212,53.7094064503716,540
-7.6926,53.28823,2021/07/18 23:00:00+00,Mon 19 Jul 2021,24882,18428,6253,2880682,2379224,174583,3055265,2553807,64.8826787192867,54.2335408195575,541
-7.6926,53.28823,2021/07/19 23:00:00+00,Tue 20 Jul 2021,30579,18177,7698,2911261,2397401,182281,3093542,2579682,65.6955425112452,54.7830313913611,542
-7.6926,53.28823,2021/07/20 23:00:00+00,Wed 21 Jul 2021,30354,19838,6887,2941615,2417239,189168,3130783,2606407,66.4864054439809,55.3505728611756,543
-7.6926,53.28823,2021/07/21 23:00:00+00,Thu 22 Jul 2021,33528,15918,6934,2975143,2433157,196102,3171245,2629259,67.3456706620029,55.8358659451121,544
-7.6926,53.28823,2021/07/22 23:00:00+00,Fri 23 Jul 2021,27088,20824,5615,3002231,2453981,201717,3203948,2655698,68.0401630357108,56.3973338186547,545
-7.6926,53.28823,2021/07/23 23:00:00+00,Sat 24 Jul 2021,15434,14807,2274,3017665,2468788,203991,3221656,2672779,68.4162163321552,56.7600719232722,546
-7.6926,53.28823,2021/07/24 23:00:00+00,Sun 25 Jul 2021,14716,13640,1043,3032381,2482428,205034,3237415,2687462,68.750879981278,57.0718852591482,547
-7.6926,53.28823,2021/07/25 23:00:00+00,Mon 26 Jul 2021,23826,18291,3421,3056207,2500719,208455,3264662,2709174,69.3295068261064,57.5329689033994,548
-7.6926,53.28823,2021/07/26 23:00:00+00,Tue 27 Jul 2021,25502,23902,3670,3081709,2524621,212125,3293834,2736746,69.9490136458418,58.1184975621731,549
-7.6926,53.28823,2021/07/27 23:00:00+00,Wed 28 Jul 2021,23433,25281,3261,3105142,2549902,215386,3320528,2765288,70.5158967887877,58.7246254810299,550
-7.6926,53.28823,2021/07/28 23:00:00+00,Thu 29 Jul 2021,19262,27860,2961,3124404,2577762,218347,3342751,2796109,70.9878322081961,59.3791510429066,551
-7.6926,53.28823,2021/07/29 23:00:00+00,Fri 30 Jul 2021,21948,22936,2118,3146352,2600698,220465,3366817,2821163,71.4989062217623,59.9112065708667,552
-7.6926,53.28823,2021/07/30 23:00:00+00,Sat 31 Jul 2021,13735,12478,907,3160087,2613176,221372,3381459,2834548,71.8098488672637,60.1954551236625,553
-7.6926,53.28823,2021/07/31 23:00:00+00,Sun 01 Aug 2021,11108,9322,368,3171195,2622498,221740,3392935,2844238,72.053557226762,60.4012353609872,554
-7.6926,53.28823,2021/08/01 23:00:00+00,Mon 02 Aug 2021,15019,16013,430,3186214,2638511,222170,3408384,2860681,72.3816376071984,60.7504246739211,555
-7.6926,53.28823,2021/08/02 23:00:00+00,Tue 03 Aug 2021,17336,25441,1111,3203550,2663952,223281,3426831,2887233,72.773384566737,61.3142922550817,556
-7.6926,53.28823,2021/08/03 23:00:00+00,Wed 04 Aug 2021,22107,17301,1575,3225657,2681253,224856,3450513,2906109,73.2763038216724,61.7151496090282,557
-7.6926,53.28823,2021/08/04 23:00:00+00,Thu 05 Aug 2021,13525,30041,1421,3239182,2711294,226277,3465459,2937571,73.5937023177565,62.3832876716402,558
-7.6926,53.28823,2021/08/05 23:00:00+00,Fri 06 Aug 2021,12205,24740,948,3251387,2736034,227225,3478612,2963259,73.8730240372129,62.9288070458813,559
-7.6926,53.28823,2021/08/06 23:00:00+00,Sat 07 Aug 2021,6327,8457,583,3257714,2744491,227808,3485522,2972299,74.0197672198665,63.1207836553153,560
-7.6926,53.28823,2021/08/07 23:00:00+00,Sun 08 Aug 2021,8626,11976,153,3266340,2756467,227961,3494301,2984428,74.2062011417936,63.3783593517562,561
-7.6926,53.28823,2021/08/08 23:00:00+00,Mon 09 Aug 2021,5537,23030,600,3271877,2779497,228561,3500438,3008058,74.3365286254326,63.8801743164603,562
-7.6926,53.28823,2021/08/09 23:00:00+00,Tue 10 Aug 2021,9350,26002,715,3281227,2805499,229276,3510503,3034775,74.5502724942327,64.44754589547,563
