X,Y,VaccinationDate,VaccineText,Dose1,Dose2,SingleDose,Dose1Cum,Dose2Cum,SingleDoseCum,PartiallyVacc,FullyVacc,PartialPercent,FullyPercent,ObjectId
-7.6926,53.28823,2022/04/06 23:00:00+00,Thu 07 Apr 2022,117,178,0,3841369,3784649,241033,4082402,4025682,85.076291247362,83.8942598747655,1
-7.6926,53.28823,2021/04/22 23:00:00+00,Fri 23 Apr 2021,33612,12362,3,1015763,424313,272,1016035,424585,21.1739288726376,8.84825088740922,2
-7.6926,53.28823,2021/12/11 00:00:00+00,Sat 11 Dec 2021,643,844,2,3674839,3615697,240971,3915810,3856668,81.6045534049151,80.3720481256821,3
-7.6926,53.28823,2022/04/07 23:00:00+00,Fri 08 Apr 2022,256,422,2,3841625,3785071,241035,4082660,4026106,85.0816679062852,83.9030959343914,4
-7.6926,53.28823,2021/04/23 23:00:00+00,Sat 24 Apr 2021,23707,7005,2,1039470,431318,274,1039744,431592,21.6680188199734,8.99427510863248,5
-7.6926,53.28823,2021/12/12 00:00:00+00,Sun 12 Dec 2021,685,1193,0,3675524,3616890,240971,3916495,3857861,81.6188286427542,80.3969099632616,6
-7.6926,53.28823,2022/04/08 23:00:00+00,Sat 09 Apr 2022,558,1018,0,3842183,3786089,241035,4083218,4027124,85.0932964941891,83.9243108133989,7
-7.6926,53.28823,2021/04/24 23:00:00+00,Sun 25 Apr 2021,9755,309,3,1049225,431627,277,1049502,431904,21.8713732299487,9.00077711477229,8
-7.6926,53.28823,2021/12/13 00:00:00+00,Mon 13 Dec 2021,721,1071,1,3676245,3617961,240972,3917217,3858933,81.6338749518341,80.4192501894856,9
-7.6926,53.28823,2020/12/28 00:00:00+00,Mon 28 Dec 2020,264,16,2,264,16,2,266,18,0.0055433770294543,0.000375115738835253,10
-7.6926,53.28823,2022/04/09 23:00:00+00,Sun 10 Apr 2022,413,719,0,3842596,3786808,241035,4083631,4027843,85.1019033164191,83.939294603189,11
-7.6926,53.28823,2020/12/29 00:00:00+00,Tue 29 Dec 2020,79,3,0,343,19,2,345,21,0.00718971832767569,0.000437635028641129,12
-7.6926,53.28823,2021/04/25 23:00:00+00,Mon 26 Apr 2021,15600,3060,4,1064825,434687,281,1065106,434968,22.1965568959923,9.06463014942736,13
-7.6926,53.28823,2021/12/14 00:00:00+00,Tue 14 Dec 2021,632,1203,3,3676877,3619164,240975,3917852,3860139,81.6471082015097,80.4443829439875,14
-7.6926,53.28823,2022/04/10 23:00:00+00,Mon 11 Apr 2022,70,93,1,3842666,3786901,241036,4083702,4027937,85.1033829396112,83.9412535409363,15
-7.6926,53.28823,2021/04/26 23:00:00+00,Tue 27 Apr 2021,25920,7824,9,1090745,442511,290,1091035,442801,22.7369111177845,9.2278680151105,16
-7.6926,53.28823,2020/12/30 00:00:00+00,Wed 30 Dec 2020,1063,2,0,1406,21,2,1408,23,0.0293423866822242,0.000479314555178379,17
-7.6926,53.28823,2021/12/15 00:00:00+00,Wed 15 Dec 2021,790,1258,1,3677667,3620422,240976,3918643,3861398,81.6635924542552,80.4706202059427,18
-7.6926,53.28823,2022/04/11 23:00:00+00,Tue 12 Apr 2022,197,178,0,3842863,3787079,241036,4083899,4028115,85.1074883729751,83.9449630187981,19
-7.6926,53.28823,2021/04/27 23:00:00+00,Wed 28 Apr 2021,26046,8622,5,1116791,451133,295,1117086,451428,23.2798077906954,9.40765265282893,20
-7.6926,53.28823,2020/12/31 00:00:00+00,Thu 31 Dec 2020,1039,1,0,2445,22,2,2447,24,0.0509949007183258,0.000500154318447004,21
-7.6926,53.28823,2021/12/16 00:00:00+00,Thu 16 Dec 2021,1048,1546,8,3678715,3621968,240984,3919699,3862952,81.6855992442668,80.5030051980622,22
-7.6926,53.28823,2022/04/12 23:00:00+00,Wed 13 Apr 2022,142,235,0,3843005,3787314,241036,4084041,4028350,85.1104476193592,83.9498603631662,23
-7.6926,53.28823,2021/04/28 23:00:00+00,Thu 29 Apr 2021,31697,11332,6,1148488,462465,301,1148789,462766,23.9404908056006,9.6439338887686,24
-7.6926,53.28823,2021/01/01 00:00:00+00,Fri 01 Jan 2021,819,0,0,3264,22,2,3266,24,0.0680626668353298,0.000500154318447004,25
-7.6926,53.28823,2021/12/17 00:00:00+00,Fri 17 Dec 2021,1197,2459,1,3679912,3624427,240985,3920897,3865412,81.7105652806626,80.554271015703,26
-7.6926,53.28823,2022/04/13 23:00:00+00,Thu 14 Apr 2022,359,431,0,3843364,3787745,241036,4084400,4028781,85.1179290943727,83.958842301135,27
-7.6926,53.28823,2021/04/29 23:00:00+00,Fri 30 Apr 2021,36100,13544,8,1184588,476009,309,1184897,476318,24.6929729777042,9.92635436058501,28
-7.6926,53.28823,2021/01/02 00:00:00+00,Sat 02 Jan 2021,1020,0,0,4284,22,2,4286,24,0.0893192253693275,0.000500154318447004,29
-7.6926,53.28823,2021/12/18 00:00:00+00,Sat 18 Dec 2021,1251,1185,0,3681163,3625612,240985,3922148,3866597,81.7366358245117,80.5789661351763,30
-7.6926,53.28823,2022/04/14 23:00:00+00,Fri 15 Apr 2022,446,990,0,3843810,3788735,241036,4084846,4029771,85.1272236287905,83.9794736667709,31
-7.6926,53.28823,2021/04/30 23:00:00+00,Sat 01 May 2021,16607,6699,20,1201195,482708,329,1201524,483037,25.0394757215716,10.0663767299869,32
-7.6926,53.28823,2021/01/03 00:00:00+00,Sun 03 Jan 2021,24,3,1,4308,25,3,4311,28,0.0898402194510431,0.000583513371521505,33
-7.6926,53.28823,2021/12/19 00:00:00+00,Sun 19 Dec 2021,550,890,2,3681713,3626502,240987,3922700,3867489,81.748139373836,80.5975552040119,34
-7.6926,53.28823,2022/04/15 23:00:00+00,Sat 16 Apr 2022,43,88,0,3843853,3788823,241036,4084889,4029859,85.128119738611,83.9813075659386,35
-7.6926,53.28823,2021/05/01 23:00:00+00,Sun 02 May 2021,12473,911,16,1213668,483619,345,1214013,483964,25.2997435250335,10.0856951905369,36
-7.6926,53.28823,2021/12/20 00:00:00+00,Mon 20 Dec 2021,517,618,1,3682230,3627120,240988,3923218,3868108,81.7589343712091,80.6104550174752,37
-7.6926,53.28823,2021/01/04 00:00:00+00,Mon 04 Jan 2021,1197,5,0,5505,30,3,5508,33,0.114785416083587,0.000687712187864631,38
-7.6926,53.28823,2022/04/16 23:00:00+00,Sun 17 Apr 2022,1,1,0,3843854,3788824,241036,4084890,4029860,85.1281405783743,83.9813284057018,39
-7.6926,53.28823,2021/05/02 23:00:00+00,Mon 03 May 2021,14273,934,21,1227941,484553,366,1228307,484919,25.5976271011952,10.1055971644584,40
-7.6926,53.28823,2021/12/21 00:00:00+00,Tue 21 Dec 2021,1405,1819,3,3683635,3628939,240991,3924626,3869930,81.7882767578913,80.6484250661506,41
-7.6926,53.28823,2021/01/05 00:00:00+00,Tue 05 Jan 2021,3542,14,0,9047,44,3,9050,47,0.188599857581058,0.000979468873625383,42
-7.6926,53.28823,2022/04/17 23:00:00+00,Mon 18 Apr 2022,36,62,1,3843890,3788886,241037,4084927,4029923,85.1289116496152,83.9826413107878,43
-7.6926,53.28823,2021/05/03 23:00:00+00,Tue 04 May 2021,26665,6804,10,1254606,491357,376,1254982,491733,26.1535277863858,10.2475993113709,44
-7.6926,53.28823,2021/12/22 00:00:00+00,Wed 22 Dec 2021,1165,1601,2,3684800,3630540,240993,3925793,3871533,81.8125967616258,80.6818312066702,45
-7.6926,53.28823,2021/01/06 00:00:00+00,Wed 06 Jan 2021,6789,14,0,15836,58,3,15839,61,0.330081010411754,0.00127122555938614,46
-7.6926,53.28823,2021/05/04 23:00:00+00,Wed 05 May 2021,32130,13465,70,1286736,504822,446,1287182,505268,26.8245681636355,10.5296655072117,47
-7.6926,53.28823,2022/04/18 23:00:00+00,Tue 19 Apr 2022,218,270,1,3844108,3789156,241038,4085146,4030194,85.133475557771,83.9882888866336,48
-7.6926,53.28823,2021/12/23 00:00:00+00,Thu 23 Dec 2021,928,1399,0,3685728,3631939,240993,3926721,3872932,81.8319360619391,80.710986035483,49
-7.6926,53.28823,2021/01/07 00:00:00+00,Thu 07 Jan 2021,11737,9,0,27573,67,3,27576,70,0.574677311895608,0.00145878342880376,50
-7.6926,53.28823,2021/05/05 23:00:00+00,Thu 06 May 2021,37301,14384,133,1324037,519206,579,1324616,519785,27.6046838618332,10.8321963505823,51
-7.6926,53.28823,2021/08/16 23:00:00+00,Tue 17 Aug 2021,12879,26873,530,3367357,2965103,233083,3600440,3198186,75.0323172628888,66.6494391290313,52
-7.6926,53.28823,2021/12/24 00:00:00+00,Fri 24 Dec 2021,101,163,0,3685829,3632102,240993,3926822,3873095,81.8340408780292,80.7143829168958,53
-7.6926,53.28823,2021/12/25 00:00:00+00,Sat 25 Dec 2021,1,7,0,3685830,3632109,240993,3926823,3873102,81.8340617177925,80.7145287952387,54
-7.6926,53.28823,2021/12/26 00:00:00+00,Sun 26 Dec 2021,12,13,0,3685842,3632122,240993,3926835,3873115,81.8343117949517,80.7147997121612,55
-7.6926,53.28823,2021/12/27 00:00:00+00,Mon 27 Dec 2021,391,590,0,3686233,3632712,240993,3927226,3873705,81.8424601423898,80.7270951724897,56
-7.6926,53.28823,2021/12/28 00:00:00+00,Tue 28 Dec 2021,468,750,0,3686701,3633462,240993,3927694,3874455,81.8522131515995,80.7427249949412,57
-7.6926,53.28823,2021/12/29 00:00:00+00,Wed 29 Dec 2021,1058,1312,0,3687759,3634774,240993,3928752,3875767,81.8742616211377,80.7700667643496,58
-7.6926,53.28823,2021/12/30 00:00:00+00,Thu 30 Dec 2021,1050,1199,1,3688809,3635973,240994,3929803,3876967,81.896164212333,80.7950744802719,59
-7.6926,53.28823,2021/12/31 00:00:00+00,Fri 31 Dec 2021,713,1682,0,3689522,3637655,240994,3930516,3878649,81.9110229635435,80.8301269620898,60
-7.6926,53.28823,2022/01/01 00:00:00+00,Sat 01 Jan 2022,69,100,0,3689591,3637755,240994,3930585,3878749,81.9124609072091,80.8322109384166,61
-7.6926,53.28823,2022/01/02 00:00:00+00,Sun 02 Jan 2022,272,629,0,3689863,3638384,240994,3930857,3879378,81.9181293228181,80.8453191495126,62
-7.6926,53.28823,2022/01/03 00:00:00+00,Mon 03 Jan 2022,3632,728,1,3693495,3639112,240995,3934490,3880107,81.9938401827731,80.8605113369354,63
-7.6926,53.28823,2022/01/04 00:00:00+00,Tue 04 Jan 2022,1187,783,1,3694682,3639895,240996,3935678,3880891,82.0185978215362,80.876849711338,64
-7.6926,53.28823,2022/01/05 00:00:00+00,Wed 05 Jan 2022,2139,913,0,3696821,3640808,240996,3937817,3881804,82.0631740751678,80.8958764152023,65
-7.6926,53.28823,2022/01/06 00:00:00+00,Thu 06 Jan 2022,2455,1697,1,3699276,3642505,240997,3940273,3883502,82.1143565337555,80.9312623332324,66
-7.6926,53.28823,2022/01/07 00:00:00+00,Fri 07 Jan 2022,4854,782,2,3704130,3643287,240999,3945129,3884286,82.215554424188,80.947600707635,67
-7.6926,53.28823,2022/01/08 00:00:00+00,Sat 08 Jan 2022,9789,744,2,3713919,3644031,241001,3954920,3885032,82.4195965463511,80.9631471710334,68
-7.6926,53.28823,2022/01/09 00:00:00+00,Sun 09 Jan 2022,7116,667,0,3721035,3644698,241001,3962036,3885699,82.5678923017706,80.9770472931336,69
-7.6926,53.28823,2022/01/10 00:00:00+00,Mon 10 Jan 2022,6663,509,1,3727698,3645207,241002,3968700,3886209,82.7067684841927,80.9876755724006,70
-7.6926,53.28823,2022/01/11 00:00:00+00,Tue 11 Jan 2022,4780,1369,1,3732478,3646576,241003,3973481,3887579,82.80640339238,81.0162260480786,71
-7.6926,53.28823,2022/01/12 00:00:00+00,Wed 12 Jan 2022,7558,927,1,3740036,3647503,241004,3981040,3888507,82.9639311629276,81.0355653483919,72
-7.6926,53.28823,2022/01/13 00:00:00+00,Thu 13 Jan 2022,7321,817,0,3747357,3648320,241004,3988361,3889324,83.1164990698172,81.0525914349823,73
-7.6926,53.28823,2022/01/14 00:00:00+00,Fri 14 Jan 2022,10723,835,0,3758080,3649155,241004,3999084,3890159,83.3399638513466,81.0699926373116,74
-7.6926,53.28823,2022/01/15 00:00:00+00,Sat 15 Jan 2022,8363,652,2,3766443,3649807,241006,4007449,3890813,83.5142884710887,81.0836218424893,75
-7.6926,53.28823,2022/01/16 00:00:00+00,Sun 16 Jan 2022,6965,1216,1,3773408,3651023,241007,4014415,3892030,83.6594582620179,81.1089838343872,76
-7.6926,53.28823,2022/01/17 00:00:00+00,Mon 17 Jan 2022,2562,562,0,3775970,3651585,241007,4016977,3892592,83.7128497355121,81.1206957813442,77
-7.6926,53.28823,2022/01/18 00:00:00+00,Tue 18 Jan 2022,4056,452,3,3780026,3652037,241010,4021036,3893047,83.7974383346195,81.1301778736314,78
-7.6926,53.28823,2022/01/19 00:00:00+00,Wed 19 Jan 2022,3486,622,0,3783512,3652659,241010,4024522,3893669,83.8700857493739,81.1431402063845,79
-7.6926,53.28823,2022/01/20 00:00:00+00,Thu 20 Jan 2022,3698,938,0,3787210,3653597,241010,4028220,3894607,83.9471511939413,81.1626879043305,80
-7.6926,53.28823,2022/01/21 00:00:00+00,Fri 21 Jan 2022,3252,977,0,3790462,3654574,241010,4031472,3895584,84.0149221040909,81.1830483530439,81
-7.6926,53.28823,2022/01/22 00:00:00+00,Sat 22 Jan 2022,4272,645,0,3794734,3655219,241010,4035744,3896229,84.1039495727744,81.1964900003522,82
-7.6926,53.28823,2022/01/23 00:00:00+00,Sun 23 Jan 2022,3092,680,0,3797826,3655899,241010,4038836,3896909,84.168386120801,81.2106610393749,83
-7.6926,53.28823,2022/01/24 00:00:00+00,Mon 24 Jan 2022,646,468,0,3798472,3656367,241010,4039482,3897377,84.1818486078726,81.2204140485846,84
-7.6926,53.28823,2022/01/25 00:00:00+00,Tue 25 Jan 2022,692,1836,0,3799164,3658203,241010,4040174,3899213,84.1962697240544,81.2586758539458,85
-7.6926,53.28823,2022/01/26 00:00:00+00,Wed 26 Jan 2022,700,897,0,3799864,3659100,241010,4040874,3900110,84.2108575583425,81.2773691215977,86
-7.6926,53.28823,2022/01/27 00:00:00+00,Thu 27 Jan 2022,1274,1179,0,3801138,3660279,241010,4042148,3901289,84.2374074167467,81.3019392024914,87
-7.6926,53.28823,2022/01/28 00:00:00+00,Fri 28 Jan 2022,1028,3095,1,3802166,3663374,241011,4043177,3904385,84.2588515331501,81.3664591095711,88
-7.6926,53.28823,2022/01/29 00:00:00+00,Sat 29 Jan 2022,2328,3445,0,3804494,3666819,241011,4045505,3907830,84.3073665020395,81.4382520940315,89
-7.6926,53.28823,2022/01/30 00:00:00+00,Sun 30 Jan 2022,1639,7536,0,3806133,3674355,241011,4047144,3915366,84.3415228740368,81.5953005500239,90
-7.6926,53.28823,2022/01/31 00:00:00+00,Mon 31 Jan 2022,481,1394,0,3806614,3675749,241011,4047625,3916760,84.351546800169,81.6243511800203,91
-7.6926,53.28823,2022/02/01 00:00:00+00,Tue 01 Feb 2022,749,3418,1,3807363,3679167,241012,4048375,3920179,84.3671766226204,81.6956023306358,92
-7.6926,53.28823,2022/02/02 00:00:00+00,Wed 02 Feb 2022,650,2996,0,3808013,3682163,241012,4049025,3923175,84.380722468745,81.7580382613886,93
-7.6926,53.28823,2022/02/03 00:00:00+00,Thu 03 Feb 2022,907,2436,1,3808920,3684599,241013,4049933,3925612,84.399644973793,81.8088247644742,94
-7.6926,53.28823,2022/02/04 00:00:00+00,Fri 04 Feb 2022,1172,6523,0,3810092,3691122,241013,4051105,3932135,84.4240691763438,81.9447625402754,95
-7.6926,53.28823,2022/02/05 00:00:00+00,Sat 05 Feb 2022,1777,5750,0,3811869,3696872,241013,4052882,3937885,84.4611014356721,82.06459117907,96
-7.6926,53.28823,2022/02/06 00:00:00+00,Sun 06 Feb 2022,1407,7555,0,3813276,3704427,241013,4054289,3945440,84.4904229825911,82.2220355905645,97
-7.6926,53.28823,2022/02/07 00:00:00+00,Mon 07 Feb 2022,439,1351,0,3813715,3705778,241013,4054728,3946791,84.499571638666,82.2501901107404,98
-7.6926,53.28823,2022/02/08 00:00:00+00,Tue 08 Feb 2022,899,1238,0,3814614,3707016,241013,4055627,3948029,84.5183065858445,82.275989737667,99
-7.6926,53.28823,2022/02/09 00:00:00+00,Wed 09 Feb 2022,1335,1784,0,3815949,3708800,241013,4056962,3949813,84.5461276698081,82.3131678753382,100
-7.6926,53.28823,2022/02/10 00:00:00+00,Thu 10 Feb 2022,686,2552,0,3816635,3711352,241013,4057648,3952365,84.5604237474104,82.3663509511997,101
-7.6926,53.28823,2022/02/11 00:00:00+00,Fri 11 Feb 2022,546,4922,0,3817181,3716274,241013,4058194,3957287,84.5718022581551,82.4689242660079,102
-7.6926,53.28823,2022/02/12 00:00:00+00,Sat 12 Feb 2022,1397,5463,0,3818578,3721737,241013,4059591,3962750,84.6009154074413,82.5827718927444,103
-7.6926,53.28823,2022/02/13 00:00:00+00,Sun 13 Feb 2022,1566,4706,0,3820144,3726443,241013,4061157,3967456,84.63355047672,82.6808438186866,104
-7.6926,53.28823,2022/02/14 00:00:00+00,Mon 14 Feb 2022,174,954,0,3820318,3727397,241013,4061331,3968410,84.6371765955287,82.7007249528448,105
-7.6926,53.28823,2022/02/15 00:00:00+00,Tue 15 Feb 2022,649,818,1,3820967,3728215,241014,4061981,3969229,84.6507224416533,82.7177927189618,106
-7.6926,53.28823,2022/02/16 00:00:00+00,Wed 16 Feb 2022,798,1786,0,3821765,3730001,241014,4062779,3971015,84.6673525727417,82.7550125361596,107
-7.6926,53.28823,2022/02/17 00:00:00+00,Thu 17 Feb 2022,790,1194,2,3822555,3731195,241016,4063571,3972211,84.6838576652505,82.7799368930289,108
-7.6926,53.28823,2022/02/18 00:00:00+00,Fri 18 Feb 2022,791,3295,0,3823346,3734490,241016,4064362,3975506,84.7003419179959,82.848603912999,109
-7.6926,53.28823,2022/02/19 00:00:00+00,Sat 19 Feb 2022,980,3555,0,3824326,3738045,241016,4065342,3979061,84.7207648859992,82.9226892714189,110
-7.6926,53.28823,2022/02/20 00:00:00+00,Sun 20 Feb 2022,1366,3588,0,3825692,3741633,241016,4066708,3982649,84.7492320026241,82.9974623420268,111
-7.6926,53.28823,2022/02/21 00:00:00+00,Mon 21 Feb 2022,254,995,1,3825946,3742628,241017,4066963,3983645,84.7545461422577,83.0182187462423,112
-7.6926,53.28823,2022/02/22 00:00:00+00,Tue 22 Feb 2022,476,981,1,3826422,3743609,241018,4067440,3984627,84.7644867093368,83.0386833937721,113
-7.6926,53.28823,2022/02/23 00:00:00+00,Wed 23 Feb 2022,829,1273,1,3827251,3744882,241019,4068270,3985901,84.7817837128497,83.0652332521764,114
-7.6926,53.28823,2022/02/24 00:00:00+00,Thu 24 Feb 2022,655,1234,0,3827906,3746116,241019,4068925,3987135,84.7954337577907,83.0909495200498,115
-7.6926,53.28823,2022/02/25 00:00:00+00,Fri 25 Feb 2022,692,1227,0,3828598,3747343,241019,4069617,3988362,84.8098548739726,83.1165199095804,116
-7.6926,53.28823,2022/02/26 00:00:00+00,Sat 26 Feb 2022,960,2092,0,3829558,3749435,241019,4070577,3990454,84.8298610467104,83.1601166943384,117
-7.6926,53.28823,2022/02/27 00:00:00+00,Sun 27 Feb 2022,671,1783,0,3830229,3751218,241019,4071248,3992237,84.8438445278637,83.1972739922464,118
-7.6926,53.28823,2022/02/28 00:00:00+00,Mon 28 Feb 2022,81,432,0,3830310,3751650,241019,4071329,3992669,84.8455325486885,83.2062767699784,119
-7.6926,53.28823,2022/03/01 00:00:00+00,Tue 01 Mar 2022,132,936,0,3830442,3752586,241019,4071461,3993605,84.8482833974399,83.2257827883978,120
-7.6926,53.28823,2022/03/02 00:00:00+00,Wed 02 Mar 2022,206,997,2,3830648,3753583,241021,4071669,3994604,84.8526180681998,83.2466017119032,121
-7.6926,53.28823,2022/03/03 00:00:00+00,Thu 03 Mar 2022,278,1277,0,3830926,3754860,241021,4071947,3995881,84.8584115223885,83.2732140895972,122
-7.6926,53.28823,2022/03/04 00:00:00+00,Fri 04 Mar 2022,735,1508,1,3831661,3756368,241022,4072683,3997390,84.8737495881542,83.3046612923696,123
-7.6926,53.28823,2022/03/05 00:00:00+00,Sat 05 Mar 2022,962,3341,0,3832623,3759709,241022,4073645,4000731,84.8937974404186,83.3742869414501,124
-7.6926,53.28823,2022/03/06 00:00:00+00,Sun 06 Mar 2022,455,1915,0,3833078,3761624,241022,4074100,4002646,84.9032795327058,83.4141950881095,125
-7.6926,53.28823,2022/03/07 00:00:00+00,Mon 07 Mar 2022,115,124,1,3833193,3761748,241023,4074216,4002771,84.905696945245,83.4168000585181,126
-7.6926,53.28823,2022/03/08 00:00:00+00,Tue 08 Mar 2022,120,493,0,3833313,3762241,241023,4074336,4003264,84.9081977168372,83.4270740618095,127
-7.6926,53.28823,2022/03/09 00:00:00+00,Wed 09 Mar 2022,129,345,1,3833442,3762586,241024,4074466,4003610,84.9109068860621,83.4342846199004,128
-7.6926,53.28823,2022/03/10 00:00:00+00,Thu 10 Mar 2022,259,508,0,3833701,3763094,241024,4074725,4004118,84.9163043847487,83.4448712196409,129
-7.6926,53.28823,2022/03/11 00:00:00+00,Fri 11 Mar 2022,492,2182,0,3834193,3765276,241024,4075217,4006300,84.9265575482769,83.490343583093,130
-7.6926,53.28823,2022/03/12 00:00:00+00,Sat 12 Mar 2022,472,2391,2,3834665,3767667,241026,4075691,4008693,84.9364355960662,83.5402131365949,131
-7.6926,53.28823,2022/03/13 00:00:00+00,Sun 13 Mar 2022,358,1082,0,3835023,3768749,241026,4076049,4009775,84.9438962313164,83.5627617604515,132
-7.6926,53.28823,2022/03/14 00:00:00+00,Mon 14 Mar 2022,109,122,0,3835132,3768871,241026,4076158,4009897,84.9461677655127,83.5653042115703,133
-7.6926,53.28823,2022/03/15 00:00:00+00,Tue 15 Mar 2022,222,755,1,3835354,3769626,241027,4076381,4010653,84.9508150327216,83.5810590726014,134
-7.6926,53.28823,2022/03/16 00:00:00+00,Wed 16 Mar 2022,195,798,0,3835549,3770424,241027,4076576,4011451,84.9548787865589,83.5976892036897,135
-7.6926,53.28823,2022/03/18 00:00:00+00,Fri 18 Mar 2022,3,6,0,3835552,3770430,241027,4076579,4011457,84.9549413058487,83.5978142422693,136
-7.6926,53.28823,2022/03/19 00:00:00+00,Sat 19 Mar 2022,743,2778,0,3836295,3773208,241027,4077322,4014235,84.9704252499573,83.6557071046296,137
-7.6926,53.28823,2022/03/20 00:00:00+00,Sun 20 Mar 2022,395,1402,0,3836690,3774610,241027,4077717,4015637,84.9786569564484,83.6849244527322,138
-7.6926,53.28823,2022/03/21 00:00:00+00,Mon 21 Mar 2022,56,112,0,3836746,3774722,241027,4077773,4015749,84.9798239831915,83.6872585062183,139
-7.6926,53.28823,2022/03/22 00:00:00+00,Tue 22 Mar 2022,141,576,0,3836887,3775298,241027,4077914,4016325,84.9827623898124,83.699262209861,140
-7.6926,53.28823,2022/03/23 00:00:00+00,Wed 23 Mar 2022,101,221,0,3836988,3775519,241027,4078015,4016546,84.9848672059025,83.7038677975434,141
-7.6926,53.28823,2022/03/24 00:00:00+00,Thu 24 Mar 2022,147,247,0,3837135,3775766,241027,4078162,4016793,84.987930651103,83.7090152190707,142
-7.6926,53.28823,2022/03/25 00:00:00+00,Fri 25 Mar 2022,434,1625,0,3837569,3777391,241027,4078596,4018418,84.9969751083616,83.7428798343822,143
-7.6926,53.28823,2022/03/26 00:00:00+00,Sat 26 Mar 2022,874,1848,1,3838443,3779239,241028,4079471,4020267,85.0152099012216,83.7814125566659,144
-7.6926,53.28823,2022/03/27 00:00:00+00,Sun 27 Mar 2022,380,803,0,3838823,3780042,241028,4079851,4021070,85.0231290112637,83.7981468865706,145
-7.6926,53.28823,2022/03/27 23:00:00+00,Mon 28 Mar 2022,44,53,1,3838867,3780095,241029,4079896,4021124,85.0240668006108,83.7992722337871,146
-7.6926,53.28823,2022/03/28 23:00:00+00,Tue 29 Mar 2022,137,193,3,3839004,3780288,241032,4080036,4021320,85.0269843674684,83.8033568273878,147
-7.6926,53.28823,2022/03/29 23:00:00+00,Wed 30 Mar 2022,109,135,0,3839113,3780423,241032,4080145,4021455,85.0292559016647,83.806170195429,148
-7.6926,53.28823,2022/07/31 23:00:00+00,Mon 01 Aug 2022,9,15,0,3855336,3809296,241051,4096387,4050347,85.3677353366737,84.4082726357862,149
-7.6926,53.28823,2022/03/30 23:00:00+00,Thu 31 Mar 2022,227,360,0,3839340,3780783,241032,4080372,4021815,85.0339865279266,83.8136725102057,150
-7.6926,53.28823,2022/03/31 23:00:00+00,Fri 01 Apr 2022,307,905,0,3839647,3781688,241032,4080679,4022720,85.0403843352501,83.8325324959639,151
-7.6926,53.28823,2022/04/01 23:00:00+00,Sat 02 Apr 2022,729,1538,1,3840376,3783226,241033,4081409,4024259,85.0555973624362,83.8646048916343,152
-7.6926,53.28823,2022/04/02 23:00:00+00,Sun 03 Apr 2022,538,815,0,3840914,3784041,241033,4081947,4025074,85.0668091550747,83.8815892986982,153
-7.6926,53.28823,2022/04/03 23:00:00+00,Mon 04 Apr 2022,50,51,0,3840964,3784092,241033,4081997,4025125,85.0678511432381,83.8826521266249,154
-7.6926,53.28823,2022/04/04 23:00:00+00,Tue 05 Apr 2022,130,169,0,3841094,3784261,241033,4082127,4025294,85.0705603124631,83.8861740466173,155
-7.6926,53.28823,2022/04/05 23:00:00+00,Wed 06 Apr 2022,158,210,0,3841252,3784471,241033,4082285,4025504,85.0738529950595,83.8905503969037,156
-7.6926,53.28823,2022/04/19 23:00:00+00,Wed 20 Apr 2022,250,607,0,3844358,3789763,241038,4085396,4030801,85.1386854985882,84.0009386229376,157
-7.6926,53.28823,2021/05/06 23:00:00+00,Fri 07 May 2021,40599,15091,98,1364636,534297,677,1365313,534974,28.4527997075764,11.1487315148695,158
-7.6926,53.28823,2022/04/20 23:00:00+00,Thu 21 Apr 2022,170,236,0,3844528,3789999,241038,4085566,4031037,85.1422282583439,84.005856807069,159
-7.6926,53.28823,2022/08/01 23:00:00+00,Tue 02 Aug 2022,36,28,0,3855372,3809324,241051,4096423,4050375,85.3684855681513,84.4088561491577,160
-7.6926,53.28823,2022/04/21 23:00:00+00,Fri 22 Apr 2022,195,254,0,3844723,3790253,241038,4085761,4031291,85.1462920121813,84.0111501069393,161
-7.6926,53.28823,2022/08/02 23:00:00+00,Wed 03 Aug 2022,93,139,0,3855465,3809463,241051,4096516,4050514,85.3704236661353,84.411752876252,162
-7.6926,53.28823,2021/08/17 23:00:00+00,Wed 18 Aug 2021,15244,25781,658,3382601,2990884,233741,3616342,3224625,75.3637111783865,67.2004216300904,163
-7.6926,53.28823,2021/05/07 23:00:00+00,Sat 08 May 2021,25632,7064,10,1390268,541361,687,1390955,542048,28.9871729173105,11.2961520002317,164
-7.6926,53.28823,2021/01/08 00:00:00+00,Fri 08 Jan 2021,12687,6,0,40260,73,3,40263,76,0.839071388484655,0.00158382200841551,165
-7.6926,53.28823,2022/04/22 23:00:00+00,Sat 23 Apr 2022,324,1010,0,3845047,3791263,241038,4086085,4032301,85.1530440954803,84.0321982678406,166
-7.6926,53.28823,2022/08/03 23:00:00+00,Thu 04 Aug 2022,45,52,0,3855510,3809515,241051,4096561,4050566,85.3713614554824,84.412836543942,167
-7.6926,53.28823,2021/08/18 23:00:00+00,Thu 19 Aug 2021,11372,25733,545,3393973,3016617,234286,3628259,3250903,75.6120586372587,67.7480489292634,168
-7.6926,53.28823,2021/05/08 23:00:00+00,Sun 09 May 2021,19678,931,5,1409946,542292,692,1410638,542984,29.3973619777269,11.3156580186512,169
-7.6926,53.28823,2021/01/09 00:00:00+00,Sat 09 Jan 2021,8077,7,0,48337,80,3,48340,83,1.00739415640534,0.00172970035129589,170
-7.6926,53.28823,2022/04/23 23:00:00+00,Sun 24 Apr 2022,181,252,0,3845228,3791515,241038,4086266,4032553,85.1568160926319,84.0374498881842,171
-7.6926,53.28823,2022/08/04 23:00:00+00,Fri 05 Aug 2022,96,91,0,3855606,3809606,241051,4096657,4050657,85.3733620727562,84.4147329623994,172
-7.6926,53.28823,2021/08/19 23:00:00+00,Fri 20 Aug 2021,14859,22271,686,3408832,3038888,234972,3643804,3273860,75.9360127572695,68.2264673746212,173
-7.6926,53.28823,2021/05/09 23:00:00+00,Mon 10 May 2021,28856,4659,171,1438802,546951,863,1439665,547814,30.0022777861253,11.4163140752386,174
-7.6926,53.28823,2021/01/10 00:00:00+00,Sun 10 Jan 2021,4787,5,1,53124,85,4,53128,89,1.10717494293552,0.00185473893090764,175
-7.6926,53.28823,2022/04/24 23:00:00+00,Mon 25 Apr 2022,41,59,1,3845269,3791574,241039,4086308,4032613,85.1576913626892,84.0387002739804,176
-7.6926,53.28823,2022/08/05 23:00:00+00,Sat 06 Aug 2022,74,130,0,3855680,3809736,241051,4096731,4050787,85.3749042152381,84.4174421316244,177
-7.6926,53.28823,2021/08/20 23:00:00+00,Sat 21 Aug 2021,11903,7992,246,3420735,3046880,235218,3655953,3282098,76.18919504122,68.3981453444281,178
-7.6926,53.28823,2021/05/10 23:00:00+00,Tue 11 May 2021,33926,14819,153,1472728,561770,1016,1473744,562786,30.7124760785567,11.7283270108965,179
-7.6926,53.28823,2021/01/11 00:00:00+00,Mon 11 Jan 2021,8349,8,0,61473,93,4,61477,97,1.28116612646527,0.00202145703705664,180
-7.6926,53.28823,2022/04/25 23:00:00+00,Tue 26 Apr 2022,144,238,0,3845413,3791812,241039,4086452,4032851,85.1606922885999,84.0436601376383,181
-7.6926,53.28823,2022/08/06 23:00:00+00,Sun 07 Aug 2022,28,80,0,3855708,3809816,241051,4096759,4050867,85.3754877286096,84.4191093126858,182
-7.6926,53.28823,2021/08/21 23:00:00+00,Sun 22 Aug 2021,8005,12260,162,3428740,3059140,235380,3664120,3294520,76.3593933878349,68.657016883751,183
-7.6926,53.28823,2021/05/11 23:00:00+00,Wed 12 May 2021,31302,20932,175,1504030,582702,1191,1505221,583893,31.3684493069633,12.1681918942074,184
-7.6926,53.28823,2021/01/12 00:00:00+00,Tue 12 Jan 2021,8896,14,0,70369,107,4,70373,111,1.46655666050296,0.00231321372281739,185
-7.6926,53.28823,2022/04/26 23:00:00+00,Wed 27 Apr 2022,122,208,0,3845535,3792020,241039,4086574,4033059,85.1632347397186,84.0479948083982,186
-7.6926,53.28823,2022/08/07 23:00:00+00,Mon 08 Aug 2022,11,15,0,3855719,3809831,241051,4096770,4050882,85.3757169660056,84.4194219091349,187
-7.6926,53.28823,2021/08/22 23:00:00+00,Mon 23 Aug 2021,10881,15397,291,3439621,3074537,235671,3675292,3310208,76.5922152230719,68.9839510899092,188
-7.6926,53.28823,2021/05/12 23:00:00+00,Thu 13 May 2021,36008,25486,152,1540038,608188,1343,1541381,609531,32.1220151467567,12.7024817448884,189
-7.6926,53.28823,2021/01/13 00:00:00+00,Wed 13 Jan 2021,9899,4,0,80268,111,4,80272,115,1.67284947709908,0.0023965727758919,190
-7.6926,53.28823,2022/04/27 23:00:00+00,Thu 28 Apr 2022,100,130,0,3845635,3792150,241039,4086674,4033189,85.1653187160455,84.0507039776231,191
-7.6926,53.28823,2022/08/08 23:00:00+00,Tue 09 Aug 2022,47,42,0,3855766,3809873,241051,4096817,4050924,85.3766964348792,84.4202971791922,192
-7.6926,53.28823,2021/08/23 23:00:00+00,Tue 24 Aug 2021,9721,22932,384,3449342,3097469,236055,3685397,3333524,76.8028010309014,69.4698510102805,193
-7.6926,53.28823,2021/05/13 23:00:00+00,Fri 14 May 2021,38233,27954,237,1578271,636142,1580,1579851,637722,32.9237208397007,13.2899755111942,194
-7.6926,53.28823,2021/01/14 00:00:00+00,Thu 14 Jan 2021,8096,6,0,88364,117,4,88368,121,1.84156820052187,0.00252161135550365,195
-7.6926,53.28823,2022/04/28 23:00:00+00,Fri 29 Apr 2022,168,222,0,3845803,3792372,241039,4086842,4033411,85.1688197962746,84.0553304050687,196
-7.6926,53.28823,2022/08/09 23:00:00+00,Wed 10 Aug 2022,55,94,1,3855821,3809967,241052,4096873,4051019,85.3778634616222,84.4222769567027,197
-7.6926,53.28823,2021/08/24 23:00:00+00,Wed 25 Aug 2021,9426,19546,317,3458768,3117015,236372,3695140,3353387,77.0058428444276,69.8837912280852,198
-7.6926,53.28823,2021/08/25 23:00:00+00,Thu 26 Aug 2021,8596,19453,369,3467364,3136468,236741,3704105,3373209,77.1926713221308,70.2968770155959,199
-7.6926,53.28823,2021/08/26 23:00:00+00,Fri 27 Aug 2021,9731,19227,432,3477095,3155695,237173,3714268,3392868,77.4044658362299,70.7065659216938,200
-7.6926,53.28823,2021/08/27 23:00:00+00,Sat 28 Aug 2021,9933,7940,155,3487028,3163635,237328,3724356,3400963,77.6146973680838,70.8752638053533,201
-7.6926,53.28823,2021/08/28 23:00:00+00,Sun 29 Aug 2021,8803,9198,30,3495831,3172833,237358,3733189,3410191,77.7987749970356,71.0675731407961,202
-7.6926,53.28823,2021/08/29 23:00:00+00,Mon 30 Aug 2021,5073,11156,85,3500904,3183989,237443,3738347,3421432,77.9062664959751,71.3018329196988,203
-7.6926,53.28823,2021/08/30 23:00:00+00,Tue 31 Aug 2021,4076,12914,145,3504980,3196903,237588,3742568,3434491,77.994231136732,71.5739793882237,204
-7.6926,53.28823,2021/08/31 23:00:00+00,Wed 01 Sep 2021,4987,12556,184,3509967,3209459,237772,3747739,3447231,78.101993552594,71.839477972266,205
-7.6926,53.28823,2021/09/01 23:00:00+00,Thu 02 Sep 2021,5014,12377,249,3514981,3221836,238021,3753002,3459857,78.2116732266768,72.1026008232957,206
-7.6926,53.28823,2021/09/02 23:00:00+00,Fri 03 Sep 2021,4784,16100,167,3519765,3237936,238188,3757953,3476124,78.3148508946198,72.4416012523864,207
-7.6926,53.28823,2021/09/03 23:00:00+00,Sat 04 Sep 2021,4631,10590,136,3524396,3248526,238324,3762720,3486850,78.4141940461213,72.6651285532057,208
-7.6926,53.28823,2021/09/04 23:00:00+00,Sun 05 Sep 2021,5310,11912,1,3529706,3260438,238325,3768031,3498763,78.524874028841,72.9133926530248,209
-7.6926,53.28823,2021/09/05 23:00:00+00,Mon 06 Sep 2021,2169,9698,76,3531875,3270136,238401,3770276,3508537,78.571659297379,73.1170804992124,210
-7.6926,53.28823,2021/09/06 23:00:00+00,Tue 07 Sep 2021,3035,10035,160,3534910,3280171,238561,3773471,3518732,78.6382423410223,73.329541885736,211
-7.6926,53.28823,2021/09/07 23:00:00+00,Wed 08 Sep 2021,2614,14805,191,3537524,3294976,238752,3776276,3533728,78.6966978769908,73.6420549757123,212
-7.6926,53.28823,2021/09/08 23:00:00+00,Thu 09 Sep 2021,3128,14823,138,3540652,3309799,238890,3779542,3548689,78.7647605438261,73.9538386739742,213
-7.6926,53.28823,2021/09/09 23:00:00+00,Fri 10 Sep 2021,3389,13951,116,3544041,3323750,239006,3783047,3562756,78.8378039140827,74.246991623874,214
-7.6926,53.28823,2021/09/10 23:00:00+00,Sat 11 Sep 2021,2564,11347,62,3546605,3335097,239068,3785673,3574165,78.8925291324261,74.4847524830057,215
-7.6926,53.28823,2021/09/11 23:00:00+00,Sun 12 Sep 2021,2043,12885,1,3548648,3347982,239069,3787717,3587051,78.9351256085471,74.7532936724852,216
-7.6926,53.28823,2021/09/12 23:00:00+00,Mon 13 Sep 2021,1623,7750,52,3550271,3355732,239121,3789392,3594853,78.9700322120221,74.915885505507,217
-7.6926,53.28823,2021/09/13 23:00:00+00,Tue 14 Sep 2021,1555,10794,82,3551826,3366526,239203,3791029,3605729,79.0041469044928,75.1425387708166,218
-7.6926,53.28823,2021/09/14 23:00:00+00,Wed 15 Sep 2021,3291,12380,138,3555117,3378906,239341,3794458,3618247,79.0756064527409,75.4034109274132,219
-7.6926,53.28823,2021/09/15 23:00:00+00,Thu 16 Sep 2021,1919,10582,115,3557036,3389488,239456,3796492,3628944,79.1179945312293,75.6263338750977,220
-7.6926,53.28823,2021/09/16 23:00:00+00,Fri 17 Sep 2021,2563,14623,95,3559599,3404111,239551,3799150,3643662,79.1733866219973,75.9330535108853,221
-7.6926,53.28823,2021/09/17 23:00:00+00,Sat 18 Sep 2021,2293,11242,48,3561892,3415353,239599,3801491,3654952,79.2221725078092,76.1683344381881,222
-7.6926,53.28823,2021/09/18 23:00:00+00,Sun 19 Sep 2021,1864,8496,16,3563756,3423849,239615,3803371,3663464,79.2613512627542,76.3457225031307,223
-7.6926,53.28823,2021/09/19 23:00:00+00,Mon 20 Sep 2021,964,5634,35,3564720,3429483,239650,3804370,3669133,79.2821701862595,76.4638631211005,224
-7.6926,53.28823,2021/09/20 23:00:00+00,Tue 21 Sep 2021,1477,6680,90,3566197,3436163,239740,3805937,3675903,79.3148260953015,76.6049483184291,225
-7.6926,53.28823,2021/09/21 23:00:00+00,Wed 22 Sep 2021,1902,8159,97,3568099,3444322,239837,3807936,3684159,79.3564847820755,76.7770014039749,226
-7.6926,53.28823,2021/09/22 23:00:00+00,Thu 23 Sep 2021,1691,8741,89,3569790,3453063,239926,3809716,3692989,79.3935795606936,76.9610165136368,227
-7.6926,53.28823,2021/09/23 23:00:00+00,Fri 24 Sep 2021,1914,7399,81,3571704,3460462,240007,3811711,3700469,79.4351548884145,77.1168979428861,228
-7.6926,53.28823,2021/09/24 23:00:00+00,Sat 25 Sep 2021,2422,6609,53,3574126,3467071,240060,3814186,3707131,79.4867333025044,77.2557324457817,229
-7.6926,53.28823,2021/09/25 23:00:00+00,Sun 26 Sep 2021,1549,7101,0,3575675,3474172,240060,3815735,3714232,79.5190140958075,77.4037156047522,230
-7.6926,53.28823,2021/09/26 23:00:00+00,Mon 27 Sep 2021,1179,3833,45,3576854,3478005,240105,3816959,3718110,79.5445219660483,77.4845322067079,231
-7.6926,53.28823,2021/09/27 23:00:00+00,Tue 28 Sep 2021,1455,5150,93,3578309,3483155,240198,3818507,3723353,79.5767819195881,77.5937950855253,232
-7.6926,53.28823,2021/09/28 23:00:00+00,Wed 29 Sep 2021,1654,3631,80,3579963,3486786,240278,3820241,3727064,79.6129180690959,77.6711314470152,233
-7.6926,53.28823,2021/09/29 23:00:00+00,Thu 30 Sep 2021,1275,3986,78,3581238,3490772,240356,3821594,3731128,79.6411142687983,77.7558242449389,234
-7.6926,53.28823,2021/09/30 23:00:00+00,Fri 01 Oct 2021,1871,5195,42,3583109,3495967,240398,3823507,3736365,79.6809807359312,77.8649620851767,235
-7.6926,53.28823,2021/10/01 23:00:00+00,Sat 02 Oct 2021,1684,4102,41,3584793,3500069,240439,3825232,3740508,79.7169293275696,77.9513012243986,236
-7.6926,53.28823,2021/10/02 23:00:00+00,Sun 03 Oct 2021,1197,3022,9,3585990,3503091,240448,3826438,3743539,79.7420620820716,78.0144665468658,237
-7.6926,53.28823,2021/10/03 23:00:00+00,Mon 04 Oct 2021,348,1243,18,3586338,3504334,240466,3826804,3744800,79.7496894354279,78.0407454883476,238
-7.6926,53.28823,2021/10/04 23:00:00+00,Tue 05 Oct 2021,960,2837,70,3587298,3507171,240536,3827834,3747707,79.7711543915946,78.1013266801694,239
-7.6926,53.28823,2021/10/05 23:00:00+00,Wed 06 Oct 2021,971,2581,40,3588269,3509752,240576,3828845,3750328,79.7922233922592,78.1559476996965,240
-7.6926,53.28823,2021/10/06 23:00:00+00,Thu 07 Oct 2021,1213,2713,44,3589482,3512465,240620,3830102,3753085,79.8184189746878,78.2134029270281,241
-7.6926,53.28823,2021/10/07 23:00:00+00,Fri 08 Oct 2021,916,2746,48,3590398,3515211,240668,3831066,3755879,79.8385085064788,78.2716292256006,242
-7.6926,53.28823,2021/10/08 23:00:00+00,Sat 09 Oct 2021,723,2368,23,3591121,3517579,240691,3831812,3758270,79.8540549698772,78.3214570995759,243
-7.6926,53.28823,2021/10/09 23:00:00+00,Sun 10 Oct 2021,1518,3927,2,3592639,3521506,240693,3833332,3762199,79.8857314100455,78.4033365294584,244
-7.6926,53.28823,2021/10/10 23:00:00+00,Mon 11 Oct 2021,335,1139,19,3592974,3522645,240712,3833686,3763357,79.8931086862426,78.4274689753234,245
-7.6926,53.28823,2021/10/11 23:00:00+00,Tue 12 Oct 2021,563,1626,21,3593537,3524271,240733,3834270,3765004,79.9052791079914,78.4617920654268,246
-7.6926,53.28823,2021/10/12 23:00:00+00,Wed 13 Oct 2021,989,2080,11,3594526,3526351,240744,3835270,3767095,79.9261188712601,78.5053680104215,247
-7.6926,53.28823,2021/10/13 23:00:00+00,Thu 14 Oct 2021,654,1610,9,3595180,3527961,240753,3835933,3768714,79.9399356343072,78.5391075871535,248
-7.6926,53.28823,2021/10/14 23:00:00+00,Fri 15 Oct 2021,957,2080,9,3596137,3530041,240762,3836899,3770803,79.9600668456247,78.5826418526216,249
-7.6926,53.28823,2021/10/15 23:00:00+00,Sat 16 Oct 2021,1383,2653,14,3597520,3532694,240776,3838296,3773470,79.9891799949109,78.638221501259,250
-7.6926,53.28823,2021/10/16 23:00:00+00,Sun 17 Oct 2021,1706,2892,2,3599226,3535586,240778,3840004,3776364,80.0247743105737,78.6985317761584,251
-7.6926,53.28823,2021/10/17 23:00:00+00,Mon 18 Oct 2021,679,1257,6,3599905,3536843,240784,3840689,3777627,80.0390495484127,78.7248523971667,252
-7.6926,53.28823,2021/10/18 23:00:00+00,Tue 19 Oct 2021,1341,1810,13,3601246,3538653,240797,3842043,3779450,80.0672665878785,78.7628432856054,253
-7.6926,53.28823,2021/10/19 23:00:00+00,Wed 20 Oct 2021,2263,2339,0,3603509,3540992,240797,3844306,3781789,80.1144269721554,78.8115874918907,254
-7.6926,53.28823,2021/10/20 23:00:00+00,Thu 21 Oct 2021,1731,1857,11,3605240,3542849,240808,3846048,3783657,80.1507298397693,78.8505161696765,255
-7.6926,53.28823,2021/10/21 23:00:00+00,Fri 22 Oct 2021,1508,1937,3,3606748,3544786,240811,3847559,3785597,80.1822187220682,78.8909453104176,256
-7.6926,53.28823,2021/10/22 23:00:00+00,Sat 23 Oct 2021,2018,1707,1,3608766,3546493,240812,3849578,3787305,80.2242942041076,78.9265396260805,257
-7.6926,53.28823,2021/10/23 23:00:00+00,Sun 24 Oct 2021,1956,2189,2,3610722,3548682,240814,3851536,3789496,80.2650984605875,78.972199547402,258
-7.6926,53.28823,2021/10/24 23:00:00+00,Mon 25 Oct 2021,1235,863,2,3611957,3549545,240816,3852773,3790361,80.2908772477508,78.9902259426294,259
-7.6926,53.28823,2021/10/25 23:00:00+00,Tue 26 Oct 2021,1247,1237,6,3613204,3550782,240822,3854026,3791604,80.3169894711264,79.0161297683723,260
-7.6926,53.28823,2021/10/26 23:00:00+00,Wed 27 Oct 2021,1568,1432,6,3614772,3552214,240828,3855600,3793042,80.3497912585112,79.0460973479526,261
-7.6926,53.28823,2021/10/27 23:00:00+00,Thu 28 Oct 2021,2159,1698,5,3616931,3553912,240833,3857764,3794745,80.3948885062245,79.081587464799,262
-7.6926,53.28823,2021/10/28 23:00:00+00,Fri 29 Oct 2021,2145,1378,2,3619076,3555290,240835,3859911,3796125,80.4396314779623,79.1103463381097,263
-7.6926,53.28823,2021/10/29 23:00:00+00,Sat 30 Oct 2021,2020,1455,1,3621096,3556745,240836,3861932,3797581,80.4817486395281,79.1406890334289,264
-7.6926,53.28823,2021/10/30 23:00:00+00,Sun 31 Oct 2021,1597,1320,0,3622693,3558065,240836,3863529,3798901,80.5150297414681,79.1681975209434,265
-7.6926,53.28823,2021/11/01 00:00:00+00,Mon 01 Nov 2021,290,297,2,3622983,3558362,240838,3863821,3799200,80.5211149523426,79.1744286101608,266
-7.6926,53.28823,2021/11/02 00:00:00+00,Tue 02 Nov 2021,1101,1098,10,3624084,3559460,240848,3864932,3800308,80.544267929334,79.1975190678624,267
-7.6926,53.28823,2021/11/03 00:00:00+00,Wed 03 Nov 2021,2538,1883,7,3626622,3561343,240855,3867477,3802198,80.5973051268527,79.2369062204401,268
-7.6926,53.28823,2021/11/04 00:00:00+00,Thu 04 Nov 2021,1536,1288,2,3628158,3562631,240857,3869015,3803488,80.6293566827598,79.2637895150566,269
-7.6926,53.28823,2021/11/05 00:00:00+00,Fri 05 Nov 2021,1631,1102,4,3629789,3563733,240861,3870650,3804594,80.663429695704,79.2868382932317,270
-7.6926,53.28823,2021/11/06 00:00:00+00,Sat 06 Nov 2021,1821,1360,6,3631610,3565093,240867,3872477,3805960,80.7015039431958,79.3153054098567,271
-7.6926,53.28823,2021/11/07 00:00:00+00,Sun 07 Nov 2021,697,775,0,3632307,3565868,240867,3873174,3806735,80.716029258194,79.3314562263898,272
-7.6926,53.28823,2021/11/08 00:00:00+00,Mon 08 Nov 2021,516,534,4,3632823,3566402,240871,3873694,3807273,80.7268659350937,79.3426680190284,273
-7.6926,53.28823,2021/11/09 00:00:00+00,Tue 09 Nov 2021,1372,1072,4,3634195,3567474,240875,3875070,3808349,80.7555414493514,79.3650916043054,274
-7.6926,53.28823,2021/11/10 00:00:00+00,Wed 10 Nov 2021,1601,1369,2,3635796,3568843,240877,3876673,3809720,80.788947589871,79.3936629197467,275
-7.6926,53.28823,2021/11/11 00:00:00+00,Thu 11 Nov 2021,1394,1125,2,3637190,3569968,240879,3878069,3810847,80.818039899394,79.4171493329504,276
-7.6926,53.28823,2021/11/12 00:00:00+00,Fri 12 Nov 2021,1143,1161,6,3638333,3571129,240885,3879218,3812014,80.8419847873896,79.4414693366849,277
-7.6926,53.28823,2021/11/13 00:00:00+00,Sat 13 Nov 2021,1395,1384,0,3639728,3572513,240885,3880613,3813398,80.8710562571493,79.4703115690487,278
-7.6926,53.28823,2021/11/14 00:00:00+00,Sun 14 Nov 2021,1646,1809,1,3641374,3574322,240886,3882260,3815208,80.9053793472528,79.5080315405649,279
-7.6926,53.28823,2021/11/15 00:00:00+00,Mon 15 Nov 2021,1243,599,1,3642617,3574921,240887,3883504,3815808,80.9313040127589,79.5205353985261,280
-7.6926,53.28823,2021/11/16 00:00:00+00,Tue 16 Nov 2021,1317,1081,5,3643934,3576002,240892,3884826,3816894,80.9588541798001,79.5431673814358,281
-7.6926,53.28823,2021/11/17 00:00:00+00,Wed 17 Nov 2021,1504,1122,3,3645438,3577124,240895,3886333,3818019,80.9902597030459,79.566612115113,282
-7.6926,53.28823,2021/11/18 00:00:00+00,Thu 18 Nov 2021,1639,2511,5,3647077,3579635,240900,3887977,3820535,81.0245202738595,79.6190449594969,283
-7.6926,53.28823,2021/11/19 00:00:00+00,Fri 19 Nov 2021,1165,1559,0,3648242,3581194,240900,3889142,3822094,81.0487985980674,79.6515341504327,284
-7.6926,53.28823,2021/11/20 00:00:00+00,Sat 20 Nov 2021,1547,2947,12,3649789,3584141,240912,3890701,3825053,81.0812877890032,79.7131990099445,285
-7.6926,53.28823,2021/11/21 00:00:00+00,Sun 21 Nov 2021,1789,2770,0,3651578,3586911,240912,3892490,3827823,81.1185701254908,79.7709251541986,286
-7.6926,53.28823,2021/11/22 00:00:00+00,Mon 22 Nov 2021,725,522,3,3652303,3587433,240915,3893218,3828348,81.1337414731504,79.7818660299147,287
-7.6926,53.28823,2021/11/23 00:00:00+00,Tue 23 Nov 2021,2156,1599,8,3654459,3589032,240923,3895382,3829955,81.1788387208637,79.8153555294873,288
-7.6926,53.28823,2021/11/24 00:00:00+00,Wed 24 Nov 2021,1614,3152,2,3656073,3592184,240925,3896998,3833109,81.2125157783058,79.8810841428366,289
-7.6926,53.28823,2021/11/25 00:00:00+00,Thu 25 Nov 2021,982,1190,2,3657055,3593374,240927,3897982,3834301,81.2330221053621,79.9059251406528,290
-7.6926,53.28823,2021/11/26 00:00:00+00,Fri 26 Nov 2021,1279,1113,12,3658334,3594487,240939,3899273,3835426,81.2599262397419,79.92936987433,291
-7.6926,53.28823,2021/11/27 00:00:00+00,Sat 27 Nov 2021,1201,1567,6,3659535,3596054,240945,3900480,3836999,81.2850798340071,79.9621508219515,292
-7.6926,53.28823,2021/11/28 00:00:00+00,Sun 28 Nov 2021,1962,2262,1,3661497,3598316,240946,3902443,3839262,81.3259882893034,80.0093112062284,293
-7.6926,53.28823,2021/11/29 00:00:00+00,Mon 29 Nov 2021,536,999,2,3662033,3599315,240948,3902981,3840263,81.337200081942,80.0301718092603,294
-7.6926,53.28823,2021/11/30 00:00:00+00,Tue 30 Nov 2021,1895,1649,6,3663928,3600964,240954,3904882,3841918,81.3768164719156,80.0646616174699,295
-7.6926,53.28823,2021/12/01 00:00:00+00,Wed 01 Dec 2021,1070,1388,4,3664998,3602352,240958,3905956,3843310,81.3991983776661,80.0936705679398,296
-7.6926,53.28823,2021/12/02 00:00:00+00,Thu 02 Dec 2021,1737,1414,0,3666735,3603766,240958,3907693,3844724,81.4353970464637,80.1231379932017,297
-7.6926,53.28823,2021/12/03 00:00:00+00,Fri 03 Dec 2021,1016,1198,2,3667751,3604964,240960,3908711,3845924,81.4566119254712,80.148145709124,298
-7.6926,53.28823,2021/12/04 00:00:00+00,Sat 04 Dec 2021,1204,1702,1,3668955,3606666,240961,3909916,3847627,81.4817238402099,80.1836358259705,299
-7.6926,53.28823,2021/12/05 00:00:00+00,Sun 05 Dec 2021,1348,1777,2,3670303,3608443,240963,3911266,3849406,81.5098575206225,80.2207097648254,300
-7.6926,53.28823,2021/12/06 00:00:00+00,Mon 06 Dec 2021,936,1305,0,3671239,3609748,240963,3912202,3850711,81.5293635390419,80.2479056558909,301
-7.6926,53.28823,2021/12/07 00:00:00+00,Tue 07 Dec 2021,483,747,2,3671722,3610495,240965,3912687,3851460,81.5394708242272,80.2635146385791,302
-7.6926,53.28823,2021/12/08 00:00:00+00,Wed 08 Dec 2021,795,1526,2,3672517,3612021,240967,3913484,3852988,81.5560801155523,80.2953577968536,303
-7.6926,53.28823,2021/12/09 00:00:00+00,Thu 09 Dec 2021,784,1212,1,3673301,3613233,240968,3914269,3854201,81.5724393297182,80.3206364296984,304
-7.6926,53.28823,2021/12/10 00:00:00+00,Fri 10 Dec 2021,895,1620,1,3674196,3614853,240969,3915165,3855822,81.5911117576069,80.3544176859569,305
-7.6926,53.28823,2021/05/14 23:00:00+00,Sat 15 May 2021,28877,12464,22,1607148,648606,1602,1608750,650208,33.5259691584007,13.5501807953662,306
-7.6926,53.28823,2022/08/10 23:00:00+00,Thu 11 Aug 2022,45,39,0,3855866,3810006,241052,4096918,4051058,85.3788012509693,84.4230897074702,307
-7.6926,53.28823,2022/04/29 23:00:00+00,Sat 30 Apr 2022,281,724,0,3846084,3793096,241039,4087123,4034135,85.1746757697531,84.0704183936752,308
-7.6926,53.28823,2022/04/30 23:00:00+00,Sun 01 May 2022,187,746,0,3846271,3793842,241039,4087310,4034881,85.1785728054844,84.0859648570736,309
-7.6926,53.28823,2021/01/15 00:00:00+00,Fri 15 Jan 2021,7700,4,0,96064,121,4,96068,125,2.00203437769028,0.00260497040857815,310
-7.6926,53.28823,2021/05/15 23:00:00+00,Sun 16 May 2021,23187,1182,11,1630335,649788,1613,1631948,651401,34.0094099867063,13.5750426329457,311
-7.6926,53.28823,2022/08/11 23:00:00+00,Fri 12 Aug 2022,70,75,0,3855936,3810081,241052,4096988,4051133,85.3802600343981,84.4246526897153,312
-7.6926,53.28823,2022/05/01 23:00:00+00,Mon 02 May 2022,12,26,0,3846283,3793868,241039,4087322,4034907,85.1788228826436,84.0865066909186,313
-7.6926,53.28823,2021/01/16 00:00:00+00,Sat 16 Jan 2021,5245,2,0,101309,123,4,101313,127,2.11133893603422,0.0026466499351154,314
-7.6926,53.28823,2021/05/16 23:00:00+00,Mon 17 May 2021,35399,3959,120,1665734,653747,1733,1667467,655480,34.7496175382446,13.6600480273184,315
-7.6926,53.28823,2022/08/12 23:00:00+00,Sat 13 Aug 2022,103,151,0,3856039,3810232,241052,4097091,4051284,85.3824065300148,84.4277994939689,316
-7.6926,53.28823,2022/05/02 23:00:00+00,Tue 03 May 2022,96,118,0,3846379,3793986,241039,4087418,4035025,85.1808234999174,84.0889657829843,317
-7.6926,53.28823,2021/01/17 00:00:00+00,Sun 17 Jan 2021,1115,5,0,102424,128,4,102428,132,2.13457527207874,0.00275084875145852,318
-7.6926,53.28823,2021/05/17 23:00:00+00,Tue 18 May 2021,39025,12511,127,1704759,666258,1860,1706619,668118,35.5655359497378,13.9234209555073,319
-7.6926,53.28823,2022/08/13 23:00:00+00,Sun 14 Aug 2022,17,26,0,3856056,3810258,241052,4097108,4051310,85.3827608059903,84.4283413278139,320
-7.6926,53.28823,2022/05/03 23:00:00+00,Wed 04 May 2022,113,128,0,3846492,3794114,241039,4087531,4035153,85.1831783931667,84.0916332726827,321
-7.6926,53.28823,2021/01/18 00:00:00+00,Mon 18 Jan 2021,8726,9,1,111150,137,5,111155,142,2.31644388612403,0.00295924638414477,322
-7.6926,53.28823,2021/05/18 23:00:00+00,Wed 19 May 2021,37041,17605,211,1741800,683863,2071,1743871,685934,36.3418588110206,14.2947021779011,323
-7.6926,53.28823,2022/08/14 23:00:00+00,Mon 15 Aug 2022,7,11,0,3856063,3810269,241052,4097115,4051321,85.3829066843332,84.4285705652098,324
-7.6926,53.28823,2022/05/04 23:00:00+00,Thu 05 May 2022,112,165,0,3846604,3794279,241039,4087643,4035318,85.1855124466528,84.095071833622,325
-7.6926,53.28823,2021/01/19 00:00:00+00,Tue 19 Jan 2021,8395,21,0,119545,158,5,119550,163,2.49139369876414,0.0033968814127859,326
-7.6926,53.28823,2021/05/19 23:00:00+00,Thu 20 May 2021,39098,19647,136,1780898,703510,2207,1783105,705717,37.1594860831019,14.7069752146444,327
-7.6926,53.28823,2022/08/15 23:00:00+00,Tue 16 Aug 2022,41,28,0,3856104,3810297,241052,4097156,4051349,85.3837611146272,84.4291540785813,328
-7.6926,53.28823,2022/05/05 23:00:00+00,Fri 06 May 2022,138,257,0,3846742,3794536,241039,4087781,4035575,85.1883883339839,84.100427652782,329
-7.6926,53.28823,2021/01/20 00:00:00+00,Wed 20 Jan 2021,8452,965,0,127997,1123,5,128002,1128,2.66753137791056,0.0235072529670092,330
-7.6926,53.28823,2021/05/20 23:00:00+00,Fri 21 May 2021,25846,23258,14934,1806744,726768,17141,1823885,743909,38.0093316291964,15.5028874533997,331
-7.6926,53.28823,2022/08/16 23:00:00+00,Wed 17 Aug 2022,51,58,0,3856155,3810355,241052,4097207,4051407,85.384823942554,84.4303627848509,332
-7.6926,53.28823,2022/05/06 23:00:00+00,Sat 07 May 2022,441,1088,0,3847183,3795624,241039,4088222,4036663,85.1975786695854,84.1231013152183,333
-7.6926,53.28823,2021/01/21 00:00:00+00,Thu 21 Jan 2021,9011,964,0,137008,2087,5,137013,2092,2.85531848472414,0.0435967847579639,334
-7.6926,53.28823,2021/05/21 23:00:00+00,Sat 22 May 2021,16594,10259,13523,1823338,737027,30664,1854002,767691,38.6369627795576,15.9984987034541,335
-7.6926,53.28823,2022/08/17 23:00:00+00,Thu 18 Aug 2022,55,39,0,3856210,3810394,241052,4097262,4051446,85.3859701295337,84.4311755356184,336
-7.6926,53.28823,2022/05/07 23:00:00+00,Sun 08 May 2022,274,437,0,3847457,3796061,241039,4088496,4037100,85.203288764721,84.1322082917667,337
-7.6926,53.28823,2021/01/22 00:00:00+00,Fri 22 Jan 2021,6790,970,0,143798,3057,5,143803,3062,2.99682047731811,0.0638113551285303,338
-7.6926,53.28823,2021/05/22 23:00:00+00,Sun 23 May 2021,8227,5536,10205,1831565,742563,40869,1872434,783432,39.0210812961249,16.3265374170656,339
-7.6926,53.28823,2022/08/18 23:00:00+00,Fri 19 Aug 2022,72,56,0,3856282,3810450,241052,4097334,4051502,85.3874705924891,84.4323425623614,340
-7.6926,53.28823,2022/05/08 23:00:00+00,Mon 09 May 2022,24,32,0,3847481,3796093,241039,4088520,4037132,85.2037889190394,84.1328751641913,341
-7.6926,53.28823,2021/01/23 00:00:00+00,Sat 23 Jan 2021,4203,461,0,148001,3518,5,148006,3523,3.08441000233614,0.0734184859953665,342
-7.6926,53.28823,2021/01/24 00:00:00+00,Sun 24 Jan 2021,1189,399,0,149190,3917,5,149195,3922,3.10918848086253,0.0817335515395479,343
-7.6926,53.28823,2021/01/25 00:00:00+00,Mon 25 Jan 2021,1371,1293,0,150561,5210,5,150566,5215,3.13775979630382,0.10867936544588,344
-7.6926,53.28823,2021/01/26 00:00:00+00,Tue 26 Jan 2021,1008,3507,0,151569,8717,5,151574,8722,3.15876627767859,0.181764415228949,345
-7.6926,53.28823,2021/01/27 00:00:00+00,Wed 27 Jan 2021,2188,6707,0,153757,15424,5,153762,15429,3.20436367971034,0.321536707471618,346
-7.6926,53.28823,2021/01/28 00:00:00+00,Thu 28 Jan 2021,1022,11542,0,154779,26966,5,154784,26971,3.22566191777088,0.562069255118089,347
-7.6926,53.28823,2021/01/29 00:00:00+00,Fri 29 Jan 2021,1591,11526,0,156370,38492,5,156375,38497,3.25881798113126,0.802268366552263,348
-7.6926,53.28823,2021/01/30 00:00:00+00,Sat 30 Jan 2021,654,7793,0,157024,46285,5,157029,46290,3.27244718630894,0.964672641704659,349
-7.6926,53.28823,2021/01/31 00:00:00+00,Sun 31 Jan 2021,238,4086,0,157262,50371,5,157267,50376,3.27740704996688,1.04982391442026,350
-7.6926,53.28823,2021/02/01 00:00:00+00,Mon 01 Feb 2021,1041,8333,1,158303,58704,6,158309,58710,3.29912208329278,1.22350250150098,351
-7.6926,53.28823,2021/02/02 00:00:00+00,Tue 02 Feb 2021,841,5110,0,159144,63814,6,159150,63820,3.3166483242017,1.32999369180366,352
-7.6926,53.28823,2021/02/03 00:00:00+00,Wed 03 Feb 2021,1412,6869,0,160556,70683,6,160562,70689,3.346074069937,1.47314202569584,353
-7.6926,53.28823,2021/02/04 00:00:00+00,Thu 04 Feb 2021,1453,10541,1,162009,81224,7,162016,81231,3.37637508572958,1.69283481007369,354
-7.6926,53.28823,2021/02/05 00:00:00+00,Fri 05 Feb 2021,3403,8616,0,165412,89840,7,165419,89847,3.44729280013271,1.87239021039617,355
-7.6926,53.28823,2021/02/06 00:00:00+00,Sat 06 Feb 2021,913,3870,0,166325,93710,7,166332,93717,3.46631950399696,1.95304009424575,356
-7.6926,53.28823,2021/02/07 00:00:00+00,Sun 07 Feb 2021,337,1301,2,166662,95011,9,166671,95020,3.47338418374503,1.98019430578476,357
-7.6926,53.28823,2021/02/08 00:00:00+00,Mon 08 Feb 2021,1197,881,0,167859,95892,9,167868,95901,3.49832938037757,1.99855413722442,358
-7.6926,53.28823,2021/02/09 00:00:00+00,Tue 09 Feb 2021,4274,553,3,172133,96445,12,172145,96457,3.58746104787748,2.01014104560178,359
-7.6926,53.28823,2021/02/10 00:00:00+00,Wed 10 Feb 2021,8832,584,0,180965,97029,12,180977,97041,3.77151783706598,2.02231146735066,360
-7.6926,53.28823,2021/02/11 00:00:00+00,Thu 11 Feb 2021,6199,449,0,187164,97478,12,187176,97490,3.90070352956819,2.03166852105827,361
-7.6926,53.28823,2021/02/12 00:00:00+00,Fri 12 Feb 2021,4401,527,0,191565,98005,12,191577,98017,3.9924193277134,2.04265107630083,362
-7.6926,53.28823,2021/02/13 00:00:00+00,Sat 13 Feb 2021,1221,1917,0,192786,99922,12,192798,99934,4.0178646786644,2.08260090248679,363
-7.6926,53.28823,2021/02/14 00:00:00+00,Sun 14 Feb 2021,2704,27,0,195490,99949,12,195502,99961,4.07421539854276,2.08316357609504,364
-7.6926,53.28823,2021/02/15 00:00:00+00,Mon 15 Feb 2021,1969,7894,0,197459,107843,12,197471,107855,4.11524889241868,2.24767266733757,365
-7.6926,53.28823,2021/02/16 00:00:00+00,Tue 16 Feb 2021,5658,8166,0,203117,116009,12,203129,116021,4.23316027299256,2.41785017418916,366
-7.6926,53.28823,2021/02/17 00:00:00+00,Wed 17 Feb 2021,9757,8465,0,212874,124474,12,212886,124486,4.43649384320454,2.59425877025807,367
-7.6926,53.28823,2021/02/18 00:00:00+00,Thu 18 Feb 2021,8473,8358,1,221347,132832,13,221360,132845,4.61308999714287,2.76845835142051,368
-7.6926,53.28823,2021/02/19 00:00:00+00,Fri 19 Feb 2021,9400,6589,1,230747,139421,14,230761,139435,4.80900461163121,2.90579239136075,369
-7.6926,53.28823,2021/02/20 00:00:00+00,Sat 20 Feb 2021,5899,3574,2,236646,142995,16,236662,143011,4.93198005467937,2.98031538480935,370
-7.6926,53.28823,2021/02/21 00:00:00+00,Sun 21 Feb 2021,1116,1025,6,237762,144020,22,237784,144042,4.95536226906677,3.00180118073931,371
-7.6926,53.28823,2021/02/22 00:00:00+00,Mon 22 Feb 2021,3953,1127,2,241715,145147,24,241739,145171,5.03778353279418,3.02532927346958,372
-7.6926,53.28823,2021/02/23 00:00:00+00,Tue 23 Feb 2021,13370,1075,1,255085,146222,25,255110,146247,5.31643200745897,3.04775285874663,373
-7.6926,53.28823,2021/02/24 00:00:00+00,Wed 24 Feb 2021,16950,2109,5,272035,148331,30,272065,148361,5.66977019367851,3.0918081182965,374
-7.6926,53.28823,2021/02/25 00:00:00+00,Thu 25 Feb 2021,18106,1763,3,290141,150094,33,290174,150127,6.04715746671004,3.12861114022889,375
-7.6926,53.28823,2021/02/26 00:00:00+00,Fri 26 Feb 2021,16090,2774,1,306231,152868,34,306265,152902,6.38249009746549,3.18644148329933,376
-7.6926,53.28823,2021/02/27 00:00:00+00,Sat 27 Feb 2021,9007,706,1,315238,153574,35,315273,153609,6.57021468498926,3.20117519593024,377
-7.6926,53.28823,2021/02/28 00:00:00+00,Sun 28 Feb 2021,2452,59,2,317690,153633,37,317727,153670,6.62135546405047,3.20244642148963,378
-7.6926,53.28823,2021/03/01 00:00:00+00,Mon 01 Mar 2021,5613,806,0,323303,154439,37,323340,154476,6.73832905527726,3.21924327068414,379
-7.6926,53.28823,2021/03/02 00:00:00+00,Tue 02 Mar 2021,12199,1616,0,335502,156055,37,335539,156092,6.99255332739122,3.25292032812624,380
-7.6926,53.28823,2021/03/03 00:00:00+00,Wed 03 Mar 2021,12918,1510,1,348420,157565,38,348458,157603,7.26178222905859,3.28440921042513,381
-7.6926,53.28823,2021/03/04 00:00:00+00,Thu 04 Mar 2021,18734,1697,5,367154,159262,43,367197,159305,7.65229855294936,3.31987848750833,382
-7.6926,53.28823,2021/03/05 00:00:00+00,Fri 05 Mar 2021,18466,2403,6,385620,161665,49,385669,161714,8.0372506600474,3.37008147722245,383
-7.6926,53.28823,2021/03/06 00:00:00+00,Sat 06 Mar 2021,10411,149,5,396031,161814,54,396085,161868,8.2543176342534,3.37329080076582,384
-7.6926,53.28823,2021/03/07 00:00:00+00,Sun 07 Mar 2021,1537,14,3,397568,161828,57,397625,161885,8.28641086968709,3.37364507674139,385
-7.6926,53.28823,2021/03/08 00:00:00+00,Mon 08 Mar 2021,6682,1509,5,404250,163337,62,404312,163399,8.42576636666438,3.40519647833008,386
-7.6926,53.28823,2021/03/09 00:00:00+00,Tue 09 Mar 2021,13851,3115,6,418101,166452,68,418169,166520,8.71454296627772,3.47023737949146,387
-7.6926,53.28823,2021/03/10 00:00:00+00,Wed 10 Mar 2021,13754,3997,3,431855,170449,71,431926,170520,9.0012355895642,3.55359643256597,388
-7.6926,53.28823,2021/03/11 00:00:00+00,Thu 11 Mar 2021,18503,2108,3,450358,172557,74,450432,172631,9.38689624861338,3.59758917282603,389
-7.6926,53.28823,2021/03/12 00:00:00+00,Fri 12 Mar 2021,17345,1348,4,467703,173905,78,467781,173983,9.74844530156075,3.62576453276521,390
-7.6926,53.28823,2021/03/13 00:00:00+00,Sat 13 Mar 2021,8332,179,0,476035,174084,78,476113,174162,9.92208220911494,3.6294948503903,391
-7.6926,53.28823,2021/03/14 00:00:00+00,Sun 14 Mar 2021,392,23,2,476427,174107,80,476507,174187,9.93029307584278,3.63001584447201,392
-7.6926,53.28823,2021/03/15 00:00:00+00,Mon 15 Mar 2021,2672,1001,0,479099,175108,80,479179,175188,9.98597692329654,3.65087644750391,393
-7.6926,53.28823,2021/03/16 00:00:00+00,Tue 16 Mar 2021,8970,3829,2,488069,178937,82,488151,179019,10.1729512793426,3.73071358058601,394
-7.6926,53.28823,2021/03/17 00:00:00+00,Wed 17 Mar 2021,4895,2426,7,492964,181363,89,493053,181452,10.2751077988854,3.78141672461858,395
-7.6926,53.28823,2021/03/18 00:00:00+00,Thu 18 Mar 2021,11742,4690,7,504706,186053,96,504802,186149,10.5199541775285,3.87930109269131,396
-7.6926,53.28823,2021/03/19 00:00:00+00,Fri 19 Mar 2021,10390,6142,2,515096,192195,98,515194,192293,10.7365209974161,4.00734059821374,397
-7.6926,53.28823,2021/03/20 00:00:00+00,Sat 20 Mar 2021,5259,3126,4,520355,195321,102,520457,195423,10.8462006714989,4.07256905724454,398
-7.6926,53.28823,2021/03/21 00:00:00+00,Sun 21 Mar 2021,3654,59,3,524009,195380,105,524114,195485,10.9224116857722,4.07386112256719,399
-7.6926,53.28823,2021/03/22 00:00:00+00,Mon 22 Mar 2021,7427,2417,1,531436,197797,106,531542,197903,11.0772094473316,4.12425167015073,400
-7.6926,53.28823,2021/03/23 00:00:00+00,Tue 23 Mar 2021,12577,7407,4,544013,205204,110,544123,205314,11.3393945090141,4.27869515573451,401
-7.6926,53.28823,2021/03/24 00:00:00+00,Wed 24 Mar 2021,13641,9785,2,557654,214989,112,557766,215101,11.623711399288,4.48265391884454,402
-7.6926,53.28823,2021/03/25 00:00:00+00,Thu 25 Mar 2021,20886,10229,3,578540,225218,115,578655,225333,12.0590332142063,4.69588637660912,403
-7.6926,53.28823,2021/03/26 00:00:00+00,Fri 26 Mar 2021,19711,9507,1,598251,234725,116,598367,234841,12.4698266277574,4.8940308457672,404
-7.6926,53.28823,2021/03/27 00:00:00+00,Sat 27 Mar 2021,11764,5362,3,610015,240087,119,610134,240206,12.7150481221394,5.00583617570338,405
-7.6926,53.28823,2021/03/28 00:00:00+00,Sun 28 Mar 2021,2497,489,0,612512,240576,119,612631,240695,12.7670850110211,5.01602681994174,406
-7.6926,53.28823,2021/03/28 23:00:00+00,Mon 29 Mar 2021,9287,3129,3,621799,243705,122,621921,243827,12.9606864117866,5.08129695849907,407
-7.6926,53.28823,2021/03/29 23:00:00+00,Tue 30 Mar 2021,13346,8677,4,635145,252382,126,635271,252508,13.2388972514228,5.262206943434,408
-7.6926,53.28823,2021/03/30 23:00:00+00,Wed 31 Mar 2021,15846,10508,4,650991,262890,130,651121,263020,13.5692074992305,5.48127453491379,409
-7.6926,53.28823,2021/03/31 23:00:00+00,Thu 01 Apr 2021,19717,11585,9,670708,274475,139,670847,274614,13.9802926694674,5.72289075025023,410
-7.6926,53.28823,2021/04/01 23:00:00+00,Fri 02 Apr 2021,20161,13727,9,690869,288202,148,691017,288350,14.4006306945956,6.00914573850807,411
-7.6926,53.28823,2021/04/02 23:00:00+00,Sat 03 Apr 2021,7554,4639,7,698423,292841,155,698578,292996,14.5582001446696,6.1059672786541,412
-7.6926,53.28823,2021/04/03 23:00:00+00,Sun 04 Apr 2021,3046,172,3,701469,293013,158,701627,293171,14.6217405828757,6.10961423722611,413
-7.6926,53.28823,2021/04/04 23:00:00+00,Mon 05 Apr 2021,3446,614,6,704915,293627,164,705079,293791,14.693679445679,6.12253489045266,414
-7.6926,53.28823,2021/04/05 23:00:00+00,Tue 06 Apr 2021,12007,8160,12,716922,301787,176,717098,301963,14.9441525604046,6.29283743588386,415
-7.6926,53.28823,2021/04/06 23:00:00+00,Wed 07 Apr 2021,18377,10490,12,735299,312277,188,735487,312465,15.3273749671513,6.51169662973096,416
-7.6926,53.28823,2021/04/07 23:00:00+00,Thu 08 Apr 2021,20201,10573,17,755500,322850,205,755705,323055,15.7487133009164,6.73238972274571,417
-7.6926,53.28823,2021/04/08 23:00:00+00,Fri 09 Apr 2021,20687,9169,16,776187,332019,221,776408,332240,16.1801589198667,6.92380294836803,418
-7.6926,53.28823,2021/04/09 23:00:00+00,Sat 10 Apr 2021,11187,4185,12,787374,336204,233,787607,336437,16.4135434287121,7.01126743480645,419
-7.6926,53.28823,2021/04/10 23:00:00+00,Sun 11 Apr 2021,2869,368,9,790243,336572,242,790485,336814,16.4735202673992,7.01912402555872,420
-7.6926,53.28823,2021/04/11 23:00:00+00,Mon 12 Apr 2021,7788,2804,13,798031,339376,255,798286,339631,16.6360912606577,7.07782963868644,421
-7.6926,53.28823,2021/04/12 23:00:00+00,Tue 13 Apr 2021,11527,8594,1,809558,347970,256,809814,348226,16.8763320516184,7.25694740398027,422
-7.6926,53.28823,2021/04/13 23:00:00+00,Wed 14 Apr 2021,20352,6598,2,829910,354568,258,830168,354826,17.300504593188,7.3944898415532,423
-7.6926,53.28823,2021/04/14 23:00:00+00,Thu 15 Apr 2021,27114,10819,1,857024,365387,259,857283,365646,17.8655747742168,7.61997608011972,424
-7.6926,53.28823,2021/04/15 23:00:00+00,Fri 16 Apr 2021,27968,9841,1,884992,375228,260,885252,375488,18.448442113077,7.82508103020953,425
-7.6926,53.28823,2021/04/16 23:00:00+00,Sat 17 Apr 2021,15855,4563,3,900847,379791,263,901110,380054,18.7789190789908,7.92023538929407,426
-7.6926,53.28823,2021/04/17 23:00:00+00,Sun 18 Apr 2021,1078,486,0,901925,380277,263,902188,380540,18.8013843437944,7.93036351424262,427
-7.6926,53.28823,2021/04/18 23:00:00+00,Mon 19 Apr 2021,6756,2265,0,908681,382542,263,908944,382805,18.9421777844372,7.97756557804606,428
-7.6926,53.28823,2021/04/19 23:00:00+00,Tue 20 Apr 2021,15097,7324,1,923778,389866,264,924042,390130,19.2568165302669,8.13021684398874,429
-7.6926,53.28823,2021/04/20 23:00:00+00,Wed 21 Apr 2021,26736,9896,4,950514,399762,268,950782,400030,19.81407180007,8.33653050034813,430
-7.6926,53.28823,2021/04/21 23:00:00+00,Thu 22 Apr 2021,31637,12189,1,982151,411951,269,982420,412220,20.4734002303627,8.59056721459267,431
-7.6926,53.28823,2022/05/09 23:00:00+00,Tue 10 May 2022,80,98,1,3847561,3796191,241040,4088601,4037231,85.2054769398642,84.1349383007549,432
-7.6926,53.28823,2022/08/19 23:00:00+00,Sat 20 Aug 2022,108,127,0,3856390,3810577,241052,4097442,4051629,85.3897212869221,84.4349892122965,433
-7.6926,53.28823,2022/08/20 23:00:00+00,Sun 21 Aug 2022,39,36,0,3856429,3810613,241052,4097481,4051665,85.3905340376895,84.4357394437742,434
-7.6926,53.28823,2021/05/23 23:00:00+00,Mon 24 May 2021,22566,8238,8452,1854131,750801,49321,1903452,800122,39.6674890731911,16.6743530660189,435
-7.6926,53.28823,2022/05/10 23:00:00+00,Wed 11 May 2022,112,132,0,3847673,3796323,241040,4088713,4037363,85.2078109933502,84.1376891495063,436
-7.6926,53.28823,2022/08/21 23:00:00+00,Mon 22 Aug 2022,12,13,0,3856441,3810626,241052,4097493,4051678,85.3907841148488,84.4360103606967,437
-7.6926,53.28823,2021/05/24 23:00:00+00,Tue 25 May 2021,30362,16515,3224,1884493,767316,52545,1937038,819861,40.3674133623312,17.0857091531783,438
-7.6926,53.28823,2021/05/25 23:00:00+00,Wed 26 May 2021,19988,25475,3054,1904481,792791,55599,1960080,848390,40.8476031875668,17.6802467594689,439
-7.6926,53.28823,2021/05/26 23:00:00+00,Thu 27 May 2021,17021,36057,550,1921502,828848,56149,1977651,884997,41.2137786679598,18.4431279734435,440
-7.6926,53.28823,2021/05/27 23:00:00+00,Fri 28 May 2021,27055,31839,1562,1948557,860687,57711,2006268,918398,41.8101501734181,19.1391969063788,441
-7.6926,53.28823,2021/05/28 23:00:00+00,Sat 29 May 2021,24498,7397,537,1973055,868084,58248,2031303,926332,42.3318736468481,19.3045395881521,442
-7.6926,53.28823,2021/05/29 23:00:00+00,Sun 30 May 2021,24260,1688,210,1997315,869772,58458,2055773,928230,42.8418226540314,19.3440934588359,443
-7.6926,53.28823,2021/05/30 23:00:00+00,Mon 31 May 2021,22604,7317,3445,2019919,877089,61903,2081822,938992,43.3846776474158,19.5683709911329,444
-7.6926,53.28823,2021/05/31 23:00:00+00,Tue 01 Jun 2021,27604,11527,3654,2047523,888616,65557,2113080,954173,44.0360869676665,19.8847394373139,445
-7.6926,53.28823,2021/06/01 23:00:00+00,Wed 02 Jun 2021,18717,20918,4008,2066240,909534,69565,2135805,979099,44.509670587946,20.4041913765476,446
-7.6926,53.28823,2021/06/02 23:00:00+00,Thu 03 Jun 2021,16700,30709,1978,2082940,940243,71543,2154483,1011786,44.8989156862774,21.0853807185092,447
-7.6926,53.28823,2021/06/03 23:00:00+00,Fri 04 Jun 2021,28998,23347,153,2111938,963590,71696,2183634,1035286,45.5064156253211,21.5751151553219,448
-7.6926,53.28823,2021/06/04 23:00:00+00,Sat 05 Jun 2021,20978,11502,35,2132916,975092,71731,2204647,1046823,45.9443215708847,21.815543504152,449
-7.6926,53.28823,2021/06/05 23:00:00+00,Sun 06 Jun 2021,19951,3918,47,2152867,979010,71778,2224645,1050788,46.3610751567306,21.8981731655121,450
-7.6926,53.28823,2021/06/06 23:00:00+00,Mon 07 Jun 2021,19845,4606,47,2172712,983616,71825,2244537,1055441,46.7756197276701,21.995140584001,451
-7.6926,53.28823,2021/06/07 23:00:00+00,Tue 08 Jun 2021,26425,18346,48,2199137,1001962,71873,2271010,1073835,47.3273107806805,22.3784671895641,452
-7.6926,53.28823,2021/06/08 23:00:00+00,Wed 09 Jun 2021,32820,20131,175,2231957,1022093,72048,2304005,1094141,48.0149187697287,22.8016394224968,453
-7.6926,53.28823,2021/06/09 23:00:00+00,Thu 10 Jun 2021,27710,27509,273,2259667,1049602,72321,2331988,1121923,48.5980778652747,23.3806097256258,454
-7.6926,53.28823,2021/06/10 23:00:00+00,Fri 11 Jun 2021,26458,32916,42,2286125,1082518,72363,2358488,1154881,49.1503315918932,24.0674466434331,455
-7.6926,53.28823,2021/06/11 23:00:00+00,Sat 12 Jun 2021,12223,19730,105,2298348,1102248,72468,2370816,1174716,49.4072441934689,24.4808033478663,456
-7.6926,53.28823,2021/06/12 23:00:00+00,Sun 13 Jun 2021,8558,18178,835,2306906,1120426,73303,2380209,1193729,49.6029920898511,24.8770297668927,457
-7.6926,53.28823,2021/06/13 23:00:00+00,Mon 14 Jun 2021,16029,31316,52,2322935,1151742,73355,2396290,1225097,49.9381163229738,25.5307314611029,458
-7.6926,53.28823,2021/06/14 23:00:00+00,Tue 15 Jun 2021,14711,41597,206,2337646,1193339,73561,2411207,1266900,50.2489830716519,26.4018960850212,459
-7.6926,53.28823,2021/06/15 23:00:00+00,Wed 16 Jun 2021,13482,48401,219,2351128,1241740,73780,2424908,1315520,50.5345086681953,27.4151253751418,460
-7.6926,53.28823,2021/06/16 23:00:00+00,Thu 17 Jun 2021,21580,42697,535,2372708,1284437,74315,2447023,1358752,50.995380032881,28.316070020771,461
-7.6926,53.28823,2021/06/17 23:00:00+00,Fri 18 Jun 2021,12022,50026,554,2384730,1334463,74869,2459599,1409332,51.2574608957472,29.3701452468981,462
-7.6926,53.28823,2021/06/18 23:00:00+00,Sat 19 Jun 2021,6329,32820,434,2391059,1367283,75303,2466362,1442586,51.3984002147329,30.0631507346329,463
-7.6926,53.28823,2021/06/19 23:00:00+00,Sun 20 Jun 2021,8523,26147,178,2399582,1393430,75481,2475063,1468911,51.5797269949332,30.6117575026795,464
-7.6926,53.28823,2021/06/20 23:00:00+00,Mon 21 Jun 2021,15496,32346,575,2415078,1425776,76056,2491134,1501832,51.9146428304233,31.2978233492459,465
-7.6926,53.28823,2021/06/21 23:00:00+00,Tue 22 Jun 2021,15153,43554,722,2430231,1469330,76778,2507009,1546108,52.2454740723127,32.2205247077275,466
-7.6926,53.28823,2021/06/22 23:00:00+00,Wed 23 Jun 2021,20105,39409,884,2450336,1508739,77662,2527998,1586401,52.6828798635579,33.0602212891102,467
-7.6926,53.28823,2021/06/23 23:00:00+00,Thu 24 Jun 2021,19029,44277,1032,2469365,1553016,78694,2548059,1631710,53.1009463544898,34.0044501230484,468
-7.6926,53.28823,2021/06/24 23:00:00+00,Fri 25 Jun 2021,15222,50131,843,2484587,1603147,79537,2564124,1682684,53.4357371514003,35.0667362159033,469
-7.6926,53.28823,2021/06/25 23:00:00+00,Sat 26 Jun 2021,9073,30577,512,2493660,1633724,80049,2573709,1713773,53.63548628233,35.7146236161616,470
-7.6926,53.28823,2021/06/26 23:00:00+00,Sun 27 Jun 2021,8742,30483,59,2502402,1664207,80108,2582510,1744315,53.8188970388572,36.3511116659119,471
-7.6926,53.28823,2021/06/27 23:00:00+00,Mon 28 Jun 2021,24249,24666,527,2526651,1688873,80635,2607286,1769508,54.3352230136007,36.8761278219384,472
-7.6926,53.28823,2021/06/28 23:00:00+00,Tue 29 Jun 2021,28152,31058,812,2554803,1719931,81447,2636250,1801378,54.9388259169131,37.5402910773095,473
-7.6926,53.28823,2021/06/29 23:00:00+00,Wed 30 Jun 2021,22587,36883,589,2577390,1756814,82036,2659426,1838850,55.4218082704268,38.3211986865114,474
-7.6926,53.28823,2021/06/30 23:00:00+00,Thu 01 Jul 2021,15047,48306,642,2592437,1805120,82678,2675115,1887798,55.7487633163482,39.3412634189841,475
-7.6926,53.28823,2021/07/01 23:00:00+00,Fri 02 Jul 2021,13692,47274,817,2606129,1852394,83495,2689624,1935889,56.0511274416127,40.3434684743355,476
-7.6926,53.28823,2021/07/02 23:00:00+00,Sat 03 Jul 2021,9322,30487,506,2615451,1882881,84001,2699452,1966882,56.2559406350168,40.98935525732,477
-7.6926,53.28823,2021/07/03 23:00:00+00,Sun 04 Jul 2021,6460,27786,233,2621911,1910667,84234,2706145,1994901,56.3954211705737,41.5732645843436,478
-7.6926,53.28823,2021/07/04 23:00:00+00,Mon 05 Jul 2021,15630,33476,5342,2637541,1944143,89576,2727117,2033719,56.8324726858433,42.3822225149051,479
-7.6926,53.28823,2021/07/05 23:00:00+00,Tue 06 Jul 2021,12407,48304,5488,2649948,1992447,95064,2745012,2087511,57.2054002495353,43.503235060651,480
-7.6926,53.28823,2021/07/06 23:00:00+00,Wed 07 Jul 2021,19711,43772,5059,2669659,2036219,100123,2769782,2136342,57.7216011856992,44.5208615408212,481
-7.6926,53.28823,2021/07/07 23:00:00+00,Thu 08 Jul 2021,17797,45610,5997,2687456,2081829,106120,2793576,2187949,58.2174625129128,45.5963392038252,482
-7.6926,53.28823,2021/07/08 23:00:00+00,Fri 09 Jul 2021,13531,45099,6531,2700987,2126928,112651,2813638,2239579,58.635549843608,46.6722961813843,483
-7.6926,53.28823,2021/07/09 23:00:00+00,Sat 10 Jul 2021,8644,23882,4365,2709631,2150810,117016,2826647,2267826,58.9066543239695,47.2609569744332,484
-7.6926,53.28823,2021/07/10 23:00:00+00,Sun 11 Jul 2021,15241,16122,2153,2724872,2166932,119169,2844041,2286101,59.269141166264,47.6418036481673,485
-7.6926,53.28823,2021/07/11 23:00:00+00,Mon 12 Jul 2021,17124,31784,6092,2741996,2198716,125261,2867257,2323977,59.7529571103084,48.4311305217297,486
-7.6926,53.28823,2021/07/12 23:00:00+00,Tue 13 Jul 2021,20117,36576,8490,2762113,2235292,133751,2895864,2369043,60.349120218134,49.3702952931936,487
-7.6926,53.28823,2021/07/13 23:00:00+00,Wed 14 Jul 2021,20804,35728,9335,2782917,2271020,143086,2926003,2414106,60.9772098432871,50.3093975453676,488
-7.6926,53.28823,2021/07/14 23:00:00+00,Thu 15 Jul 2021,23660,28846,9585,2806577,2299866,152671,2959248,2452537,61.6700277731525,51.1102904875442,489
-7.6926,53.28823,2021/07/15 23:00:00+00,Fri 16 Jul 2021,23519,27437,9168,2830096,2327303,161839,2991935,2489142,62.3512171151141,51.8731300219922,490
-7.6926,53.28823,2021/07/16 23:00:00+00,Sat 17 Jul 2021,11519,19436,4677,2841615,2346739,166516,3008131,2513255,62.6887379210127,52.3756392336886,491
-7.6926,53.28823,2021/07/17 23:00:00+00,Sun 18 Jul 2021,16871,15826,1931,2858486,2362565,168447,3026933,2531012,63.0805671499894,52.7456909100495,492
-7.6926,53.28823,2021/07/18 23:00:00+00,Mon 19 Jul 2021,24909,18452,6253,2883395,2381017,174700,3058095,2555717,63.7299758529663,53.2605372616009,493
-7.6926,53.28823,2021/07/19 23:00:00+00,Tue 20 Jul 2021,30601,18190,7699,2913996,2399207,182399,3096395,2581606,64.5281387861546,53.8000578928624,494
-7.6926,53.28823,2021/07/20 23:00:00+00,Wed 21 Jul 2021,30371,19851,6894,2944367,2419058,189293,3133660,2608351,65.30473256436,54.3574173614817,495
-7.6926,53.28823,2021/07/21 23:00:00+00,Thu 22 Jul 2021,33545,15940,6937,2977912,2434998,196230,3174142,2631228,66.1483678610005,54.8341686257781,496
-7.6926,53.28823,2021/07/22 23:00:00+00,Fri 23 Jul 2021,27087,20843,5616,3004999,2455841,201846,3206845,2657687,66.8298906391743,55.3855679221026,497
-7.6926,53.28823,2021/07/23 23:00:00+00,Sat 24 Jul 2021,15446,14820,2276,3020445,2470661,204122,3224567,2674783,67.1992129238209,55.7418445149431,498
-7.6926,53.28823,2021/07/24 23:00:00+00,Sun 25 Jul 2021,14742,13654,1046,3035187,2484315,205168,3240355,2689483,67.5282311063059,56.0481890349918,499
-7.6926,53.28823,2021/07/25 23:00:00+00,Mon 26 Jul 2021,23853,18318,3422,3059040,2502633,208590,3267630,2711223,68.0966356494577,56.5012454884517,500
-7.6926,53.28823,2021/07/26 23:00:00+00,Tue 27 Jul 2021,25527,23918,3672,3084567,2526551,212262,3296829,2738813,68.7051358971383,57.0762145570331,501
-7.6926,53.28823,2021/07/27 23:00:00+00,Wed 28 Jul 2021,23449,25296,3265,3108016,2551847,215527,3323543,2767374,69.2618493330963,57.6714190357483,502
-7.6926,53.28823,2021/07/28 23:00:00+00,Thu 29 Jul 2021,19293,27880,2962,3127309,2579727,218489,3345798,2798216,69.7256382646396,58.3141590144793,503
-7.6926,53.28823,2021/07/29 23:00:00+00,Fri 30 Jul 2021,21964,22956,2123,3149273,2602683,220612,3369885,2823295,70.2276056424909,58.8367994374931,504
-7.6926,53.28823,2021/07/30 23:00:00+00,Sat 31 Jul 2021,13755,12494,907,3163028,2615177,221519,3384547,2836696,70.5331582515355,59.116073105056,505
-7.6926,53.28823,2021/07/31 23:00:00+00,Sun 01 Aug 2021,11142,9346,369,3174170,2624523,221888,3396058,2846411,70.7730447665207,59.3185314052106,506
-7.6926,53.28823,2021/08/01 23:00:00+00,Mon 02 Aug 2021,15032,16045,430,3189202,2640568,222318,3411520,2862886,71.0952691861802,59.6618665050612,507
-7.6926,53.28823,2021/08/02 23:00:00+00,Tue 03 Aug 2021,17355,25461,1111,3206557,2666029,223429,3429986,2889458,71.4800962546986,60.2156206946351,508
-7.6926,53.28823,2021/08/03 23:00:00+00,Wed 04 Aug 2021,22131,17314,1575,3228688,2683343,225004,3453692,2908347,71.9741236827446,60.6092629830162,509
-7.6926,53.28823,2021/08/04 23:00:00+00,Thu 05 Aug 2021,13546,30060,1421,3242234,2713403,226425,3468659,2939828,72.2860324195861,61.2653195704758,510
-7.6926,53.28823,2021/08/05 23:00:00+00,Fri 06 Aug 2021,12222,24753,949,3254456,2738156,227374,3481830,2965530,72.5605129415972,61.800943166006,511
-7.6926,53.28823,2021/08/06 23:00:00+00,Sat 07 Aug 2021,6343,8468,583,3260799,2746624,227957,3488756,2974581,72.7048491419957,61.9895638633503,512
-7.6926,53.28823,2021/08/07 23:00:00+00,Sun 08 Aug 2021,8633,11990,153,3269432,2758614,228110,3497542,2986724,72.8879473020738,62.2426211087213,513
-7.6926,53.28823,2021/08/08 23:00:00+00,Mon 09 Aug 2021,5556,23047,601,3274988,2781661,228711,3503699,3010372,73.0162577245188,62.7354398304977,514
-7.6926,53.28823,2021/08/09 23:00:00+00,Tue 10 Aug 2021,9377,26022,717,3284365,2807683,229428,3513793,3037111,73.2266142949523,63.2926742605375,515
-7.6926,53.28823,2021/08/10 23:00:00+00,Wed 11 Aug 2021,7028,31247,666,3291393,2838930,230094,3521487,3069024,73.3869554335411,63.9577336257291,516
-7.6926,53.28823,2021/08/11 23:00:00+00,Thu 12 Aug 2021,6791,38305,865,3298184,2877235,230959,3529143,3108194,73.5465046611257,64.7740271529612,517
-7.6926,53.28823,2021/08/12 23:00:00+00,Fri 13 Aug 2021,10943,28232,875,3309127,2905467,231834,3540961,3137301,73.7927889834343,65.380610142421,518
-7.6926,53.28823,2021/08/13 23:00:00+00,Sat 14 Aug 2021,18147,5854,281,3327274,2911321,232115,3559389,3143436,74.1768241409485,65.508462090074,519
-7.6926,53.28823,2021/08/14 23:00:00+00,Sun 15 Aug 2021,17003,3740,52,3344277,2915061,232167,3576444,3147228,74.5322463034949,65.5874864723887,520
-7.6926,53.28823,2021/08/15 23:00:00+00,Mon 16 Aug 2021,10201,23169,386,3354478,2938230,232553,3587031,3170783,74.7528768772198,66.0783670961811,521
-7.6926,53.28823,2022/08/22 23:00:00+00,Tue 23 Aug 2022,78,72,0,3856519,3810698,241052,4097571,4051750,85.3924096163837,84.437510823652,522
-7.6926,53.28823,2022/05/11 23:00:00+00,Thu 12 May 2022,207,398,0,3847880,3796721,241040,4088920,4037761,85.2121248243468,84.1459833752872,523
-7.6926,53.28823,2022/08/23 23:00:00+00,Wed 24 Aug 2022,53,55,0,3856572,3810753,241052,4097624,4051805,85.393514123837,84.4386570106318,524
-7.6926,53.28823,2022/05/12 23:00:00+00,Fri 13 May 2022,173,327,0,3848053,3797048,241040,4089093,4038088,85.2157301033923,84.1527979778761,525
-7.6926,53.28823,2022/08/24 23:00:00+00,Thu 25 Aug 2022,40,49,0,3856612,3810802,241052,4097664,4051854,85.3943477143677,84.439678159032,526
-7.6926,53.28823,2022/05/13 23:00:00+00,Sat 14 May 2022,333,633,0,3848386,3797681,241040,4089426,4038721,85.2226697445608,84.1659895480251,527
-7.6926,53.28823,2022/08/25 23:00:00+00,Fri 26 Aug 2022,98,89,0,3856710,3810891,241052,4097762,4051943,85.396390011168,84.4415328979629,528
-7.6926,53.28823,2022/05/14 23:00:00+00,Sun 15 May 2022,168,254,0,3848554,3797935,241040,4089594,4038975,85.2261708247899,84.1712828478954,529
-7.6926,53.28823,2022/08/26 23:00:00+00,Sat 27 Aug 2022,86,119,0,3856796,3811010,241052,4097848,4052062,85.3981822308091,84.4440128297919,530
-7.6926,53.28823,2022/05/15 23:00:00+00,Mon 16 May 2022,31,41,0,3848585,3797976,241040,4089625,4039016,85.2268168574512,84.1721372781894,531
-7.6926,53.28823,2022/08/27 23:00:00+00,Sun 28 Aug 2022,44,20,0,3856840,3811030,241052,4097892,4052082,85.399099180393,84.4444296250572,532
-7.6926,53.28823,2022/05/16 23:00:00+00,Tue 17 May 2022,97,102,0,3848682,3798078,241040,4089722,4039118,85.2288383144883,84.1742629340428,533
-7.6926,53.28823,2022/05/17 23:00:00+00,Wed 18 May 2022,98,123,0,3848780,3798201,241040,4089820,4039241,85.2308806112886,84.1768262249248,534
-7.6926,53.28823,2022/05/18 23:00:00+00,Thu 19 May 2022,73,106,0,3848853,3798307,241040,4089893,4039347,85.2324019140072,84.1790352398313,535
-7.6926,53.28823,2022/05/19 23:00:00+00,Fri 20 May 2022,127,208,0,3848980,3798515,241040,4090020,4039555,85.2350485639423,84.1833699105912,536
-7.6926,53.28823,2022/05/20 23:00:00+00,Sat 21 May 2022,392,762,0,3849372,3799277,241040,4090412,4040317,85.2432177511436,84.1992498102019,537
-7.6926,53.28823,2022/05/21 23:00:00+00,Sun 22 May 2022,234,409,0,3849606,3799686,241040,4090646,4040726,85.2480942557485,84.2077732733787,538
-7.6926,53.28823,2022/05/22 23:00:00+00,Mon 23 May 2022,26,35,0,3849632,3799721,241040,4090672,4040761,85.2486360895935,84.2085026650931,539
-7.6926,53.28823,2022/05/23 23:00:00+00,Tue 24 May 2022,64,83,0,3849696,3799804,241040,4090736,4040844,85.2499698344427,84.2102323654444,540
-7.6926,53.28823,2022/05/24 23:00:00+00,Wed 25 May 2022,86,134,1,3849782,3799938,241041,4090823,4040979,85.251782893847,84.2130457334857,541
-7.6926,53.28823,2022/05/25 23:00:00+00,Thu 26 May 2022,98,155,0,3849880,3800093,241041,4090921,4041134,85.2538251906474,84.2162758967923,542
-7.6926,53.28823,2022/05/26 23:00:00+00,Fri 27 May 2022,95,152,0,3849975,3800245,241041,4091016,4041286,85.2558049681579,84.2194435408092,543
-7.6926,53.28823,2022/05/27 23:00:00+00,Sat 28 May 2022,335,580,0,3850310,3800825,241041,4091351,4041866,85.2627862888529,84.231530603505,544
-7.6926,53.28823,2022/05/28 23:00:00+00,Sun 29 May 2022,182,349,0,3850492,3801174,241041,4091533,4042215,85.2665791257678,84.2388036808857,545
-7.6926,53.28823,2022/05/29 23:00:00+00,Mon 30 May 2022,8,23,0,3850500,3801197,241041,4091541,4042238,85.2667458438739,84.2392829954409,546
-7.6926,53.28823,2022/05/30 23:00:00+00,Tue 31 May 2022,65,79,2,3850565,3801276,241043,4091608,4042319,85.2681421080129,84.2409710162656,547
-7.6926,53.28823,2022/05/31 23:00:00+00,Wed 01 Jun 2022,68,102,0,3850633,3801378,241043,4091676,4042421,85.2695592119152,84.243096672119,548
-7.6926,53.28823,2022/06/01 23:00:00+00,Thu 02 Jun 2022,91,141,0,3850724,3801519,241043,4091767,4042562,85.2714556303726,84.2460350787399,549
-7.6926,53.28823,2022/06/02 23:00:00+00,Fri 03 Jun 2022,60,143,0,3850784,3801662,241043,4091827,4042705,85.2727060161687,84.2490151648873,550
-7.6926,53.28823,2022/06/03 23:00:00+00,Sat 04 Jun 2022,305,607,0,3851089,3802269,241043,4092132,4043312,85.2790621439657,84.2616649011914,551
-7.6926,53.28823,2022/06/04 23:00:00+00,Sun 05 Jun 2022,143,273,0,3851232,3802542,241043,4092275,4043585,85.2820422301131,84.2673541565637,552
-7.6926,53.28823,2022/06/05 23:00:00+00,Mon 06 Jun 2022,4,7,1,3851236,3802549,241044,4092280,4043593,85.2821464289294,84.2675208746699,553
-7.6926,53.28823,2022/06/06 23:00:00+00,Tue 07 Jun 2022,29,52,0,3851265,3802601,241044,4092309,4043645,85.2827507820642,84.2686045423598,554
-7.6926,53.28823,2022/06/07 23:00:00+00,Wed 08 Jun 2022,36,76,0,3851301,3802677,241044,4092345,4043721,85.2835010135419,84.2701883643683,555
-7.6926,53.28823,2022/06/08 23:00:00+00,Thu 09 Jun 2022,73,122,0,3851374,3802799,241044,4092418,4043843,85.2850223162605,84.272730815487,556
-7.6926,53.28823,2022/06/09 23:00:00+00,Fri 10 Jun 2022,56,108,0,3851430,3802907,241044,4092474,4043951,85.2861893430035,84.27498150992,557
-7.6926,53.28823,2022/06/10 23:00:00+00,Sat 11 Jun 2022,189,562,0,3851619,3803469,241044,4092663,4044513,85.2901280582613,84.286693456877,558
-7.6926,53.28823,2022/06/11 23:00:00+00,Sun 12 Jun 2022,143,288,0,3851762,3803757,241044,4092806,4044801,85.2931081444087,84.2926953086984,559
-7.6926,53.28823,2022/06/12 23:00:00+00,Mon 13 Jun 2022,17,44,0,3851779,3803801,241044,4092823,4044845,85.2934624203843,84.2936122582822,560
-7.6926,53.28823,2022/06/13 23:00:00+00,Tue 14 Jun 2022,37,55,0,3851816,3803856,241044,4092860,4044900,85.2942334916252,84.294758445262,561
-7.6926,53.28823,2022/06/14 23:00:00+00,Wed 15 Jun 2022,66,123,0,3851882,3803979,241044,4092926,4045023,85.295608916001,84.297321736144,562
-7.6926,53.28823,2022/06/15 23:00:00+00,Thu 16 Jun 2022,42,85,0,3851924,3804064,241044,4092968,4045108,85.2964841860582,84.2990931160218,563
-7.6926,53.28823,2022/06/16 23:00:00+00,Fri 17 Jun 2022,58,95,0,3851982,3804159,241044,4093026,4045203,85.2976928923278,84.3010728935324,564
-7.6926,53.28823,2022/06/17 23:00:00+00,Sat 18 Jun 2022,223,488,0,3852205,3804647,241044,4093249,4045691,85.3023401595367,84.3112426980074,565
-7.6926,53.28823,2022/06/18 23:00:00+00,Sun 19 Jun 2022,80,129,0,3852285,3804776,241044,4093329,4045820,85.3040073405982,84.3139310274691,566
-7.6926,53.28823,2022/06/19 23:00:00+00,Mon 20 Jun 2022,9,28,0,3852294,3804804,241044,4093338,4045848,85.3041948984676,84.3145145408406,567
-7.6926,53.28823,2022/06/20 23:00:00+00,Tue 21 Jun 2022,74,169,1,3852368,3804973,241045,4093413,4046018,85.3057578807128,84.3180573005963,568
-7.6926,53.28823,2022/06/21 23:00:00+00,Wed 22 Jun 2022,60,94,0,3852428,3805067,241045,4093473,4046112,85.3070082665089,84.3200162383435,569
-7.6926,53.28823,2022/06/22 23:00:00+00,Thu 23 Jun 2022,64,114,0,3852492,3805181,241045,4093537,4046226,85.3083420113581,84.3223919713562,570
-7.6926,53.28823,2022/06/23 23:00:00+00,Fri 24 Jun 2022,55,93,1,3852547,3805274,241046,4093593,4046320,85.3095090381011,84.3243509091034,571
-7.6926,53.28823,2022/06/24 23:00:00+00,Sat 25 Jun 2022,210,293,0,3852757,3805567,241046,4093803,4046613,85.3138853883875,84.3304569597411,572
-7.6926,53.28823,2022/06/25 23:00:00+00,Sun 26 Jun 2022,174,402,0,3852931,3805969,241046,4093977,4047015,85.3175115071963,84.3388345445751,573
-7.6926,53.28823,2022/06/26 23:00:00+00,Mon 27 Jun 2022,4,33,0,3852935,3806002,241046,4093981,4047048,85.3175948662494,84.339522256763,574
-7.6926,53.28823,2022/06/27 23:00:00+00,Tue 28 Jun 2022,48,60,0,3852983,3806062,241046,4094029,4047108,85.3185951748862,84.3407726425591,575
-7.6926,53.28823,2022/06/28 23:00:00+00,Wed 29 Jun 2022,63,81,3,3853046,3806143,241049,4094095,4047192,85.319970599262,84.3425231826737,576
-7.6926,53.28823,2022/06/29 23:00:00+00,Thu 30 Jun 2022,49,88,0,3853095,3806231,241049,4094144,4047280,85.3209917476621,84.3443570818413,577
-7.6926,53.28823,2022/06/30 23:00:00+00,Fri 01 Jul 2022,46,64,0,3853141,3806295,241049,4094190,4047344,85.3219503767725,84.3456908266905,578
-7.6926,53.28823,2022/07/01 23:00:00+00,Sat 02 Jul 2022,182,228,0,3853323,3806523,241049,4094372,4047572,85.3257432136874,84.3504422927157,579
-7.6926,53.28823,2022/07/02 23:00:00+00,Sun 03 Jul 2022,108,273,0,3853431,3806796,241049,4094480,4047845,85.3279939081204,84.3561315480881,580
-7.6926,53.28823,2022/07/03 23:00:00+00,Mon 04 Jul 2022,13,15,0,3853444,3806811,241049,4094493,4047860,85.3282648250429,84.3564441445371,581
-7.6926,53.28823,2022/07/04 23:00:00+00,Tue 05 Jul 2022,51,69,0,3853495,3806880,241049,4094544,4047929,85.3293276529696,84.3578820882026,582
-7.6926,53.28823,2022/07/05 23:00:00+00,Wed 06 Jul 2022,60,83,0,3853555,3806963,241049,4094604,4048012,85.3305780387657,84.3596117885539,583
-7.6926,53.28823,2022/07/06 23:00:00+00,Thu 07 Jul 2022,76,77,0,3853631,3807040,241049,4094680,4048089,85.3321618607741,84.3612164503256,584
-7.6926,53.28823,2022/07/07 23:00:00+00,Fri 08 Jul 2022,99,90,0,3853730,3807130,241049,4094779,4048179,85.3342249973377,84.3630920290198,585
-7.6926,53.28823,2022/07/08 23:00:00+00,Sat 09 Jul 2022,119,143,0,3853849,3807273,241049,4094898,4048322,85.3367049291667,84.3660721151672,586
-7.6926,53.28823,2022/07/09 23:00:00+00,Sun 10 Jul 2022,132,219,0,3853981,3807492,241049,4095030,4048541,85.3394557779181,84.370636023323,587
-7.6926,53.28823,2022/07/10 23:00:00+00,Mon 11 Jul 2022,11,16,0,3853992,3807508,241049,4095041,4048557,85.3396850153141,84.3709694595353,588
-7.6926,53.28823,2022/07/11 23:00:00+00,Tue 12 Jul 2022,44,81,0,3854036,3807589,241049,4095085,4048638,85.3406019648979,84.3726574803601,589
-7.6926,53.28823,2022/07/12 23:00:00+00,Wed 13 Jul 2022,99,74,0,3854135,3807663,241049,4095184,4048712,85.3426651014615,84.374199622842,590
-7.6926,53.28823,2022/07/13 23:00:00+00,Thu 14 Jul 2022,71,39,0,3854206,3807702,241049,4095255,4048751,85.3441447246536,84.3750123736094,591
-7.6926,53.28823,2022/07/14 23:00:00+00,Fri 15 Jul 2022,80,118,1,3854286,3807820,241050,4095336,4048870,85.3458327454783,84.3774923054384,592
-7.6926,53.28823,2022/07/15 23:00:00+00,Sat 16 Jul 2022,124,210,0,3854410,3808030,241050,4095460,4049080,85.3484168761237,84.3818686557248,593
-7.6926,53.28823,2022/07/16 23:00:00+00,Sun 17 Jul 2022,119,165,0,3854529,3808195,241050,4095579,4049245,85.3508968079526,84.3853072166641,594
-7.6926,53.28823,2022/07/17 23:00:00+00,Mon 18 Jul 2022,14,18,0,3854543,3808213,241050,4095593,4049263,85.3511885646384,84.385682332403,595
-7.6926,53.28823,2022/07/18 23:00:00+00,Tue 19 Jul 2022,30,33,0,3854573,3808246,241050,4095623,4049296,85.3518137575364,84.3863700445908,596
-7.6926,53.28823,2022/07/19 23:00:00+00,Wed 20 Jul 2022,78,66,0,3854651,3808312,241050,4095701,4049362,85.3534392590714,84.3877454689666,597
-7.6926,53.28823,2022/07/20 23:00:00+00,Thu 21 Jul 2022,52,30,0,3854703,3808342,241050,4095753,4049392,85.3545229267614,84.3883706618646,598
-7.6926,53.28823,2022/07/21 23:00:00+00,Fri 22 Jul 2022,73,70,0,3854776,3808412,241050,4095826,4049462,85.35604422948,84.3898294452934,599
-7.6926,53.28823,2022/07/22 23:00:00+00,Sat 23 Jul 2022,99,175,0,3854875,3808587,241050,4095925,4049637,85.3581073660436,84.3934764038654,600
-7.6926,53.28823,2022/07/23 23:00:00+00,Sun 24 Jul 2022,108,231,0,3854983,3808818,241050,4096033,4049868,85.3603580604766,84.3982903891805,601
-7.6926,53.28823,2022/07/24 23:00:00+00,Mon 25 Jul 2022,14,23,0,3854997,3808841,241050,4096047,4049891,85.3606498171623,84.3987697037357,602
-7.6926,53.28823,2022/07/25 23:00:00+00,Tue 26 Jul 2022,18,16,0,3855015,3808857,241050,4096065,4049907,85.3610249329012,84.399103139948,603
-7.6926,53.28823,2022/07/26 23:00:00+00,Wed 27 Jul 2022,60,72,1,3855075,3808929,241051,4096126,4049980,85.3622961584606,84.4006244426666,604
-7.6926,53.28823,2022/07/27 23:00:00+00,Thu 28 Jul 2022,49,71,0,3855124,3809000,241051,4096175,4050051,85.3633173068607,84.4021040658587,605
-7.6926,53.28823,2022/07/28 23:00:00+00,Fri 29 Jul 2022,71,105,0,3855195,3809105,241051,4096246,4050156,85.3647969300528,84.4042922410019,606
-7.6926,53.28823,2022/07/29 23:00:00+00,Sat 30 Jul 2022,100,119,0,3855295,3809224,241051,4096346,4050275,85.3668809063797,84.4067721728308,607
-7.6926,53.28823,2022/07/30 23:00:00+00,Sun 31 Jul 2022,32,57,0,3855327,3809281,241051,4096378,4050332,85.3675477788043,84.4079600393371,608
-7.6926,53.28823,2022/08/28 23:00:00+00,Mon 29 Aug 2022,13,12,0,3856853,3811042,241052,4097905,4052094,85.3993700973154,84.4446797022164,609
-7.6926,53.28823,2022/08/29 23:00:00+00,Tue 30 Aug 2022,41,44,0,3856894,3811086,241052,4097946,4052138,85.4002245276095,84.4455966518003,610
-7.6926,53.28823,2022/08/30 23:00:00+00,Wed 31 Aug 2022,28,30,0,3856922,3811116,241052,4097974,4052168,85.400808040981,84.4462218446983,611
-7.6926,53.28823,2022/08/31 23:00:00+00,Thu 01 Sep 2022,32,29,0,3856954,3811145,241052,4098006,4052197,85.4014749134056,84.4468261978331,612
-7.6926,53.28823,2022/09/01 23:00:00+00,Fri 02 Sep 2022,47,51,0,3857001,3811196,241052,4098053,4052248,85.4024543822792,84.4478890257598,613
-7.6926,53.28823,2022/09/02 23:00:00+00,Sat 03 Sep 2022,73,101,0,3857074,3811297,241052,4098126,4052349,85.4039756849978,84.44999384185,614
-7.6926,53.28823,2022/09/03 23:00:00+00,Sun 04 Sep 2022,58,82,0,3857132,3811379,241052,4098184,4052431,85.4051843912674,84.451702702438,615
-7.6926,53.28823,2022/09/04 23:00:00+00,Mon 05 Sep 2022,9,5,0,3857141,3811384,241052,4098193,4052436,85.4053719491368,84.4518069012543,616
-7.6926,53.28823,2022/09/05 23:00:00+00,Tue 06 Sep 2022,42,22,0,3857183,3811406,241052,4098235,4052458,85.4062472191941,84.4522653760462,617
-7.6926,53.28823,2022/09/06 23:00:00+00,Wed 07 Sep 2022,49,42,0,3857232,3811448,241052,4098284,4052500,85.4072683675942,84.4531406461035,618
-7.6926,53.28823,2022/09/07 23:00:00+00,Thu 08 Sep 2022,39,49,2,3857271,3811497,241054,4098325,4052551,85.4081227978883,84.4542034740302,619
-7.6926,53.28823,2022/09/08 23:00:00+00,Fri 09 Sep 2022,63,61,0,3857334,3811558,241054,4098388,4052612,85.4094357029742,84.4554746995896,620
-7.6926,53.28823,2022/09/09 23:00:00+00,Sat 10 Sep 2022,94,135,0,3857428,3811693,241054,4098482,4052747,85.4113946407214,84.4582880676309,621
-7.6926,53.28823,2022/09/10 23:00:00+00,Sun 11 Sep 2022,58,58,0,3857486,3811751,241054,4098540,4052805,85.412603346991,84.4594967739004,622
-7.6926,53.28823,2022/09/11 23:00:00+00,Mon 12 Sep 2022,13,13,0,3857499,3811764,241054,4098553,4052818,85.4128742639135,84.4597676908229,623
-7.6926,53.28823,2022/09/12 23:00:00+00,Tue 13 Sep 2022,29,25,0,3857528,3811789,241054,4098582,4052843,85.4134786170483,84.4602886849047,624
-7.6926,53.28823,2022/09/13 23:00:00+00,Wed 14 Sep 2022,36,33,0,3857564,3811822,241054,4098618,4052876,85.414228848526,84.4609763970925,625
-7.6926,53.28823,2022/09/14 23:00:00+00,Thu 15 Sep 2022,50,35,0,3857614,3811857,241054,4098668,4052911,85.4152708366894,84.4617057888069,626
-7.6926,53.28823,2022/09/15 23:00:00+00,Fri 16 Sep 2022,38,56,0,3857652,3811913,241054,4098706,4052967,85.4160627476936,84.46287281555,627
-7.6926,53.28823,2022/09/16 23:00:00+00,Sat 17 Sep 2022,67,149,0,3857719,3812062,241054,4098773,4053116,85.4174590118326,84.465977940277,628
-7.6926,53.28823,2022/09/17 23:00:00+00,Sun 18 Sep 2022,30,53,0,3857749,3812115,241054,4098803,4053169,85.4180842047307,84.4670824477302,629
-7.6926,53.28823,2022/09/18 23:00:00+00,Mon 19 Sep 2022,11,11,0,3857760,3812126,241054,4098814,4053180,85.4183134421266,84.4673116851262,630
-7.6926,53.28823,2022/09/19 23:00:00+00,Tue 20 Sep 2022,39,37,0,3857799,3812163,241054,4098853,4053217,85.4191261928941,84.4680827563671,631
-7.6926,53.28823,2022/09/20 23:00:00+00,Wed 21 Sep 2022,41,32,0,3857840,3812195,241054,4098894,4053249,85.4199806231881,84.4687496287917,632
-7.6926,53.28823,2022/09/21 23:00:00+00,Thu 22 Sep 2022,61,34,0,3857901,3812229,241054,4098955,4053283,85.4212518487475,84.4694581807428,633
-7.6926,53.28823,2022/09/22 23:00:00+00,Fri 23 Sep 2022,38,39,0,3857939,3812268,241054,4098993,4053322,85.4220437597517,84.4702709315103,634
-7.6926,53.28823,2022/09/23 23:00:00+00,Sat 24 Sep 2022,56,104,0,3857995,3812372,241054,4099049,4053426,85.4232107864947,84.4724382668903,635
-7.6926,53.28823,2022/09/24 23:00:00+00,Sun 25 Sep 2022,42,74,0,3858037,3812446,241054,4099091,4053500,85.424086056552,84.4739804093721,636
-7.6926,53.28823,2022/09/25 23:00:00+00,Mon 26 Sep 2022,23,10,0,3858060,3812456,241054,4099114,4053510,85.4245653711072,84.4741888070048,637
-7.6926,53.28823,2022/09/26 23:00:00+00,Tue 27 Sep 2022,30,33,2,3858090,3812489,241056,4099146,4053545,85.4252322435318,84.4749181987192,638
-7.6926,53.28823,2022/09/27 23:00:00+00,Wed 28 Sep 2022,43,27,0,3858133,3812516,241056,4099189,4053572,85.4261283533524,84.4754808723275,639
-7.6926,53.28823,2022/09/28 23:00:00+00,Thu 29 Sep 2022,30,23,0,3858163,3812539,241056,4099219,4053595,85.4267535462504,84.4759601868827,640
-7.6926,53.28823,2022/09/29 23:00:00+00,Fri 30 Sep 2022,39,58,0,3858202,3812597,241056,4099258,4053653,85.4275662970179,84.4771688931522,641
-7.6926,53.28823,2022/09/30 23:00:00+00,Sat 01 Oct 2022,51,105,0,3858253,3812702,241056,4099309,4053758,85.4286291249446,84.4793570682954,642
-7.6926,53.28823,2022/10/01 23:00:00+00,Sun 02 Oct 2022,26,47,0,3858279,3812749,241056,4099335,4053805,85.4291709587896,84.4803365371691,643
-7.6926,53.28823,2022/10/02 23:00:00+00,Mon 03 Oct 2022,24,1,0,3858303,3812750,241056,4099359,4053806,85.429671113108,84.4803573769323,644
-7.6926,53.28823,2022/10/03 23:00:00+00,Tue 04 Oct 2022,31,17,0,3858334,3812767,241056,4099390,4053823,85.4303171457694,84.4807116529079,645
-7.6926,53.28823,2022/10/04 23:00:00+00,Wed 05 Oct 2022,49,37,0,3858383,3812804,241056,4099439,4053860,85.4313382941695,84.4814827241488,646
-7.6926,53.28823,2022/10/05 23:00:00+00,Thu 06 Oct 2022,59,26,0,3858442,3812830,241056,4099498,4053886,85.4325678402024,84.4820245579938,647
-7.6926,53.28823,2022/10/06 23:00:00+00,Fri 07 Oct 2022,82,39,0,3858524,3812869,241056,4099580,4053925,85.4342767007904,84.4828373087613,648
-7.6926,53.28823,2022/10/07 23:00:00+00,Sat 08 Oct 2022,101,101,0,3858625,3812970,241056,4099681,4054026,85.4363815168805,84.4849421248514,649
-7.6926,53.28823,2022/10/08 23:00:00+00,Sun 09 Oct 2022,38,28,0,3858663,3812998,241056,4099719,4054054,85.4371734278847,84.485525638223,650
-7.6926,53.28823,2022/10/09 23:00:00+00,Mon 10 Oct 2022,19,2,0,3858682,3813000,241056,4099738,4054056,85.4375693833868,84.4855673177495,651
-7.6926,53.28823,2022/10/10 23:00:00+00,Tue 11 Oct 2022,80,14,0,3858762,3813014,241056,4099818,4054070,85.4392365644483,84.4858590744353,652
-7.6926,53.28823,2022/10/11 23:00:00+00,Wed 12 Oct 2022,59,36,0,3858821,3813050,241056,4099877,4054106,85.4404661104812,84.4866093059129,653
-7.6926,53.28823,2022/10/12 23:00:00+00,Thu 13 Oct 2022,80,29,0,3858901,3813079,241056,4099957,4054135,85.4421332915427,84.4872136590477,654
-7.6926,53.28823,2022/10/13 23:00:00+00,Fri 14 Oct 2022,131,21,0,3859032,3813100,241056,4100088,4054156,85.4448633005309,84.4876512940764,655
-7.6926,53.28823,2022/10/14 23:00:00+00,Sat 15 Oct 2022,108,120,0,3859140,3813220,241056,4100196,4054276,85.4471139949639,84.4901520656686,656
-7.6926,53.28823,2022/10/15 23:00:00+00,Sun 16 Oct 2022,26,37,1,3859166,3813257,241057,4100223,4054314,85.4476766685721,84.4909439766728,657
-7.6926,53.28823,2022/10/16 23:00:00+00,Mon 17 Oct 2022,67,3,1,3859233,3813260,241058,4100291,4054318,85.4490937724744,84.4910273357259,658
-7.6926,53.28823,2022/10/17 23:00:00+00,Tue 18 Oct 2022,127,17,0,3859360,3813277,241058,4100418,4054335,85.4517404224095,84.4913816117014,659
-7.6926,53.28823,2022/10/18 23:00:00+00,Wed 19 Oct 2022,98,40,0,3859458,3813317,241058,4100516,4054375,85.4537827192098,84.4922152022322,660
-7.6926,53.28823,2022/10/19 23:00:00+00,Thu 20 Oct 2022,123,9,0,3859581,3813326,241058,4100639,4054384,85.4563460100919,84.4924027601016,661
-7.6926,53.28823,2022/10/20 23:00:00+00,Fri 21 Oct 2022,136,17,0,3859717,3813343,241058,4100775,4054401,85.4591802178964,84.4927570360772,662
-7.6926,53.28823,2022/10/21 23:00:00+00,Sat 22 Oct 2022,101,56,0,3859818,3813399,241058,4100876,4054457,85.4612850339865,84.4939240628202,663
-7.6926,53.28823,2022/10/22 23:00:00+00,Sun 23 Oct 2022,81,46,0,3859899,3813445,241058,4100957,4054503,85.4629730548113,84.4948826919306,664
-7.6926,53.28823,2022/10/23 23:00:00+00,Mon 24 Oct 2022,84,4,0,3859983,3813449,241058,4101041,4054507,85.4647235949259,84.4949660509836,665
-7.6926,53.28823,2022/10/24 23:00:00+00,Tue 25 Oct 2022,74,26,0,3860057,3813475,241058,4101115,4054533,85.4662657374077,84.4955078848286,666
-7.6926,53.28823,2022/10/25 23:00:00+00,Wed 26 Oct 2022,46,25,0,3860103,3813500,241058,4101161,4054558,85.4672243665181,84.4960288789104,667
-7.6926,53.28823,2022/10/26 23:00:00+00,Thu 27 Oct 2022,64,34,0,3860167,3813534,241058,4101225,4054592,85.4685581113673,84.4967374308615,668
-7.6926,53.28823,2022/10/27 23:00:00+00,Fri 28 Oct 2022,59,19,0,3860226,3813553,241058,4101284,4054611,85.4697876574001,84.4971333863636,669
-7.6926,53.28823,2022/10/28 23:00:00+00,Sat 29 Oct 2022,91,61,0,3860317,3813614,241058,4101375,4054672,85.4716840758576,84.498404611923,670
-7.6926,53.28823,2022/10/29 23:00:00+00,Sun 30 Oct 2022,11,6,0,3860328,3813620,241058,4101386,4054678,85.4719133132535,84.4985296505026,671
-7.6926,53.28823,2022/10/31 00:00:00+00,Mon 31 Oct 2022,1,1,0,3860329,3813621,241058,4101387,4054679,85.4719341530168,84.4985504902659,672
-7.6926,53.28823,2022/11/01 00:00:00+00,Tue 01 Nov 2022,98,24,0,3860427,3813645,241058,4101485,4054703,85.4739764498171,84.4990506445843,673
-7.6926,53.28823,2022/11/02 00:00:00+00,Wed 02 Nov 2022,124,12,0,3860551,3813657,241058,4101609,4054715,85.4765605804624,84.4993007217435,674
-7.6926,53.28823,2022/11/03 00:00:00+00,Thu 03 Nov 2022,93,28,0,3860644,3813685,241058,4101702,4054743,85.4784986784464,84.499884235115,675
-7.6926,53.28823,2022/11/04 00:00:00+00,Fri 04 Nov 2022,60,21,0,3860704,3813706,241058,4101762,4054764,85.4797490642425,84.5003218701437,676
-7.6926,53.28823,2022/11/05 00:00:00+00,Sat 05 Nov 2022,47,54,0,3860751,3813760,241058,4101809,4054818,85.4807285331162,84.5014472173602,677
-7.6926,53.28823,2022/11/06 00:00:00+00,Sun 06 Nov 2022,56,75,0,3860807,3813835,241058,4101865,4054893,85.4818955598592,84.5030101996053,678
-7.6926,53.28823,2022/11/07 00:00:00+00,Mon 07 Nov 2022,52,4,0,3860859,3813839,241058,4101917,4054897,85.4829792275492,84.5030935586584,679
-7.6926,53.28823,2022/11/08 00:00:00+00,Tue 08 Nov 2022,78,28,0,3860937,3813867,241058,4101995,4054925,85.4846047290841,84.5036770720299,680
-7.6926,53.28823,2022/11/09 00:00:00+00,Wed 09 Nov 2022,94,32,0,3861031,3813899,241058,4102089,4054957,85.4865636668314,84.5043439444545,681
-7.6926,53.28823,2022/11/10 00:00:00+00,Thu 10 Nov 2022,48,15,0,3861079,3813914,241058,4102137,4054972,85.4875639754683,84.5046565409036,682
-7.6926,53.28823,2022/11/11 00:00:00+00,Fri 11 Nov 2022,48,16,0,3861127,3813930,241058,4102185,4054988,85.4885642841052,84.5049899771159,683
-7.6926,53.28823,2022/11/12 00:00:00+00,Sat 12 Nov 2022,78,84,0,3861205,3814014,241058,4102263,4055072,85.4901897856401,84.5067405172304,684
-7.6926,53.28823,2022/11/13 00:00:00+00,Sun 13 Nov 2022,45,60,0,3861250,3814074,241058,4102308,4055132,85.4911275749872,84.5079909030265,685
-7.6926,53.28823,2022/11/14 00:00:00+00,Mon 14 Nov 2022,16,2,0,3861266,3814076,241058,4102324,4055134,85.4914610111995,84.5080325825531,686
-7.6926,53.28823,2022/11/15 00:00:00+00,Tue 15 Nov 2022,82,6,0,3861348,3814082,241058,4102406,4055140,85.4931698717875,84.5081576211327,687
-7.6926,53.28823,2022/11/16 00:00:00+00,Wed 16 Nov 2022,52,20,0,3861400,3814102,241058,4102458,4055160,85.4942535394775,84.5085744163981,688
-7.6926,53.28823,2022/11/17 00:00:00+00,Thu 17 Nov 2022,65,8,1,3861465,3814110,241059,4102524,4055169,85.4956289638532,84.5087619742675,689
-7.6926,53.28823,2022/11/18 00:00:00+00,Fri 18 Nov 2022,29,22,0,3861494,3814132,241059,4102553,4055191,85.496233316988,84.5092204490594,690
-7.6926,53.28823,2022/11/19 00:00:00+00,Sat 19 Nov 2022,51,57,0,3861545,3814189,241059,4102604,4055248,85.4972961449147,84.5104083155657,691
-7.6926,53.28823,2022/11/20 00:00:00+00,Sun 20 Nov 2022,43,53,0,3861588,3814242,241059,4102647,4055301,85.4981922547353,84.5115128230189,692
-7.6926,53.28823,2022/11/21 00:00:00+00,Mon 21 Nov 2022,18,3,0,3861606,3814245,241059,4102665,4055304,85.4985673704741,84.5115753423087,693
-7.6926,53.28823,2022/11/22 00:00:00+00,Tue 22 Nov 2022,47,17,0,3861653,3814262,241059,4102712,4055321,85.4995468393477,84.5119296182843,694
-7.6926,53.28823,2022/11/23 00:00:00+00,Wed 23 Nov 2022,25,16,0,3861678,3814278,241059,4102737,4055337,85.5000678334294,84.5122630544966,695
-7.6926,53.28823,2022/11/24 00:00:00+00,Thu 24 Nov 2022,27,15,0,3861705,3814293,241059,4102764,4055352,85.5006305070377,84.5125756509456,696
