X,Y,VaccinationDate,VaccineText,Dose1,Dose2,SingleDose,Dose1Cum,Dose2Cum,SingleDoseCum,PartiallyVacc,FullyVacc,PartialPercent,FullyPercent,ObjectId
-7.6926,53.28823,2021/10/29 23:00:00+00,Sat 30 Oct 2021,2020,1451,1,3618675,3554586,240726,3859401,3795312,81.9595927462572,80.598576272583,1
-7.6926,53.28823,2022/02/09 00:00:00+00,Wed 09 Feb 2022,1333,1783,0,3813301,3706329,240891,4054192,3947220,86.0962427161972,83.8245478196957,2
-7.6926,53.28823,2021/10/30 23:00:00+00,Sun 31 Oct 2021,1596,1320,0,3620271,3555906,240726,3860997,3796632,81.9934859618166,80.6266082553765,3
-7.6926,53.28823,2022/02/10 00:00:00+00,Thu 10 Feb 2022,685,2549,0,3813986,3708878,240891,4054877,3949769,86.110789616359,83.878679277378,4
-7.6926,53.28823,2021/11/01 00:00:00+00,Mon 01 Nov 2021,278,290,2,3620549,3556196,240728,3861277,3796924,81.9994321399849,80.632809269752,5
-7.6926,53.28823,2021/11/02 00:00:00+00,Tue 02 Nov 2021,1100,1095,10,3621649,3557291,240738,3862387,3798029,82.0230044891522,80.6562754371662,6
-7.6926,53.28823,2022/02/11 00:00:00+00,Fri 11 Feb 2022,547,4920,0,3814533,3713798,240891,4055424,3954689,86.1224059001377,83.9831621223354,7
-7.6926,53.28823,2021/11/03 00:00:00+00,Wed 03 Nov 2021,2535,1880,7,3624184,3559171,240745,3864929,3799916,82.0769872923802,80.6963484307505,8
-7.6926,53.28823,2022/02/12 00:00:00+00,Sat 12 Feb 2022,1397,5462,0,3815930,3719260,240891,4056821,3960151,86.1520730819275,84.0991550693186,9
-7.6926,53.28823,2021/11/04 00:00:00+00,Thu 04 Nov 2021,1534,1285,2,3625718,3560456,240747,3866465,3801203,82.1096063269035,80.7236796139741,10
-7.6926,53.28823,2022/02/13 00:00:00+00,Sun 13 Feb 2022,1567,4706,0,3817497,3723966,240891,4058388,3964857,86.1853504433194,84.1990933352474,11
-7.6926,53.28823,2021/11/05 00:00:00+00,Fri 05 Nov 2021,1628,1097,4,3627346,3561553,240751,3868097,3802304,82.1442640510845,80.7470608359859,12
-7.6926,53.28823,2021/11/06 00:00:00+00,Sat 06 Nov 2021,1816,1357,6,3629162,3562910,240757,3869919,3803667,82.1829566818797,80.7760059818552,13
-7.6926,53.28823,2022/02/14 00:00:00+00,Mon 14 Feb 2022,173,953,0,3817670,3724919,240891,4058561,3965810,86.1890243319734,84.2193315773703,14
-7.6926,53.28823,2021/11/07 00:00:00+00,Sun 07 Nov 2021,696,775,0,3629858,3563685,240757,3870615,3804442,82.197737181898,80.7924641535711,15
-7.6926,53.28823,2022/02/15 00:00:00+00,Tue 15 Feb 2022,649,817,1,3818319,3725736,240892,4059211,3966628,86.2028279598642,84.236702912162,16
-7.6926,53.28823,2021/11/08 00:00:00+00,Mon 08 Nov 2021,517,530,3,3630375,3564215,240760,3871135,3804975,82.2087800842106,80.8037831284415,17
-7.6926,53.28823,2022/02/16 00:00:00+00,Wed 16 Feb 2022,800,1786,0,3819119,3727522,240892,4060011,3968414,86.219817040345,84.2746310343356,18
-7.6926,53.28823,2021/11/09 00:00:00+00,Tue 09 Nov 2021,1370,1063,3,3631745,3565278,240763,3872508,3806041,82.2379375935859,80.8264210781823,19
-7.6926,53.28823,2022/02/17 00:00:00+00,Thu 17 Feb 2022,790,1192,2,3819909,3728714,240894,4060803,3969608,86.2366362300211,84.2999872369533,20
-7.6926,53.28823,2021/11/10 00:00:00+00,Wed 10 Nov 2021,1609,1360,1,3633354,3566638,240764,3874118,3807402,82.2721281180537,80.8553237513504,21
-7.6926,53.28823,2022/02/18 00:00:00+00,Fri 18 Feb 2022,791,3293,0,3820700,3732007,240894,4061594,3972901,86.2534341833466,84.3699185394827,22
-7.6926,53.28823,2021/11/11 00:00:00+00,Thu 11 Nov 2021,1386,1114,1,3634740,3567752,240765,3875505,3808517,82.3015829363375,80.8790022822706,23
-7.6926,53.28823,2022/02/19 00:00:00+00,Sat 19 Feb 2022,980,3555,0,3821680,3735562,240894,4062574,3976456,86.2742458069357,84.4454137658697,24
-7.6926,53.28823,2021/11/12 00:00:00+00,Fri 12 Nov 2021,1143,1156,6,3635883,3568908,240771,3876654,3809679,82.3259835031781,80.9036789216691,25
-7.6926,53.28823,2022/02/20 00:00:00+00,Sun 20 Feb 2022,1366,3587,0,3823046,3739149,240894,4063940,3980043,86.3032546618568,84.5215885554758,26
-7.6926,53.28823,2021/11/13 00:00:00+00,Sat 13 Nov 2021,1397,1377,0,3637280,3570285,240771,3878051,3811056,82.3556506849679,80.9329213764468,27
-7.6926,53.28823,2022/02/21 00:00:00+00,Mon 21 Feb 2022,253,994,1,3823299,3740143,240895,4064194,3981038,86.3086486949095,84.5427187243239,28
-7.6926,53.28823,2021/11/14 00:00:00+00,Sun 14 Nov 2021,1647,1807,1,3638927,3572092,240772,3879699,3812864,82.3906481907585,80.9713166983336,29
-7.6926,53.28823,2022/02/22 00:00:00+00,Tue 22 Feb 2022,477,981,0,3823776,3741124,240895,4064671,3982019,86.3187784341462,84.5635515842636,30
-7.6926,53.28823,2022/02/23 00:00:00+00,Wed 23 Feb 2022,832,1272,1,3824608,3742396,240896,4065504,3983292,86.3364683141969,84.5905854585788,31
-7.6926,53.28823,2021/11/15 00:00:00+00,Mon 15 Nov 2021,1239,597,1,3640166,3572689,240773,3880939,3813462,82.4169812655039,80.9840160359931,32
-7.6926,53.28823,2022/02/24 00:00:00+00,Thu 24 Feb 2022,657,1233,0,3825265,3743629,240896,4066161,3984525,86.3504205965418,84.61676987887,33
-7.6926,53.28823,2021/11/16 00:00:00+00,Tue 16 Nov 2021,1315,1075,5,3641481,3573764,240778,3882259,3814542,82.4450132482973,81.0069512946423,34
-7.6926,53.28823,2022/02/25 00:00:00+00,Fri 25 Feb 2022,691,1227,0,3825956,3744856,240896,4066852,3985752,86.3650949148072,84.6428268810575,35
-7.6926,53.28823,2022/02/26 00:00:00+00,Sat 26 Feb 2022,959,2092,0,3826915,3746948,240896,4067811,3987844,86.3854605750337,84.687253326515,36
-7.6926,53.28823,2021/11/17 00:00:00+00,Wed 17 Nov 2021,1502,1116,1,3642983,3574880,240779,3883762,3815659,82.4769314832508,81.0306722982637,37
-7.6926,53.28823,2022/02/27 00:00:00+00,Sun 27 Feb 2022,671,1783,0,3827586,3748731,240896,4068482,3989627,86.399710166287,84.7251177396368,38
-7.6926,53.28823,2022/02/28 00:00:00+00,Mon 28 Feb 2022,81,428,0,3827667,3749159,240896,4068563,3990055,86.4014303106857,84.7342068976941,39
-7.6926,53.28823,2021/11/18 00:00:00+00,Thu 18 Nov 2021,1643,2502,5,3644626,3577382,240784,3885410,3818166,82.5119289890414,81.0839118292207,40
-7.6926,53.28823,2022/03/01 00:00:00+00,Tue 01 Mar 2022,130,937,0,3827797,3750096,240896,4068693,3990992,86.4041910362638,84.7541053582073,41
-7.6926,53.28823,2021/11/19 00:00:00+00,Fri 19 Nov 2021,1163,1554,0,3645789,3578936,240784,3886573,3819720,82.5366268647905,81.1169131180548,42
-7.6926,53.28823,2021/11/20 00:00:00+00,Sat 20 Nov 2021,1545,2942,12,3647334,3581878,240796,3888130,3822674,82.5696918626764,81.1796452977304,43
-7.6926,53.28823,2022/03/02 00:00:00+00,Wed 02 Mar 2022,206,996,2,3828003,3751092,240898,4068901,3991990,86.4086081971889,84.7752992361072,44
-7.6926,53.28823,2021/11/21 00:00:00+00,Sun 21 Nov 2021,1788,2766,0,3649122,3584644,240796,3889918,3825440,82.6076624575512,81.2383850434931,45
-7.6926,53.28823,2022/03/03 00:00:00+00,Thu 03 Mar 2022,279,1274,0,3828282,3752366,240898,4069180,3993264,86.4145331390066,84.802354346773,46
-7.6926,53.28823,2021/11/22 00:00:00+00,Mon 22 Nov 2021,719,519,3,3649841,3585163,240799,3890640,3825962,82.6229951026852,81.2494704185069,47
-7.6926,53.28823,2022/03/04 00:00:00+00,Fri 04 Mar 2022,735,1507,1,3829017,3753873,240899,4069916,3994772,86.430163093049,84.8343787634795,48
-7.6926,53.28823,2021/11/23 00:00:00+00,Tue 23 Nov 2021,2153,1596,7,3651994,3586759,240806,3892800,3827565,82.6688656199836,81.2835122885205,49
-7.6926,53.28823,2022/03/05 00:00:00+00,Sat 05 Mar 2022,963,3341,0,3829980,3757214,240899,4070879,3998113,86.4506136986778,84.9053294108378,50
-7.6926,53.28823,2022/03/06 00:00:00+00,Sun 06 Mar 2022,455,1915,0,3830435,3759129,240899,4071334,4000028,86.4602762382013,84.9459970222389,51
-7.6926,53.28823,2022/03/07 00:00:00+00,Mon 07 Mar 2022,114,124,1,3830549,3759253,240900,4071449,4000153,86.4627184185205,84.9486515660641,52
-7.6926,53.28823,2022/03/08 00:00:00+00,Tue 08 Mar 2022,120,493,0,3830669,3759746,240900,4071569,4000646,86.4652667805926,84.9591210869104,53
-7.6926,53.28823,2022/03/09 00:00:00+00,Wed 09 Mar 2022,130,345,1,3830799,3760091,240901,4071700,4000992,86.4680487425213,84.9664688642184,54
-7.6926,53.28823,2022/03/10 00:00:00+00,Thu 10 Mar 2022,258,509,0,3831057,3760600,240901,4071958,4001501,86.4735277209764,84.9772781666744,55
-7.6926,53.28823,2022/03/11 00:00:00+00,Fri 11 Mar 2022,493,2182,0,3831550,3762782,240901,4072451,4003683,86.4839972418228,85.0236158836859,56
-7.6926,53.28823,2022/03/12 00:00:00+00,Sat 12 Mar 2022,473,2391,2,3832023,3765173,240903,4072926,4006076,86.4940845083583,85.0744344706744,57
-7.6926,53.28823,2022/03/13 00:00:00+00,Sun 13 Mar 2022,358,1082,0,3832381,3766255,240903,4073284,4007158,86.5016871218735,85.0974122020248,58
-7.6926,53.28823,2022/03/14 00:00:00+00,Mon 14 Mar 2022,109,121,0,3832490,3766376,240903,4073393,4007279,86.504001884089,85.0999818004475,59
-7.6926,53.28823,2022/03/15 00:00:00+00,Tue 15 Mar 2022,220,756,1,3832710,3767132,240904,4073614,4008036,86.5086951175719,85.1160577178526,60
-7.6926,53.28823,2022/03/16 00:00:00+00,Wed 16 Mar 2022,196,797,0,3832906,3767929,240904,4073810,4008833,86.5128574422897,85.1329830892817,61
-7.6926,53.28823,2022/03/18 00:00:00+00,Fri 18 Mar 2022,1,6,0,3832907,3767935,240904,4073811,4008839,86.5128786786403,85.1331105073853,62
-7.6926,53.28823,2022/03/19 00:00:00+00,Sat 19 Mar 2022,744,2779,0,3833651,3770714,240904,4074555,4011618,86.5286785234875,85.1921263257057,63
-7.6926,53.28823,2022/03/20 00:00:00+00,Sun 20 Mar 2022,395,1402,0,3834046,3772116,240904,4074950,4013020,86.537066881975,85.2218996892485,64
-7.6926,53.28823,2022/03/21 00:00:00+00,Mon 21 Mar 2022,55,112,0,3834101,3772228,240904,4075005,4013132,86.538234881258,85.2242781605158,65
-7.6926,53.28823,2022/03/22 00:00:00+00,Tue 22 Mar 2022,140,574,0,3834241,3772802,240904,4075145,4013706,86.5412079703422,85.2364678257608,66
-7.6926,53.28823,2022/03/23 00:00:00+00,Wed 23 Mar 2022,102,221,0,3834343,3773023,240904,4075247,4013927,86.5433740781035,85.2411610592437,67
-7.6926,53.28823,2022/03/24 00:00:00+00,Thu 24 Mar 2022,147,244,0,3834490,3773267,240904,4075394,4014171,86.5464958216418,85.2463427287904,68
-7.6926,53.28823,2022/03/25 00:00:00+00,Fri 25 Mar 2022,435,1625,0,3834925,3774892,240904,4075829,4015796,86.5557336341533,85.2808517985171,69
-7.6926,53.28823,2022/03/26 00:00:00+00,Sat 26 Mar 2022,874,1848,0,3835799,3776740,240904,4076703,4017644,86.5742942045787,85.320096574428,70
-7.6926,53.28823,2022/03/27 00:00:00+00,Sun 27 Mar 2022,380,803,0,3836179,3777543,240904,4077083,4018447,86.5823640178071,85.3371493639607,71
-7.6926,53.28823,2022/03/27 23:00:00+00,Mon 28 Mar 2022,44,53,1,3836223,3777596,240905,4077128,4018501,86.5833196535842,85.3382961268931,72
-7.6926,53.28823,2022/03/28 23:00:00+00,Tue 29 Mar 2022,138,194,3,3836361,3777790,240908,4077269,4018698,86.5863139790189,85.3424796879616,73
-7.6926,53.28823,2022/03/29 23:00:00+00,Wed 30 Mar 2022,109,135,0,3836470,3777925,240908,4077378,4018833,86.5886287412344,85.3453465952927,74
-7.6926,53.28823,2022/03/30 23:00:00+00,Thu 31 Mar 2022,227,358,0,3836697,3778283,240908,4077605,4019191,86.5934493928209,85.3529492088079,75
-7.6926,53.28823,2022/03/31 23:00:00+00,Fri 01 Apr 2022,304,904,0,3837001,3779187,240908,4077909,4020095,86.5999052434036,85.3721468697513,76
-7.6926,53.28823,2022/04/01 23:00:00+00,Sat 02 Apr 2022,730,1539,0,3837731,3780726,240908,4078639,4021634,86.6154077793424,85.4048296133264,77
-7.6926,53.28823,2022/04/02 23:00:00+00,Sun 03 Apr 2022,538,815,0,3838269,3781541,240908,4079177,4022449,86.6268329359658,85.4221372390663,78
-7.6926,53.28823,2022/04/03 23:00:00+00,Mon 04 Apr 2022,50,52,0,3838319,3781593,240908,4079227,4022501,86.6278947534959,85.4232415292976,79
-7.6926,53.28823,2022/04/04 23:00:00+00,Tue 05 Apr 2022,130,169,0,3838449,3781762,240908,4079357,4022670,86.630655479074,85.4268304725492,80
-7.6926,53.28823,2022/04/05 23:00:00+00,Wed 06 Apr 2022,159,210,0,3838608,3781972,240908,4079516,4022880,86.6340320588196,85.4312901061754,81
-7.6926,53.28823,2022/04/06 23:00:00+00,Thu 07 Apr 2022,117,178,0,3838725,3782150,240908,4079633,4023058,86.6365167118399,85.4350701765824,82
-7.6926,53.28823,2022/04/07 23:00:00+00,Fri 08 Apr 2022,258,421,2,3838983,3782571,240910,4079893,4023481,86.6420381629962,85.4440531528866,83
-7.6926,53.28823,2022/04/08 23:00:00+00,Sat 09 Apr 2022,559,1018,0,3839542,3783589,240910,4080452,4024499,86.6539092829822,85.4656717577986,84
-7.6926,53.28823,2022/04/09 23:00:00+00,Sun 10 Apr 2022,413,719,0,3839955,3784308,240910,4080865,4025218,86.6626798957805,85.4809406938808,85
-7.6926,53.28823,2022/04/10 23:00:00+00,Mon 11 Apr 2022,70,92,1,3840025,3784400,240911,4080936,4025311,86.6641876766732,85.4829156744867,86
-7.6926,53.28823,2022/04/11 23:00:00+00,Tue 12 Apr 2022,198,177,0,3840223,3784577,240911,4081134,4025488,86.6683924740922,85.4866745085431,87
-7.6926,53.28823,2022/04/12 23:00:00+00,Wed 13 Apr 2022,144,232,0,3840367,3784809,240911,4081278,4025720,86.6714505085787,85.4916013418825,88
-7.6926,53.28823,2022/04/13 23:00:00+00,Thu 14 Apr 2022,360,429,0,3840727,3785238,240911,4081638,4026149,86.6790955947951,85.5007117362904,89
-7.6926,53.28823,2022/04/14 23:00:00+00,Fri 15 Apr 2022,446,990,0,3841173,3786228,240911,4082084,4027139,86.6885670071632,85.5217357233855,90
-7.6926,53.28823,2022/04/15 23:00:00+00,Sat 16 Apr 2022,42,88,0,3841215,3786316,240911,4082126,4027227,86.6894589338885,85.5236045222384,91
-7.6926,53.28823,2022/04/16 23:00:00+00,Sun 17 Apr 2022,1,0,0,3841216,3786316,240911,4082127,4027227,86.6894801702391,85.5236045222384,92
-7.6926,53.28823,2022/04/17 23:00:00+00,Mon 18 Apr 2022,36,62,1,3841252,3786378,240912,4082164,4027290,86.6902659152113,85.5249424123263,93
-7.6926,53.28823,2022/04/18 23:00:00+00,Tue 19 Apr 2022,218,269,1,3841470,3786647,240913,4082383,4027560,86.694916675993,85.5306762269886,94
-7.6926,53.28823,2022/04/19 23:00:00+00,Wed 20 Apr 2022,250,606,0,3841720,3787253,240913,4082633,4028166,86.7002257636432,85.5435454554528,95
-7.6926,53.28823,2022/04/20 23:00:00+00,Thu 21 Apr 2022,171,236,0,3841891,3787489,240913,4082804,4028402,86.703857179596,85.5485572341947,96
-7.6926,53.28823,2022/04/21 23:00:00+00,Fri 22 Apr 2022,196,254,0,3842087,3787743,240913,4083000,4028656,86.7080195043139,85.5539512672474,97
-7.6926,53.28823,2022/04/22 23:00:00+00,Sat 23 Apr 2022,324,1010,0,3842411,3788753,240913,4083324,4029666,86.7149000819086,85.5753999813545,98
-7.6926,53.28823,2022/04/23 23:00:00+00,Sun 24 Apr 2022,181,253,0,3842592,3789006,240913,4083505,4029919,86.7187438613674,85.5807727780566,99
-7.6926,53.28823,2022/04/24 23:00:00+00,Mon 25 Apr 2022,42,58,1,3842634,3789064,240914,4083548,4029978,86.7196570244433,85.582025722742,100
-7.6926,53.28823,2022/04/25 23:00:00+00,Tue 26 Apr 2022,145,238,0,3842779,3789302,240914,4083693,4030216,86.7227362952804,85.5870799741851,101
-7.6926,53.28823,2022/04/26 23:00:00+00,Wed 27 Apr 2022,122,208,0,3842901,3789510,240914,4083815,4030424,86.7253271300537,85.5914971351101,102
-7.6926,53.28823,2022/04/27 23:00:00+00,Thu 28 Apr 2022,103,130,0,3843004,3789640,240914,4083918,4030554,86.7275144741657,85.5942578606883,103
-7.6926,53.28823,2022/04/28 23:00:00+00,Fri 29 Apr 2022,171,222,0,3843175,3789862,240914,4084089,4030776,86.7311458901185,85.5989723305217,104
-7.6926,53.28823,2022/04/29 23:00:00+00,Sat 30 Apr 2022,282,723,0,3843457,3790585,240914,4084371,4031499,86.737134540988,85.6143262120063,105
-7.6926,53.28823,2022/04/30 23:00:00+00,Sun 01 May 2022,187,746,0,3843644,3791331,240914,4084558,4032245,86.7411057385504,85.6301685295547,106
-7.6926,53.28823,2022/05/01 23:00:00+00,Mon 02 May 2022,13,26,0,3843657,3791357,240914,4084571,4032271,86.7413818111082,85.6307206746704,107
-7.6926,53.28823,2022/05/02 23:00:00+00,Tue 03 May 2022,101,117,0,3843758,3791474,240914,4084672,4032388,86.7435266825189,85.6332053276907,108
-7.6926,53.28823,2022/05/03 23:00:00+00,Wed 04 May 2022,116,128,0,3843874,3791602,240914,4084788,4032516,86.7459900991886,85.6359235805676,109
-7.6926,53.28823,2022/05/04 23:00:00+00,Thu 05 May 2022,117,164,0,3843991,3791766,240914,4084905,4032680,86.7484747522089,85.6394063420662,110
-7.6926,53.28823,2022/05/05 23:00:00+00,Fri 06 May 2022,140,257,0,3844131,3792023,240914,4085045,4032937,86.7514478412931,85.6448640841707,111
-7.6926,53.28823,2022/05/06 23:00:00+00,Sat 07 May 2022,442,1087,0,3844573,3793110,240914,4085487,4034024,86.7608343082588,85.6679479972741,112
-7.6926,53.28823,2022/05/07 23:00:00+00,Sun 08 May 2022,275,437,0,3844848,3793547,240914,4085762,4034461,86.7666743046741,85.6772282824868,113
-7.6926,53.28823,2022/05/08 23:00:00+00,Mon 09 May 2022,27,32,0,3844875,3793579,240914,4085789,4034493,86.7672476861403,85.677907845706,114
-7.6926,53.28823,2022/05/09 23:00:00+00,Tue 10 May 2022,84,98,1,3844959,3793677,240915,4085874,4034592,86.7690527759414,85.6800102444155,115
-7.6926,53.28823,2022/05/10 23:00:00+00,Wed 11 May 2022,123,132,0,3845082,3793809,240915,4085997,4034724,86.7716648470654,85.6828134426949,116
-7.6926,53.28823,2022/05/11 23:00:00+00,Thu 12 May 2022,248,397,0,3845330,3794206,240915,4086245,4035121,86.7769314620144,85.6912442738835,117
-7.6926,53.28823,2022/05/12 23:00:00+00,Fri 13 May 2022,182,326,0,3845512,3794532,240915,4086427,4035447,86.7807964778238,85.6981673241795,118
-7.6926,53.28823,2022/05/13 23:00:00+00,Sat 14 May 2022,333,632,0,3845845,3795164,240915,4086760,4036079,86.787868182574,85.7115886977594,119
-7.6926,53.28823,2022/05/14 23:00:00+00,Sun 15 May 2022,169,254,0,3846014,3795418,240915,4086929,4036333,86.7914571258256,85.716982730812,120
-7.6926,53.28823,2022/05/15 23:00:00+00,Mon 16 May 2022,32,40,0,3846046,3795458,240915,4086961,4036373,86.7921366890448,85.7178321848361,121
-7.6926,53.28823,2022/05/16 23:00:00+00,Tue 17 May 2022,97,98,0,3846143,3795556,240915,4087058,4036471,86.7941966150531,85.719913347195,122
-7.6926,53.28823,2022/05/17 23:00:00+00,Wed 18 May 2022,103,121,0,3846246,3795677,240915,4087161,4036592,86.796383959165,85.7224829456177,123
-7.6926,53.28823,2022/05/18 23:00:00+00,Thu 19 May 2022,99,104,0,3846345,3795781,240915,4087260,4036696,86.7984863578746,85.7246915260802,124
-7.6926,53.28823,2022/05/19 23:00:00+00,Fri 20 May 2022,128,208,0,3846473,3795989,240915,4087388,4036904,86.8012046107515,85.7291086870053,125
-7.6926,53.28823,2022/05/20 23:00:00+00,Sat 21 May 2022,393,761,0,3846866,3796750,240915,4087781,4037665,86.8095504965377,85.7452695498127,126
-7.6926,53.28823,2022/05/21 23:00:00+00,Sun 22 May 2022,234,409,0,3847100,3797159,240915,4088015,4038074,86.8145198025784,85.7539552172086,127
-7.6926,53.28823,2021/04/08 23:00:00+00,Fri 09 Apr 2021,20677,9160,16,775167,331600,204,775371,331804,16.4660504019298,7.04630607484922,128
-7.6926,53.28823,2020/12/28 00:00:00+00,Mon 28 Dec 2020,226,14,1,226,14,1,227,15,0.00482065158645095,0.000318545259016583,129
-7.6926,53.28823,2021/07/19 23:00:00+00,Tue 20 Jul 2021,30587,18184,7699,2912100,2397845,182336,3094436,2580181,65.7145278086826,54.7936283303111,130
-7.6926,53.28823,2021/11/24 00:00:00+00,Wed 24 Nov 2021,1608,3144,2,3653602,3589903,240808,3894410,3830711,82.7030561444514,81.3503218475115,131
-7.6926,53.28823,2021/04/09 23:00:00+00,Sat 10 Apr 2021,11179,4175,12,786346,335775,216,786562,335991,16.7037064015068,7.13522267481605,132
-7.6926,53.28823,2020/12/29 00:00:00+00,Tue 29 Dec 2020,77,2,0,303,16,1,304,17,0.00645585058273608,0.000361017960218794,133
-7.6926,53.28823,2021/07/20 23:00:00+00,Wed 21 Jul 2021,30363,19844,6890,2942463,2417689,189226,3131689,2606915,66.5056455776255,55.361360927281,134
-7.6926,53.28823,2021/11/25 00:00:00+00,Thu 25 Nov 2021,976,1185,1,3654578,3591088,240809,3895387,3831897,82.7238040589886,81.3755081593245,135
-7.6926,53.28823,2021/04/10 23:00:00+00,Sun 11 Apr 2021,2865,366,8,789211,336141,224,789435,336365,16.7647184367837,7.14316506994086,136
-7.6926,53.28823,2020/12/30 00:00:00+00,Wed 30 Dec 2020,1059,1,0,1362,17,1,1363,18,0.0289451458693068,0.000382254310819899,137
-7.6926,53.28823,2021/07/21 23:00:00+00,Thu 22 Jul 2021,33543,15931,6934,2976006,2433620,196160,3172166,2629780,67.3652293409065,55.8469300837753,138
-7.6926,53.28823,2021/11/26 00:00:00+00,Fri 26 Nov 2021,1285,1108,12,3655863,3592196,240821,3896684,3833017,82.7513476057183,81.3992928719977,139
-7.6926,53.28823,2021/04/11 23:00:00+00,Mon 12 Apr 2021,7778,2797,13,796989,338938,237,797226,339175,16.930170844317,7.20283921512997,140
-7.6926,53.28823,2020/12/31 00:00:00+00,Thu 31 Dec 2020,1033,1,0,2395,18,1,2396,19,0.0508822960402488,0.000403490661421005,141
-7.6926,53.28823,2021/07/22 23:00:00+00,Fri 23 Jul 2021,27091,20837,5615,3003097,2454457,201775,3204872,2656232,68.0597854236663,56.4086740298757,142
-7.6926,53.28823,2021/11/27 00:00:00+00,Sat 27 Nov 2021,1200,1564,6,3657063,3593760,240827,3897890,3834587,82.7769586445432,81.4326339424414,143
-7.6926,53.28823,2021/04/12 23:00:00+00,Tue 13 Apr 2021,11519,8588,1,808508,347526,238,808746,347764,17.1748136032417,7.38523823044286,144
-7.6926,53.28823,2021/01/01 00:00:00+00,Fri 01 Jan 2021,815,0,0,3210,18,1,3211,19,0.0681899217801498,0.000403490661421005,145
-7.6926,53.28823,2021/07/23 23:00:00+00,Sat 24 Jul 2021,15439,14812,2275,3018536,2469269,204050,3222586,2673319,68.4359661382142,56.7715395525968,146
-7.6926,53.28823,2022/05/22 23:00:00+00,Mon 23 May 2022,30,36,0,3847130,3797195,240915,4088045,4038110,86.8151568930964,85.7547197258302,147
-7.6926,53.28823,2021/11/28 00:00:00+00,Sun 28 Nov 2021,1953,2257,1,3659016,3596017,240828,3899844,3836845,82.8184544736178,81.4805856220987,148
-7.6926,53.28823,2021/11/29 00:00:00+00,Mon 29 Nov 2021,534,993,1,3659550,3597010,240829,3900379,3837839,82.8298159211894,81.5016945545962,149
-7.6926,53.28823,2021/11/30 00:00:00+00,Tue 30 Nov 2021,1894,1646,6,3661444,3598656,240835,3902279,3839491,82.8701649873314,81.5367770057892,150
-7.6926,53.28823,2021/12/01 00:00:00+00,Wed 01 Dec 2021,1037,1381,4,3662481,3600037,240839,3903320,3840876,82.8922720283072,81.5661893513718,151
-7.6926,53.28823,2021/12/02 00:00:00+00,Thu 02 Dec 2021,1739,1411,0,3664220,3601448,240839,3905059,3842287,82.9292020420025,81.5961538420699,152
-7.6926,53.28823,2021/12/03 00:00:00+00,Fri 03 Dec 2021,1014,1189,2,3665234,3602637,240841,3906075,3843478,82.9507781742132,81.6214463356359,153
-7.6926,53.28823,2021/12/04 00:00:00+00,Sat 04 Dec 2021,1202,1700,1,3666436,3604337,240842,3907278,3845179,82.9763255039864,81.6575693680083,154
-7.6926,53.28823,2021/12/05 00:00:00+00,Sun 05 Dec 2021,1346,1774,2,3667782,3606111,240844,3908626,3846955,83.0049521045967,81.6952851266759,155
-7.6926,53.28823,2021/12/06 00:00:00+00,Mon 06 Dec 2021,932,1297,0,3668714,3607408,240844,3909558,3848252,83.0247443833569,81.7228286734055,156
-7.6926,53.28823,2021/12/07 00:00:00+00,Tue 07 Dec 2021,484,742,2,3669198,3608150,240846,3910044,3848996,83.035065249749,81.7386285182528,157
-7.6926,53.28823,2021/12/08 00:00:00+00,Wed 08 Dec 2021,785,1521,2,3669983,3609671,240848,3910831,3850519,83.0517782576721,81.7709714802182,158
-7.6926,53.28823,2021/12/09 00:00:00+00,Thu 09 Dec 2021,786,1210,1,3670769,3610881,240849,3911618,3851730,83.0684912655952,81.7966887007962,159
-7.6926,53.28823,2021/12/10 00:00:00+00,Fri 10 Dec 2021,887,1613,1,3671656,3612494,240850,3912506,3853344,83.087349144929,81.8309641706663,160
-7.6926,53.28823,2021/12/11 00:00:00+00,Sat 11 Dec 2021,638,842,2,3672294,3613336,240852,3913146,3854188,83.1009404093137,81.8488876505737,161
-7.6926,53.28823,2021/12/12 00:00:00+00,Sun 12 Dec 2021,685,1192,0,3672979,3614528,240852,3913831,3855380,83.1154873094754,81.8742013804902,162
-7.6926,53.28823,2021/12/13 00:00:00+00,Mon 13 Dec 2021,719,1069,1,3673698,3615597,240853,3914551,3856450,83.1307774819082,81.8969242756334,163
-7.6926,53.28823,2021/12/14 00:00:00+00,Tue 14 Dec 2021,626,1201,3,3674324,3616798,240856,3915180,3857654,83.1441351464363,81.9224928417571,164
-7.6926,53.28823,2021/12/15 00:00:00+00,Wed 15 Dec 2021,789,1259,0,3675113,3618057,240856,3915969,3858913,83.1608906270606,81.9492294071639,165
-7.6926,53.28823,2021/12/16 00:00:00+00,Thu 16 Dec 2021,1042,1542,7,3676155,3619599,240863,3917018,3860462,83.1831675588411,81.982124514245,166
-7.6926,53.28823,2021/12/17 00:00:00+00,Fri 17 Dec 2021,1197,2459,1,3677352,3622058,240864,3918216,3862922,83.2086087068613,82.0343659367237,167
-7.6926,53.28823,2021/12/18 00:00:00+00,Sat 18 Dec 2021,1245,1183,0,3678597,3623241,240864,3919461,3864105,83.2350479633596,82.0594885394848,168
-7.6926,53.28823,2021/12/19 00:00:00+00,Sun 19 Dec 2021,544,887,1,3679141,3624128,240865,3920006,3864993,83.2466217744373,82.0783464188186,169
-7.6926,53.28823,2021/12/20 00:00:00+00,Mon 20 Dec 2021,506,615,1,3679647,3624743,240866,3920513,3865609,83.257388604192,82.0914280107889,170
-7.6926,53.28823,2021/12/21 00:00:00+00,Tue 21 Dec 2021,1397,1816,3,3681044,3626559,240869,3921913,3867428,83.2871194950336,82.1300569325323,171
-7.6926,53.28823,2021/12/22 00:00:00+00,Wed 22 Dec 2021,1154,1595,2,3682198,3628154,240871,3923069,3869025,83.3116687163284,82.1639713844423,172
-7.6926,53.28823,2021/12/23 00:00:00+00,Thu 23 Dec 2021,924,1393,0,3683122,3629547,240871,3923993,3870418,83.3312911042838,82.1935536208296,173
-7.6926,53.28823,2021/12/24 00:00:00+00,Fri 24 Dec 2021,102,157,0,3683224,3629704,240871,3924095,3870575,83.3334572120452,82.196887727874,174
-7.6926,53.28823,2021/12/25 00:00:00+00,Sat 25 Dec 2021,1,5,0,3683225,3629709,240871,3924096,3870580,83.3334784483958,82.196993909627,175
-7.6926,53.28823,2021/12/26 00:00:00+00,Sun 26 Dec 2021,12,11,0,3683237,3629720,240871,3924108,3870591,83.333733284603,82.1972275094836,176
-7.6926,53.28823,2021/12/27 00:00:00+00,Mon 27 Dec 2021,389,589,0,3683626,3630309,240871,3924497,3871180,83.3419942249868,82.2097357199877,177
-7.6926,53.28823,2021/12/28 00:00:00+00,Tue 28 Dec 2021,465,747,0,3684091,3631056,240871,3924962,3871927,83.3518691280163,82.2255992738867,178
-7.6926,53.28823,2021/12/29 00:00:00+00,Wed 29 Dec 2021,1057,1309,0,3685148,3632365,240871,3926019,3873236,83.3743159506017,82.2533976568236,179
-7.6926,53.28823,2021/12/30 00:00:00+00,Thu 30 Dec 2021,1047,1196,1,3686195,3633561,240872,3927067,3874433,83.3965716460317,82.2788175684931,180
-7.6926,53.28823,2021/12/31 00:00:00+00,Fri 31 Dec 2021,711,1680,0,3686906,3635241,240872,3927778,3876113,83.411670691309,82.3144946375029,181
-7.6926,53.28823,2022/01/01 00:00:00+00,Sat 01 Jan 2022,64,99,0,3686970,3635340,240872,3927842,3876212,83.4130298177475,82.3165970362124,182
-7.6926,53.28823,2022/01/02 00:00:00+00,Sun 02 Jan 2022,270,628,0,3687240,3635968,240872,3928112,3876840,83.4187636324098,82.3299334643899,183
-7.6926,53.28823,2022/01/03 00:00:00+00,Mon 03 Jan 2022,3630,728,1,3690870,3636696,240873,3931743,3877569,83.4958728214424,82.3454147639781,184
-7.6926,53.28823,2022/01/04 00:00:00+00,Tue 04 Jan 2022,1186,781,1,3692056,3637477,240874,3932930,3878351,83.5210803696059,82.3620215901482,185
-7.6926,53.28823,2022/01/05 00:00:00+00,Wed 05 Jan 2022,2140,908,0,3694196,3638385,240874,3935070,3879259,83.5665261598923,82.381304196494,186
-7.6926,53.28823,2022/01/06 00:00:00+00,Thu 06 Jan 2022,2455,1694,1,3696651,3640079,240875,3937526,3880954,83.6186826369686,82.4172998107629,187
-7.6926,53.28823,2022/01/07 00:00:00+00,Fri 07 Jan 2022,4852,784,2,3701503,3640863,240877,3942380,3881740,83.7217638827864,82.4339915823354,188
-7.6926,53.28823,2022/01/08 00:00:00+00,Sat 08 Jan 2022,9789,740,2,3711292,3641603,240879,3952171,3882482,83.9296889915218,82.4497489544814,189
-7.6926,53.28823,2022/01/09 00:00:00+00,Sun 09 Jan 2022,7115,666,0,3718407,3642269,240879,3959286,3883148,84.0807856260487,82.4638923639817,190
-7.6926,53.28823,2022/01/10 00:00:00+00,Mon 10 Jan 2022,6658,508,1,3725065,3642777,240880,3965945,3883657,84.2221984847014,82.4747016664377,191
-7.6926,53.28823,2022/01/11 00:00:00+00,Tue 11 Jan 2022,4780,1366,1,3729845,3644143,240881,3970726,3885024,84.3237294769253,82.5037317577094,192
-7.6926,53.28823,2022/01/12 00:00:00+00,Wed 12 Jan 2022,7559,919,1,3737404,3645062,240882,3978286,3885944,84.4842762874697,82.5232692002624,193
-7.6926,53.28823,2022/01/13 00:00:00+00,Thu 13 Jan 2022,7322,816,0,3744726,3645878,240882,3985608,3886760,84.639768846571,82.5405980623529,194
-7.6926,53.28823,2022/01/14 00:00:00+00,Fri 14 Jan 2022,10721,835,0,3755447,3646713,240882,3996329,3887595,84.8674437613654,82.5583304151048,195
-7.6926,53.28823,2022/01/15 00:00:00+00,Sat 15 Jan 2022,8360,652,2,3763807,3647365,240884,4004691,3888249,85.0450221250919,82.5722189883979,196
-7.6926,53.28823,2022/01/16 00:00:00+00,Sun 16 Jan 2022,6966,1215,1,3770773,3648580,240885,4011658,3889465,85.1929757797298,82.5980423907289,197
-7.6926,53.28823,2022/01/17 00:00:00+00,Mon 17 Jan 2022,2563,560,0,3773336,3649140,240885,4014221,3890025,85.2474045463204,82.6099347470655,198
-7.6926,53.28823,2022/01/18 00:00:00+00,Tue 18 Jan 2022,4056,451,3,3777392,3649591,240888,4018280,3890479,85.3336028934103,82.6195760502384,199
-7.6926,53.28823,2022/01/19 00:00:00+00,Wed 19 Jan 2022,3486,621,0,3780878,3650212,240888,4021766,3891100,85.4076328116058,82.6327638239617,200
-7.6926,53.28823,2022/01/20 00:00:00+00,Thu 20 Jan 2022,3693,933,0,3784571,3651145,240888,4025459,3892033,85.4860586543756,82.6525773390725,201
-7.6926,53.28823,2022/01/21 00:00:00+00,Fri 21 Jan 2022,3250,977,0,3787821,3652122,240888,4028709,3893010,85.5550767938292,82.6733252536098,202
-7.6926,53.28823,2022/01/22 00:00:00+00,Sat 22 Jan 2022,4270,643,0,3792091,3652765,240888,4032979,3893653,85.645756010896,82.6869802270463,203
-7.6926,53.28823,2022/01/23 00:00:00+00,Sun 23 Jan 2022,3092,677,0,3795183,3653442,240888,4036071,3894330,85.7114188069546,82.7013572364033,204
-7.6926,53.28823,2022/01/24 00:00:00+00,Mon 24 Jan 2022,646,463,0,3795829,3653905,240888,4036717,3894793,85.7251374894429,82.7111896667316,205
-7.6926,53.28823,2022/01/25 00:00:00+00,Tue 25 Jan 2022,692,1836,0,3796521,3655741,240888,4037409,3896629,85.7398330440588,82.7501796064352,206
-7.6926,53.28823,2022/01/26 00:00:00+00,Wed 26 Jan 2022,700,897,0,3797221,3656638,240888,4038109,3897526,85.7546984894796,82.7692286129244,207
-7.6926,53.28823,2022/01/27 00:00:00+00,Thu 27 Jan 2022,1274,1177,0,3798495,3657815,240888,4039383,3898703,85.7817536001454,82.7942237975819,208
-7.6926,53.28823,2022/01/28 00:00:00+00,Fri 28 Jan 2022,1027,3094,1,3799522,3660909,240889,4040411,3901798,85.8035845685634,82.8599503026923,209
-7.6926,53.28823,2022/01/29 00:00:00+00,Sat 29 Jan 2022,2328,3444,0,3801850,3664353,240889,4042739,3905242,85.8530227927627,82.9330882941625,210
-7.6926,53.28823,2022/01/30 00:00:00+00,Sun 30 Jan 2022,1638,7537,0,3803488,3671890,240889,4044377,3912779,85.8878079350473,83.0931466686431,211
-7.6926,53.28823,2022/01/31 00:00:00+00,Mon 31 Jan 2022,480,1392,0,3803968,3673282,240889,4044857,3914171,85.8980013833359,83.1227076686798,212
-7.6926,53.28823,2022/02/01 00:00:00+00,Tue 01 Feb 2022,747,3417,1,3804715,3676699,240890,4045605,3917589,85.9138861735855,83.1952935150344,213
-7.6926,53.28823,2022/02/02 00:00:00+00,Wed 02 Feb 2022,650,2996,0,3805365,3679695,240890,4046255,3920585,85.9276898014762,83.2589176214353,214
-7.6926,53.28823,2022/02/03 00:00:00+00,Thu 03 Feb 2022,905,2435,1,3806270,3682130,240891,4047161,3923021,85.9469299351208,83.3106493714996,215
-7.6926,53.28823,2022/02/04 00:00:00+00,Fri 04 Feb 2022,1172,6523,0,3807442,3688653,240891,4048333,3929544,85.9718189380253,83.4491740864706,216
-7.6926,53.28823,2022/02/05 00:00:00+00,Sat 05 Feb 2022,1777,5750,0,3809219,3694403,240891,4050110,3935294,86.0095559330435,83.5712831024269,217
-7.6926,53.28823,2022/02/06 00:00:00+00,Sun 06 Feb 2022,1407,7555,0,3810626,3701958,240891,4051517,3942849,86.0394354783392,83.7317237312183,218
-7.6926,53.28823,2022/02/07 00:00:00+00,Mon 07 Feb 2022,441,1351,0,3811067,3703309,240891,4051958,3944200,86.0488007089543,83.7604140408804,219
-7.6926,53.28823,2022/02/08 00:00:00+00,Tue 08 Feb 2022,901,1237,0,3811968,3704546,240891,4052859,3945437,86.0679346608459,83.786683406574,220
-7.6926,53.28823,2021/04/13 23:00:00+00,Wed 14 Apr 2021,20342,6585,2,828850,354111,240,829090,354351,17.6068459198706,7.52512207185234,221
-7.6926,53.28823,2021/01/02 00:00:00+00,Sat 02 Jan 2021,1016,0,0,4226,18,1,4227,19,0.089766053990873,0.000403490661421005,222
-7.6926,53.28823,2021/07/24 23:00:00+00,Sun 25 Jul 2021,14725,13647,1046,3033261,2482916,205096,3238357,2688012,68.7708846235443,57.0835652519789,223
-7.6926,53.28823,2021/01/03 00:00:00+00,Sun 03 Jan 2021,20,2,1,4246,20,2,4248,22,0.0902120173534963,0.000467199713224322,224
-7.6926,53.28823,2022/05/23 23:00:00+00,Tue 24 May 2022,77,83,0,3847207,3797278,240915,4088122,4038193,86.8167920920927,85.7564823429301,225
-7.6926,53.28823,2021/04/14 23:00:00+00,Thu 15 Apr 2021,27102,10812,1,855952,364923,241,856193,365164,18.1824147302123,7.7547507309021,226
-7.6926,53.28823,2021/07/25 23:00:00+00,Mon 26 Jul 2021,23840,18305,3422,3057101,2501221,208518,3265619,2709739,69.3498300136316,57.5449674414891,227
-7.6926,53.28823,2021/01/04 00:00:00+00,Mon 04 Jan 2021,1190,3,0,5436,23,2,5438,25,0.115483274568812,0.000530908765027638,228
-7.6926,53.28823,2022/05/24 23:00:00+00,Wed 25 May 2022,89,134,1,3847296,3797412,240916,4088212,4038328,86.8187033636468,85.7593492502613,229
-7.6926,53.28823,2021/04/15 23:00:00+00,Fri 16 Apr 2021,27958,9835,1,883910,374758,242,884152,375000,18.7761618566687,7.96363147541457,230
-7.6926,53.28823,2021/07/26 23:00:00+00,Tue 27 Jul 2021,25510,23909,3674,3082611,2525130,212192,3294803,2737322,69.9695916695743,58.1307297001194,231
-7.6926,53.28823,2021/01/05 00:00:00+00,Tue 05 Jan 2021,3532,13,0,8968,36,2,8970,38,0.190490064891917,0.00080698132284201,232
-7.6926,53.28823,2022/05/25 23:00:00+00,Thu 26 May 2022,135,155,0,3847431,3797567,240916,4088347,4038483,86.821570270978,85.7626408846044,233
-7.6926,53.28823,2021/04/16 23:00:00+00,Sat 17 Apr 2021,15850,4556,3,899760,379314,245,900005,379559,19.112821722748,8.06044799780501,234
-7.6926,53.28823,2021/07/27 23:00:00+00,Wed 28 Jul 2021,23440,25289,3264,3106051,2550419,215456,3321507,2765875,70.5366871760262,58.7370912188327,235
-7.6926,53.28823,2021/01/06 00:00:00+00,Wed 06 Jan 2021,6778,13,0,15746,49,2,15748,51,0.33443004926621,0.00108305388065638,236
-7.6926,53.28823,2022/05/26 23:00:00+00,Fri 27 May 2022,98,152,0,3847529,3797719,240916,4088445,4038635,86.8236514333369,85.7658688098958,237
-7.6926,53.28823,2021/04/17 23:00:00+00,Sun 18 Apr 2021,1073,484,0,900833,379798,245,901078,380043,19.135608326943,8.07072639149595,238
-7.6926,53.28823,2021/07/28 23:00:00+00,Thu 29 Jul 2021,19277,27866,2963,3125328,2578285,218419,3343747,2796704,71.0089836133948,59.3917866715142,239
-7.6926,53.28823,2021/01/07 00:00:00+00,Thu 07 Jan 2021,11728,8,0,27474,57,2,27476,59,0.583489969115975,0.00125294468546523,240
-7.6926,53.28823,2022/05/27 23:00:00+00,Sat 28 May 2022,335,578,0,3847864,3798297,240916,4088780,4039213,86.8307656107882,85.7781434205432,241
-7.6926,53.28823,2021/04/18 23:00:00+00,Mon 19 Apr 2021,6748,2259,0,907581,382057,245,907826,382302,19.2789112207992,8.11869930750384,242
-7.6926,53.28823,2021/07/29 23:00:00+00,Fri 30 Jul 2021,21957,22944,2120,3147285,2601229,220539,3367824,2821768,71.5202912268176,59.9240545629803,243
-7.6926,53.28823,2021/01/08 00:00:00+00,Fri 08 Jan 2021,12682,5,0,40156,62,2,40158,64,0.852809367439196,0.00135912643847075,244
-7.6926,53.28823,2022/05/28 23:00:00+00,Sun 29 May 2022,182,349,0,3848046,3798646,240916,4088962,4039562,86.8346306265976,85.785554906903,245
-7.6926,53.28823,2022/05/29 23:00:00+00,Mon 30 May 2022,11,22,0,3848057,3798668,240916,4088973,4039584,86.8348642264542,85.7860221066162,246
-7.6926,53.28823,2022/05/30 23:00:00+00,Tue 31 May 2022,66,79,1,3848123,3798747,240917,4089040,4039664,86.8362870619445,85.7877210146643,247
-7.6926,53.28823,2022/05/31 23:00:00+00,Wed 01 Jun 2022,71,100,0,3848194,3798847,240917,4089111,4039764,86.8377948428372,85.7898446497244,248
-7.6926,53.28823,2022/06/01 23:00:00+00,Thu 02 Jun 2022,120,138,0,3848314,3798985,240917,4089231,4039902,86.8403432049093,85.7927752661074,249
-7.6926,53.28823,2022/06/02 23:00:00+00,Fri 03 Jun 2022,63,144,0,3848377,3799129,240917,4089294,4040046,86.8416810949972,85.795833300594,250
-7.6926,53.28823,2022/06/03 23:00:00+00,Sat 04 Jun 2022,307,606,0,3848684,3799735,240917,4089601,4040652,86.8482006546317,85.8087025290582,251
-7.6926,53.28823,2022/06/04 23:00:00+00,Sun 05 Jun 2022,143,273,0,3848827,3800008,240917,4089744,4040925,86.8512374527677,85.8145000527723,252
-7.6926,53.28823,2022/06/05 23:00:00+00,Mon 06 Jun 2022,3,7,1,3848830,3800015,240918,4089748,4040933,86.8513223981701,85.8146699435771,253
-7.6926,53.28823,2022/06/06 23:00:00+00,Tue 07 Jun 2022,29,50,0,3848859,3800065,240918,4089777,4040983,86.8519382523375,85.8157317611072,254
-7.6926,53.28823,2022/06/07 23:00:00+00,Wed 08 Jun 2022,41,76,0,3848900,3800141,240918,4089818,4041059,86.8528089427122,85.8173457237529,255
-7.6926,53.28823,2022/06/08 23:00:00+00,Thu 09 Jun 2022,83,123,0,3848983,3800264,240918,4089901,4041182,86.8545715598121,85.8199577948768,256
-7.6926,53.28823,2022/06/09 23:00:00+00,Fri 10 Jun 2022,56,108,0,3849039,3800372,240918,4089957,4041290,86.8557607954457,85.8222513207417,257
-7.6926,53.28823,2022/06/10 23:00:00+00,Sat 11 Jun 2022,189,561,0,3849228,3800933,240918,4090146,4041851,86.8597744657094,85.8341649134289,258
-7.6926,53.28823,2022/06/11 23:00:00+00,Sun 12 Jun 2022,143,288,0,3849371,3801221,240918,4090289,4042139,86.8628112638453,85.8402809824021,259
-7.6926,53.28823,2022/06/12 23:00:00+00,Mon 13 Jun 2022,19,44,0,3849390,3801265,240918,4090308,4042183,86.8632147545067,85.8412153818285,260
-7.6926,53.28823,2022/06/13 23:00:00+00,Tue 14 Jun 2022,39,54,0,3849429,3801319,240918,4090347,4042237,86.8640429721802,85.842362144761,261
-7.6926,53.28823,2022/06/14 23:00:00+00,Wed 15 Jun 2022,70,122,0,3849499,3801441,240918,4090417,4042359,86.8655295167222,85.8449529795343,262
-7.6926,53.28823,2022/06/15 23:00:00+00,Thu 16 Jun 2022,81,85,0,3849580,3801526,240918,4090498,4042444,86.8672496611209,85.8467580693354,263
-7.6926,53.28823,2022/06/16 23:00:00+00,Fri 17 Jun 2022,60,94,0,3849640,3801620,240918,4090558,4042538,86.868523842157,85.8487542862919,264
-7.6926,53.28823,2022/06/17 23:00:00+00,Sat 18 Jun 2022,223,487,0,3849863,3802107,240918,4090781,4043025,86.8732595483411,85.8590963890346,265
-7.6926,53.28823,2022/06/18 23:00:00+00,Sun 19 Jun 2022,80,129,0,3849943,3802236,240918,4090861,4043154,86.8749584563891,85.8618358782622,266
-7.6926,53.28823,2022/06/19 23:00:00+00,Mon 20 Jun 2022,9,27,0,3849952,3802263,240918,4090870,4043181,86.8751495835445,85.8624092597284,267
-7.6926,53.28823,2022/06/20 23:00:00+00,Tue 21 Jun 2022,79,168,1,3850031,3802431,240919,4090950,4043350,86.8768484915926,85.86599820298,268
-7.6926,53.28823,2022/06/21 23:00:00+00,Wed 22 Jun 2022,59,94,0,3850090,3802525,240919,4091009,4043444,86.8781014362781,85.8679944199365,269
-7.6926,53.28823,2022/06/22 23:00:00+00,Thu 23 Jun 2022,65,115,0,3850155,3802640,240919,4091074,4043559,86.8794817990672,85.8704366002556,270
-7.6926,53.28823,2022/06/23 23:00:00+00,Fri 24 Jun 2022,56,91,1,3850211,3802731,240920,4091131,4043651,86.8806922710514,85.8723903445109,271
-7.6926,53.28823,2022/06/24 23:00:00+00,Sat 25 Jun 2022,210,292,0,3850421,3803023,240920,4091341,4043943,86.8851519046777,85.8785913588865,272
-7.6926,53.28823,2022/06/25 23:00:00+00,Sun 26 Jun 2022,174,403,0,3850595,3803426,240920,4091515,4044346,86.8888470296823,85.8871496081787,273
-7.6926,53.28823,2022/06/26 23:00:00+00,Mon 27 Jun 2022,4,33,0,3850599,3803459,240920,4091519,4044379,86.8889319750847,85.8878504077485,274
-7.6926,53.28823,2022/06/27 23:00:00+00,Tue 28 Jun 2022,47,60,0,3850646,3803519,240920,4091566,4044439,86.8899300835629,85.8891245887846,275
-7.6926,53.28823,2022/06/28 23:00:00+00,Wed 29 Jun 2022,63,81,3,3850709,3803600,240923,4091632,4044523,86.8913316827026,85.8909084422351,276
-7.6926,53.28823,2022/06/29 23:00:00+00,Thu 30 Jun 2022,73,87,0,3850782,3803687,240923,4091705,4044610,86.8928819362965,85.8927560047374,277
-7.6926,53.28823,2022/06/30 23:00:00+00,Fri 01 Jul 2022,49,62,0,3850831,3803749,240923,4091754,4044672,86.8939225174759,85.8940726584747,278
-7.6926,53.28823,2022/07/01 23:00:00+00,Sat 02 Jul 2022,182,228,0,3851013,3803977,240923,4091936,4044900,86.8977875332853,85.8989145464117,279
-7.6926,53.28823,2022/07/02 23:00:00+00,Sun 03 Jul 2022,108,273,0,3851121,3804250,240923,4092044,4045173,86.9000810591503,85.9047120701258,280
-7.6926,53.28823,2022/07/03 23:00:00+00,Mon 04 Jul 2022,14,14,0,3851135,3804264,240923,4092058,4045187,86.9003783680587,85.9050093790343,281
-7.6926,53.28823,2022/07/04 23:00:00+00,Tue 05 Jul 2022,53,69,0,3851188,3804333,240923,4092111,4045256,86.9015038946405,85.9064746872257,282
-7.6926,53.28823,2022/07/05 23:00:00+00,Wed 06 Jul 2022,63,82,0,3851251,3804415,240923,4092174,4045338,86.9028417847284,85.908216067975,283
-7.6926,53.28823,2022/07/06 23:00:00+00,Thu 07 Jul 2022,79,74,0,3851330,3804489,240923,4092253,4045412,86.9045194564259,85.9097875579195,284
-7.6926,53.28823,2022/07/07 23:00:00+00,Fri 08 Jul 2022,101,88,0,3851431,3804577,240923,4092354,4045500,86.9066643278366,85.9116563567724,285
-7.6926,53.28823,2022/07/08 23:00:00+00,Sat 09 Jul 2022,120,142,0,3851551,3804719,240923,4092474,4045642,86.9092126899087,85.9146719185577,286
-7.6926,53.28823,2022/07/09 23:00:00+00,Sun 10 Jul 2022,131,219,0,3851682,3804938,240923,4092605,4045861,86.9119946518375,85.9193226793394,287
-7.6926,53.28823,2022/07/10 23:00:00+00,Mon 11 Jul 2022,12,15,0,3851694,3804953,240923,4092617,4045876,86.9122494880447,85.9196412245984,288
-7.6926,53.28823,2022/07/11 23:00:00+00,Tue 12 Jul 2022,43,80,0,3851737,3805033,240923,4092660,4045956,86.9131626511205,85.9213401326465,289
-7.6926,53.28823,2022/07/12 23:00:00+00,Wed 13 Jul 2022,99,73,0,3851836,3805106,240923,4092759,4046029,86.91526504983,85.9228903862404,290
-7.6926,53.28823,2022/07/13 23:00:00+00,Thu 14 Jul 2022,70,39,0,3851906,3805145,240923,4092829,4046068,86.9167515943721,85.9237186039138,291
-7.6926,53.28823,2022/07/14 23:00:00+00,Fri 15 Jul 2022,79,116,1,3851985,3805261,240924,4092909,4046185,86.9184505024202,85.9262032569341,292
-7.6926,53.28823,2022/07/15 23:00:00+00,Sat 16 Jul 2022,124,209,0,3852109,3805470,240924,4093033,4046394,86.9210838098947,85.9306416542098,293
-7.6926,53.28823,2022/07/16 23:00:00+00,Sun 17 Jul 2022,119,165,0,3852228,3805635,240924,4093152,4046559,86.9236109356163,85.934145652059,294
-7.6926,53.28823,2022/07/17 23:00:00+00,Mon 18 Jul 2022,13,17,0,3852241,3805652,240924,4093165,4046576,86.9238870081741,85.9345066700192,295
-7.6926,53.28823,2022/07/18 23:00:00+00,Tue 19 Jul 2022,29,33,0,3852270,3805685,240924,4093194,4046609,86.9245028623415,85.935207469589,296
-7.6926,53.28823,2022/07/19 23:00:00+00,Wed 20 Jul 2022,77,66,0,3852347,3805751,240924,4093271,4046675,86.9261380613378,85.9366090687287,297
-7.6926,53.28823,2022/07/20 23:00:00+00,Thu 21 Jul 2022,51,30,0,3852398,3805781,240924,4093322,4046705,86.9272211152185,85.9372461592467,298
-7.6926,53.28823,2022/07/21 23:00:00+00,Fri 22 Jul 2022,72,69,0,3852470,3805850,240924,4093394,4046774,86.9287501324617,85.9387114674382,299
-7.6926,53.28823,2022/07/22 23:00:00+00,Sat 23 Jul 2022,97,175,0,3852567,3806025,240924,4093491,4046949,86.93081005847,85.9424278287934,300
-7.6926,53.28823,2022/07/23 23:00:00+00,Sun 24 Jul 2022,106,232,0,3852673,3806257,240924,4093597,4047181,86.9330611116338,85.9473546621329,301
-7.6926,53.28823,2022/07/24 23:00:00+00,Mon 25 Jul 2022,13,22,0,3852686,3806279,240924,4093610,4047203,86.9333371841916,85.9478218618461,302
-7.6926,53.28823,2022/07/25 23:00:00+00,Tue 26 Jul 2022,18,16,0,3852704,3806295,240924,4093628,4047219,86.9337194385024,85.9481616434557,303
-7.6926,53.28823,2022/07/26 23:00:00+00,Wed 27 Jul 2022,60,72,1,3852764,3806367,240925,4093689,4047292,86.9350148558891,85.9497118970496,304
-7.6926,53.28823,2022/07/27 23:00:00+00,Thu 28 Jul 2022,48,71,0,3852812,3806438,240925,4093737,4047363,86.9360342007179,85.9512196779422,305
-7.6926,53.28823,2022/07/28 23:00:00+00,Fri 29 Jul 2022,69,106,0,3852881,3806544,240925,4093806,4047469,86.9374995089094,85.953470731106,306
-7.6926,53.28823,2022/07/29 23:00:00+00,Sat 30 Jul 2022,99,118,0,3852980,3806662,240925,4093905,4047587,86.9396019076189,85.9559766204769,307
-7.6926,53.28823,2022/07/30 23:00:00+00,Sun 31 Jul 2022,31,57,0,3853011,3806719,240925,4093936,4047644,86.9402602344875,85.9571870924612,308
-7.6926,53.28823,2022/07/31 23:00:00+00,Mon 01 Aug 2022,9,14,0,3853020,3806733,240925,4093945,4047658,86.9404513616429,85.9574844013696,309
-7.6926,53.28823,2022/08/01 23:00:00+00,Tue 02 Aug 2022,35,27,0,3853055,3806760,240925,4093980,4047685,86.941194633914,85.9580577828358,310
-7.6926,53.28823,2022/08/02 23:00:00+00,Wed 03 Aug 2022,93,139,0,3853148,3806899,240925,4094073,4047824,86.9431696145199,85.9610096355694,311
-7.6926,53.28823,2022/08/03 23:00:00+00,Thu 04 Aug 2022,44,51,0,3853192,3806950,240925,4094117,4047875,86.9441040139463,85.96209268945,312
-7.6926,53.28823,2022/08/04 23:00:00+00,Fri 05 Aug 2022,95,90,0,3853287,3807040,240925,4094212,4047965,86.9461214672534,85.9640039610041,313
-7.6926,53.28823,2022/08/05 23:00:00+00,Sat 06 Aug 2022,71,131,0,3853358,3807171,240925,4094283,4048096,86.9476292481461,85.9667859229329,314
-7.6926,53.28823,2022/08/06 23:00:00+00,Sun 07 Aug 2022,28,80,0,3853386,3807251,240925,4094311,4048176,86.9482238659629,85.968484830981,315
-7.6926,53.28823,2022/08/07 23:00:00+00,Mon 08 Aug 2022,11,16,0,3853397,3807267,240925,4094322,4048192,86.9484574658196,85.9688246125906,316
-7.6926,53.28823,2022/08/08 23:00:00+00,Tue 09 Aug 2022,47,39,0,3853444,3807306,240925,4094369,4048231,86.9494555742978,85.969652830264,317
-7.6926,53.28823,2022/08/09 23:00:00+00,Wed 10 Aug 2022,54,94,0,3853498,3807400,240925,4094423,4048325,86.9506023372303,85.9716490472205,318
-7.6926,53.28823,2022/08/10 23:00:00+00,Thu 11 Aug 2022,43,38,0,3853541,3807438,240925,4094466,4048363,86.9515155003061,85.9724560285433,319
-7.6926,53.28823,2022/08/11 23:00:00+00,Fri 12 Aug 2022,70,75,0,3853611,3807513,240925,4094536,4048438,86.9530020448482,85.9740487548384,320
-7.6926,53.28823,2022/08/12 23:00:00+00,Sat 13 Aug 2022,100,151,0,3853711,3807664,240925,4094636,4048589,86.9551256799083,85.9772554437792,321
-7.6926,53.28823,2022/08/13 23:00:00+00,Sun 14 Aug 2022,18,26,0,3853729,3807690,240925,4094654,4048615,86.9555079342191,85.9778075888948,322
-7.6926,53.28823,2022/08/14 23:00:00+00,Mon 15 Aug 2022,12,6,0,3853741,3807696,240925,4094666,4048621,86.9557627704263,85.9779350069984,323
-7.6926,53.28823,2022/08/15 23:00:00+00,Tue 16 Aug 2022,40,27,0,3853781,3807723,240925,4094706,4048648,86.9566122244504,85.9785083884647,324
-7.6926,53.28823,2022/08/16 23:00:00+00,Wed 17 Aug 2022,52,56,0,3853833,3807779,240925,4094758,4048704,86.9577165146816,85.9796976240983,325
-7.6926,53.28823,2022/08/17 23:00:00+00,Thu 18 Aug 2022,82,37,0,3853915,3807816,240925,4094840,4048741,86.9594578954309,85.9804833690706,326
-7.6926,53.28823,2022/08/18 23:00:00+00,Fri 19 Aug 2022,68,57,0,3853983,3807873,240925,4094908,4048798,86.9609019672718,85.9816938410548,327
-7.6926,53.28823,2022/08/19 23:00:00+00,Sat 20 Aug 2022,110,125,0,3854093,3807998,240925,4095018,4048923,86.9632379658379,85.98434838488,328
-7.6926,53.28823,2022/08/20 23:00:00+00,Sun 21 Aug 2022,38,36,0,3854131,3808034,240925,4095056,4048959,86.9640449471608,85.9851128935016,329
-7.6926,53.28823,2022/08/21 23:00:00+00,Mon 22 Aug 2022,9,10,0,3854140,3808044,240925,4095065,4048969,86.9642360743162,85.9853252570076,330
-7.6926,53.28823,2022/08/22 23:00:00+00,Tue 23 Aug 2022,78,71,0,3854218,3808115,240925,4095143,4049040,86.9658925096631,85.9868330379003,331
-7.6926,53.28823,2022/08/23 23:00:00+00,Wed 24 Aug 2022,57,51,0,3854275,3808166,240925,4095200,4049091,86.9671029816473,85.987916091781,332
-7.6926,53.28823,2022/08/24 23:00:00+00,Thu 25 Aug 2022,65,47,0,3854340,3808213,240925,4095265,4049138,86.9684833444364,85.9889142002592,333
-7.6926,53.28823,2022/08/25 23:00:00+00,Fri 26 Aug 2022,90,77,0,3854430,3808290,240925,4095355,4049215,86.9703946159905,85.9905493992555,334
-7.6926,53.28823,2022/08/26 23:00:00+00,Sat 27 Aug 2022,84,118,0,3854514,3808408,240925,4095439,4049333,86.972178469441,85.9930552886264,335
-7.6926,53.28823,2022/08/27 23:00:00+00,Sun 28 Aug 2022,44,19,0,3854558,3808427,240925,4095483,4049352,86.9731128688674,85.9934587792878,336
-7.6926,53.28823,2021/04/19 23:00:00+00,Tue 20 Apr 2021,15089,7320,1,922670,389377,246,922916,389623,19.5993677513699,8.27417063025454,337
-7.6926,53.28823,2021/07/30 23:00:00+00,Sat 31 Jul 2021,13748,12486,907,3161033,2613715,221446,3382479,2835161,71.8315099448768,60.2084730065809,338
-7.6926,53.28823,2021/07/31 23:00:00+00,Sun 01 Aug 2021,11123,9337,368,3172156,2623052,221814,3393970,2844866,72.0755368496341,60.4145717891647,339
-7.6926,53.28823,2021/01/09 00:00:00+00,Sat 09 Jan 2021,8073,7,0,48229,69,2,48231,71,1.02425042584192,0.00150778089267849,340
-7.6926,53.28823,2021/04/20 23:00:00+00,Wed 21 Apr 2021,26727,9888,4,949397,399265,250,949647,399515,20.1670366392881,8.48424061040067,341
-7.6926,53.28823,2021/01/10 00:00:00+00,Sun 10 Jan 2021,4782,4,1,53011,73,3,53014,76,1.12582389076701,0.00161396264568402,342
-7.6926,53.28823,2021/08/01 23:00:00+00,Mon 02 Aug 2021,15024,16025,430,3187180,2639077,222244,3409424,2861321,72.4037234118236,60.7640159383058,343
-7.6926,53.28823,2021/01/11 00:00:00+00,Mon 11 Jan 2021,8343,7,0,61354,80,3,61357,83,1.30299876383203,0.00176261709989176,344
-7.6926,53.28823,2021/04/21 23:00:00+00,Thu 22 Apr 2021,31620,12183,1,981017,411448,251,981268,411699,20.8385512816456,8.74298430612454,345
-7.6926,53.28823,2021/08/02 23:00:00+00,Tue 03 Aug 2021,17348,25452,1111,3204528,2664529,223355,3427883,2887884,72.7957252075694,61.328117119323,346
-7.6926,53.28823,2021/01/12 00:00:00+00,Tue 12 Jan 2021,8886,10,0,70240,90,3,70243,93,1.49170497527346,0.00197498060590281,347
-7.6926,53.28823,2021/04/22 23:00:00+00,Fri 23 Apr 2021,33615,12351,3,1014632,423799,254,1014886,424053,21.5524749161536,9.0053381814506,348
-7.6926,53.28823,2021/08/03 23:00:00+00,Wed 04 Aug 2021,22117,17310,1576,3226645,2681839,224931,3451576,2906770,73.2988780623614,61.7291868367755,349
-7.6926,53.28823,2021/01/13 00:00:00+00,Wed 13 Jan 2021,9888,4,0,80128,94,3,80131,97,1.70169001001719,0.00205992600830724,350
-7.6926,53.28823,2021/04/23 23:00:00+00,Sat 24 Apr 2021,23702,6995,2,1038334,430794,256,1038590,431050,22.0558613708022,9.15392892660653,351
-7.6926,53.28823,2021/08/04 23:00:00+00,Thu 05 Aug 2021,13535,30049,1420,3240180,2711888,226351,3466531,2938239,73.6164676856009,62.3974735538417,352
-7.6926,53.28823,2021/01/14 00:00:00+00,Thu 14 Jan 2021,8084,5,0,88212,99,3,88215,102,1.87336466827652,0.00216610776131276,353
-7.6926,53.28823,2021/04/24 23:00:00+00,Sun 25 Apr 2021,9752,304,2,1048086,431098,258,1048344,431356,22.2630007345654,9.16042724989047,354
-7.6926,53.28823,2021/08/05 23:00:00+00,Fri 06 Aug 2021,12212,24753,948,3252392,2736641,227299,3479691,2963940,73.8959380595115,62.9432690006407,355
-7.6926,53.28823,2021/01/15 00:00:00+00,Fri 15 Jan 2021,7692,2,0,95904,101,3,95907,104,2.03671467710023,0.00220858046251497,356
-7.6926,53.28823,2021/04/25 23:00:00+00,Mon 26 Apr 2021,15594,3055,3,1063680,434153,261,1063941,434414,22.5942240948908,9.22536801002865,357
-7.6926,53.28823,2021/08/06 23:00:00+00,Sat 07 Aug 2021,6337,8463,583,3258729,2745104,227882,3486611,2972986,74.0428936056711,63.1353730281783,358
-7.6926,53.28823,2021/01/16 00:00:00+00,Sat 16 Jan 2021,5240,2,0,101144,103,3,101147,106,2.14799315425002,0.00225105316371719,359
-7.6926,53.28823,2021/04/26 23:00:00+00,Tue 27 Apr 2021,25917,7819,9,1089597,441972,270,1089867,442242,23.1447977205751,9.39160616253411,360
-7.6926,53.28823,2021/08/07 23:00:00+00,Sun 08 Aug 2021,8628,11979,153,3267357,2757083,228035,3495392,2985118,74.2293700002994,63.3930124336709,361
-7.6926,53.28823,2021/01/17 00:00:00+00,Sun 17 Jan 2021,1113,4,0,102257,107,3,102260,110,2.17162921246905,0.00233599856612161,362
-7.6926,53.28823,2021/04/27 23:00:00+00,Wed 28 Apr 2021,26039,8613,5,1115636,450585,275,1115911,450860,23.6978772356303,9.57462103201444,363
-7.6926,53.28823,2021/08/08 23:00:00+00,Mon 09 Aug 2021,5546,23040,600,3272903,2780123,228635,3501538,3008758,74.3598886110938,63.895039761881,364
-7.6926,53.28823,2021/01/18 00:00:00+00,Mon 18 Jan 2021,8717,8,1,110974,115,4,110978,119,2.35676771700949,0.00252712572153156,365
-7.6926,53.28823,2021/04/28 23:00:00+00,Thu 29 Apr 2021,31689,11321,6,1147325,461906,281,1147606,462187,24.3709633679323,9.81516517527316,366
-7.6926,53.28823,2021/08/09 23:00:00+00,Tue 10 Aug 2021,9358,26014,716,3282261,2806137,229351,3511612,3035488,74.5738236070494,64.4626874134486,367
-7.6926,53.28823,2021/01/19 00:00:00+00,Tue 19 Jan 2021,8383,19,0,119357,134,4,119361,138,2.53479204409856,0.00293061638295256,368
-7.6926,53.28823,2021/04/29 23:00:00+00,Fri 30 Apr 2021,36096,13532,8,1183421,475438,289,1183710,475727,25.1376805700346,10.1027053624121,369
-7.6926,53.28823,2021/08/10 23:00:00+00,Wed 11 Aug 2021,7019,31245,666,3289280,2837382,230017,3519297,3067399,74.7370249614189,65.1403605974805,370
-7.6926,53.28823,2021/01/20 00:00:00+00,Wed 20 Jan 2021,8448,962,0,127805,1096,4,127809,1100,2.7141967339767,0.0233599856612161,371
-7.6926,53.28823,2021/04/30 23:00:00+00,Sat 01 May 2021,16588,6693,18,1200009,482131,307,1200316,482438,25.4903314081166,10.2452225112961,372
-7.6926,53.28823,2021/08/11 23:00:00+00,Thu 12 Aug 2021,6779,38300,862,3296059,2875682,230879,3526938,3106561,74.8992919163619,65.972018559721,373
-7.6926,53.28823,2021/01/21 00:00:00+00,Thu 21 Jan 2021,9005,962,0,136810,2058,4,136814,2062,2.90543007113965,0.0437893549394796,374
-7.6926,53.28823,2021/05/01 23:00:00+00,Sun 02 May 2021,12466,911,16,1212475,483042,323,1212798,483365,25.7554035363196,10.2649086083034,375
-7.6926,53.28823,2021/08/12 23:00:00+00,Fri 13 Aug 2021,10933,28251,872,3306992,2903933,231751,3538743,3135684,75.149987035208,66.590484798277,376
-7.6926,53.28823,2021/01/22 00:00:00+00,Fri 22 Jan 2021,6783,967,0,143593,3025,4,143597,3029,3.04947623726695,0.0643249059707486,377
-7.6926,53.28823,2021/05/02 23:00:00+00,Mon 03 May 2021,14267,926,21,1226742,483968,344,1227086,484312,26.0588285137082,10.2850194323226,378
-7.6926,53.28823,2021/08/13 23:00:00+00,Sat 14 Aug 2021,18139,5847,281,3325131,2909780,232032,3557163,3141812,75.5411606132803,66.7206211547605,379
-7.6926,53.28823,2021/01/23 00:00:00+00,Sat 23 Jan 2021,4191,460,0,147784,3485,4,147788,3489,3.13847778263618,0.0740936272472572,380
-7.6926,53.28823,2021/05/03 23:00:00+00,Tue 04 May 2021,26661,6796,10,1253403,490764,354,1253757,491118,26.6252232205903,10.4295540345137,381
-7.6926,53.28823,2021/08/14 23:00:00+00,Sun 15 Aug 2021,17001,3733,51,3342132,2913513,232083,3574215,3145596,75.9032828637304,66.8009795054351,382
-7.6926,53.28823,2021/01/24 00:00:00+00,Sun 24 Jan 2021,1184,398,0,148968,3883,4,148972,3887,3.16362162174789,0.0825456947864972,383
-7.6926,53.28823,2021/05/04 23:00:00+00,Wed 05 May 2021,32117,13459,69,1285520,504223,423,1285943,504646,27.3087364010374,10.7168393854455,384
-7.6926,53.28823,2021/08/15 23:00:00+00,Mon 16 Aug 2021,10193,23156,384,3352325,2936669,232467,3584792,3169136,76.1278997440383,67.3008831985852,385
-7.6926,53.28823,2021/01/25 00:00:00+00,Mon 25 Jan 2021,1363,1289,0,150331,5172,4,150335,5176,3.1925667676172,0.109919350711322,386
-7.6926,53.28823,2021/01/26 00:00:00+00,Tue 26 Jan 2021,1002,3502,0,151333,8674,4,151337,8678,3.21384559091951,0.184289050516394,387
-7.6926,53.28823,2021/01/27 00:00:00+00,Wed 27 Jan 2021,2179,6700,0,153512,15374,4,153516,15378,3.26011959887932,0.326572599543801,388
-7.6926,53.28823,2021/01/28 00:00:00+00,Thu 28 Jan 2021,1013,11541,0,154525,26915,4,154529,26919,3.28163202203824,0.571661321831159,389
-7.6926,53.28823,2021/01/29 00:00:00+00,Fri 29 Jan 2021,1579,11526,0,156104,38441,4,156108,38445,3.31516421963738,0.816431498859502,390
-7.6926,53.28823,2021/01/30 00:00:00+00,Sat 30 Jan 2021,646,7792,0,156750,46233,4,156754,46237,3.32888290212569,0.981905142743316,391
-7.6926,53.28823,2021/01/31 00:00:00+00,Sun 31 Jan 2021,232,4086,0,156982,50319,4,156986,50323,3.33380973546515,1.06867687129943,392
-7.6926,53.28823,2021/02/01 00:00:00+00,Mon 01 Feb 2021,1028,8332,1,158010,58651,5,158015,58656,3.35566194023369,1.24563938085845,393
-7.6926,53.28823,2021/02/02 00:00:00+00,Tue 02 Feb 2021,834,5108,0,158844,63759,5,158849,63764,3.37337305663501,1.35411465972889,394
-7.6926,53.28823,2021/02/03 00:00:00+00,Wed 03 Feb 2021,1405,6868,0,160249,70627,5,160254,70632,3.40321012922956,1.49996591565729,395
-7.6926,53.28823,2021/02/04 00:00:00+00,Thu 04 Feb 2021,1437,10541,1,161686,81168,6,161692,81174,3.43374800139395,1.72383952369414,396
-7.6926,53.28823,2021/02/05 00:00:00+00,Fri 05 Feb 2021,3395,8614,0,165081,89782,6,165087,89788,3.50584541168471,1.90676944777206,397
-7.6926,53.28823,2021/02/06 00:00:00+00,Sat 06 Feb 2021,902,3870,0,165983,93652,6,165989,93658,3.5250005999269,1.98895412459834,398
-7.6926,53.28823,2021/02/07 00:00:00+00,Sun 07 Feb 2021,332,1300,2,166315,94952,8,166323,94960,3.53209354102767,2.01660385308098,399
-7.6926,53.28823,2021/02/08 00:00:00+00,Mon 08 Feb 2021,1187,879,0,167502,95831,8,167510,95839,3.55730108919119,2.03527060525935,400
-7.6926,53.28823,2021/02/09 00:00:00+00,Tue 09 Feb 2021,4263,545,3,171765,96376,11,171776,96387,3.6478953608555,2.04690812538876,401
-7.6926,53.28823,2021/02/10 00:00:00+00,Wed 10 Feb 2021,8827,579,0,180592,96955,11,180603,96966,3.83534862761146,2.0592039723868,402
-7.6926,53.28823,2021/02/11 00:00:00+00,Thu 11 Feb 2021,6189,446,0,186781,97401,11,186792,97412,3.9667804014817,2.06867538475489,403
-7.6926,53.28823,2021/02/12 00:00:00+00,Fri 12 Feb 2021,4397,524,0,191178,97925,11,191189,97936,4.06015663507476,2.07980323246987,404
-7.6926,53.28823,2021/02/13 00:00:00+00,Sat 13 Feb 2021,1211,1915,0,192389,99840,11,192400,99851,4.0858738556527,2.12047084387099,405
-7.6926,53.28823,2021/02/14 00:00:00+00,Sun 14 Feb 2021,2701,27,0,195090,99867,11,195101,99878,4.14323323862629,2.12104422533722,406
-7.6926,53.28823,2021/02/15 00:00:00+00,Mon 15 Feb 2021,1964,7891,0,197054,107758,11,197065,107769,4.18494143120686,2.28862026793054,407
-7.6926,53.28823,2021/02/16 00:00:00+00,Tue 16 Feb 2021,5652,8163,0,202706,115921,11,202717,115932,4.30496928480431,2.46197259788737,408
-7.6926,53.28823,2021/02/17 00:00:00+00,Wed 17 Feb 2021,9747,8465,0,212453,124386,11,212464,124397,4.51195999411328,2.64173830572572,409
-7.6926,53.28823,2021/02/18 00:00:00+00,Thu 18 Feb 2021,8467,8354,1,220920,132740,12,220932,132752,4.69178941100344,2.81916801499796,410
-7.6926,53.28823,2021/02/19 00:00:00+00,Fri 19 Feb 2021,9391,6582,0,230311,139322,12,230323,139334,4.89121997949843,2.95894567465444,411
-7.6926,53.28823,2021/02/20 00:00:00+00,Sat 20 Feb 2021,5890,3573,2,236201,142895,14,236215,142909,5.01634455724014,3.03486562805339,412
-7.6926,53.28823,2021/02/21 00:00:00+00,Sun 21 Feb 2021,1112,1024,6,237313,143919,20,237333,143939,5.04008679721218,3.05673906917253,413
-7.6926,53.28823,2021/02/22 00:00:00+00,Mon 22 Feb 2021,3946,1123,1,241259,145042,21,241280,145063,5.12390667303474,3.08060872724817,414
-7.6926,53.28823,2021/02/23 00:00:00+00,Tue 23 Feb 2021,13362,1068,1,254621,146110,22,254643,146132,5.40768802611731,3.10331038604075,415
-7.6926,53.28823,2021/02/24 00:00:00+00,Wed 24 Feb 2021,16940,2106,3,271561,148216,25,271586,148241,5.76749551435184,3.14809784945848,416
-7.6926,53.28823,2021/02/25 00:00:00+00,Thu 25 Feb 2021,18097,1758,2,289658,149974,27,289685,150001,6.15185222388125,3.18547382651643,417
-7.6926,53.28823,2021/02/26 00:00:00+00,Fri 26 Feb 2021,16080,2769,0,305738,152743,27,305765,152770,6.49333274154703,3.24427728133089,418
-7.6926,53.28823,2021/02/27 00:00:00+00,Sat 27 Feb 2021,8996,705,1,314734,153448,28,314762,153476,6.68439618790518,3.25927014485527,419
-7.6926,53.28823,2021/02/28 00:00:00+00,Sun 28 Feb 2021,2446,57,2,317180,153505,30,317210,153535,6.73638277417668,3.26052308954074,420
-7.6926,53.28823,2021/03/01 00:00:00+00,Mon 01 Mar 2021,5605,796,0,322785,154301,30,322815,154331,6.85541251929588,3.27742722461922,421
-7.6926,53.28823,2021/03/02 00:00:00+00,Tue 02 Mar 2021,12180,1611,0,334965,155912,30,334995,155942,7.11407126961734,3.3116389854376,422
-7.6926,53.28823,2021/03/03 00:00:00+00,Wed 03 Mar 2021,12899,1504,1,347864,157416,31,347895,157447,7.38802019237161,3.34359969309226,423
-7.6926,53.28823,2021/03/04 00:00:00+00,Thu 04 Mar 2021,18725,1691,5,366589,159107,36,366625,159143,7.78577703913031,3.37961654371174,424
-7.6926,53.28823,2021/03/05 00:00:00+00,Fri 05 Mar 2021,18449,2400,6,385038,161507,42,385080,161549,8.17769388947371,3.430711203258,425
-7.6926,53.28823,2021/03/06 00:00:00+00,Sat 06 Mar 2021,10404,141,4,395442,161648,46,395488,161694,8.39872182653002,3.43379047409516,426
-7.6926,53.28823,2021/03/07 00:00:00+00,Sun 07 Mar 2021,1523,12,3,396965,161660,49,397014,161709,8.43112849754731,3.43410901935417,427
-7.6926,53.28823,2021/03/08 00:00:00+00,Mon 08 Mar 2021,6669,1498,5,403634,163158,54,403688,163212,8.57285990145909,3.46602725430763,428
-7.6926,53.28823,2021/03/09 00:00:00+00,Tue 09 Mar 2021,13834,3106,6,417468,166264,60,417528,166324,8.86677099377839,3.53211477737828,429
-7.6926,53.28823,2021/03/10 00:00:00+00,Wed 10 Mar 2021,13740,3990,3,431208,170254,63,431271,170317,9.15862216008938,3.61691152532849,430
-7.6926,53.28823,2021/03/11 00:00:00+00,Thu 11 Mar 2021,18485,2102,3,449693,172356,66,449759,172422,9.55123981000262,3.66161404334382,431
-7.6926,53.28823,2021/03/12 00:00:00+00,Fri 12 Mar 2021,17332,1340,4,467025,173696,70,467095,173766,9.91939318402338,3.6901556985517,432
-7.6926,53.28823,2021/03/13 00:00:00+00,Sat 13 Mar 2021,8312,176,0,475337,173872,70,475407,173942,10.0959097302198,3.6938932962575,433
-7.6926,53.28823,2021/03/14 00:00:00+00,Sun 14 Mar 2021,383,20,2,475720,173892,72,475792,173964,10.1040857252012,3.69436049597072,434
-7.6926,53.28823,2021/03/15 00:00:00+00,Mon 15 Mar 2021,2658,992,0,478378,174884,72,478450,174956,10.1605319450989,3.71542695576702,435
-7.6926,53.28823,2021/03/16 00:00:00+00,Tue 16 Mar 2021,8948,3823,2,487326,178707,74,487400,178781,10.3505972829788,3.79665599681625,436
-7.6926,53.28823,2021/03/17 00:00:00+00,Wed 17 Mar 2021,4881,2415,7,492207,181122,81,492288,181203,10.454400564717,3.84809043797212,437
-7.6926,53.28823,2021/03/18 00:00:00+00,Thu 18 Mar 2021,11719,4683,5,503926,185805,86,504012,185891,10.7033755391644,3.94764644959011,438
-7.6926,53.28823,2021/03/19 00:00:00+00,Fri 19 Mar 2021,10374,6133,2,514300,191938,88,514388,192026,10.9237239130015,4.07793146052789,439
-7.6926,53.28823,2021/03/20 00:00:00+00,Sat 20 Mar 2021,5247,3118,4,519547,195056,92,519639,195148,11.0352359900079,4.14423134710454,440
-7.6926,53.28823,2021/03/21 00:00:00+00,Sun 21 Mar 2021,3641,54,3,523188,195110,95,523283,195205,11.1126212515983,4.1454418190888,441
-7.6926,53.28823,2021/03/22 00:00:00+00,Mon 22 Mar 2021,7415,2409,1,530603,197519,96,530699,197615,11.2701100276561,4.19662142403747,442
-7.6926,53.28823,2021/03/23 00:00:00+00,Tue 23 Mar 2021,12567,7392,4,543170,204911,100,543270,205011,11.5370721910626,4.35368547308324,443
-7.6926,53.28823,2021/03/24 00:00:00+00,Wed 24 Mar 2021,13630,9781,2,556800,214692,102,556902,214794,11.8265661224569,4.56144069101386,444
-7.6926,53.28823,2021/03/25 00:00:00+00,Thu 25 Mar 2021,20876,10224,3,577676,224916,105,577781,225021,12.2699598866574,4.77862484861137,445
-7.6926,53.28823,2021/03/26 00:00:00+00,Fri 26 Mar 2021,19700,9497,1,597376,234413,106,597482,234519,12.6883372298497,4.98032770662067,446
-7.6926,53.28823,2021/03/27 00:00:00+00,Sat 27 Mar 2021,11761,5356,3,609137,239769,109,609246,239878,12.9381616583211,5.09413330949199,447
-7.6926,53.28823,2021/03/28 00:00:00+00,Sun 28 Mar 2021,2492,484,0,611629,240253,109,611738,240362,12.9910826440191,5.10441170318293,448
-7.6926,53.28823,2021/03/28 23:00:00+00,Mon 29 Mar 2021,9279,3122,3,620908,243375,112,621020,243487,13.1881984502986,5.17077529881138,449
-7.6926,53.28823,2021/03/29 23:00:00+00,Tue 30 Mar 2021,13331,8670,4,634239,252045,116,634355,252161,13.4713851855643,5.35497940392537,450
-7.6926,53.28823,2021/03/30 23:00:00+00,Wed 31 Mar 2021,15836,10503,4,650075,262548,120,650195,262668,13.8077689790858,5.57810973969119,451
-7.6926,53.28823,2021/03/31 23:00:00+00,Thu 01 Apr 2021,19694,11571,8,669769,274119,128,669897,274247,14.2261675586288,5.82400544330139,452
-7.6926,53.28823,2021/04/01 23:00:00+00,Fri 02 Apr 2021,20147,13722,9,689916,287841,137,690053,287978,14.6542074413447,6.11560177340517,453
-7.6926,53.28823,2021/04/02 23:00:00+00,Sat 03 Apr 2021,7548,4635,6,697464,292476,143,697607,292619,14.8146268337854,6.2141596765449,454
-7.6926,53.28823,2021/04/03 23:00:00+00,Sun 04 Apr 2021,3039,170,3,700503,292646,146,700649,292792,14.879227812314,6.21783356519889,455
-7.6926,53.28823,2021/04/04 23:00:00+00,Mon 05 Apr 2021,3435,607,4,703938,293253,150,704088,293403,14.9522596220312,6.23080897541616,456
-7.6926,53.28823,2021/04/05 23:00:00+00,Tue 06 Apr 2021,11997,8149,11,715935,301402,161,716096,301563,15.2072657200493,6.40409759632118,457
-7.6926,53.28823,2021/04/06 23:00:00+00,Wed 07 Apr 2021,18370,10472,11,734305,311874,172,734477,312046,15.5976110804482,6.62671825967257,458
-7.6926,53.28823,2021/04/07 23:00:00+00,Thu 08 Apr 2021,20185,10566,16,754490,322440,188,754678,322628,16.0266065989411,6.85144132173347,459
-7.6926,53.28823,2021/08/16 23:00:00+00,Tue 17 Aug 2021,12873,26866,528,3365198,2963535,232995,3598193,3196530,76.4124880784437,67.8826317869518,460
-7.6926,53.28823,2021/08/17 23:00:00+00,Wed 18 Aug 2021,15237,25768,658,3380435,2989303,233653,3614088,3222956,76.7500398712482,68.4438235879366,461
-7.6926,53.28823,2021/05/05 23:00:00+00,Thu 06 May 2021,37295,14374,132,1322815,518597,555,1323370,519152,28.103549294985,11.0248938872651,462
-7.6926,53.28823,2021/08/18 23:00:00+00,Thu 19 Aug 2021,11362,25715,544,3391797,3015018,234197,3625994,3249215,77.002879861505,69.0014689183711,463
-7.6926,53.28823,2021/08/19 23:00:00+00,Fri 20 Aug 2021,14853,22253,686,3406650,3037271,234883,3641533,3272154,77.3328715134956,69.4886095648098,464
-7.6926,53.28823,2021/05/06 23:00:00+00,Fri 07 May 2021,40594,15076,97,1363409,533673,652,1364061,534325,28.9676776372946,11.3471130349357,465
-7.6926,53.28823,2021/08/20 23:00:00+00,Sat 21 Aug 2021,11895,7981,246,3418545,3045252,235129,3653674,3280381,77.5907020461436,69.6633210212051,466
-7.6926,53.28823,2021/05/07 23:00:00+00,Sat 08 May 2021,25626,7054,10,1389035,540727,662,1389697,541389,29.5120927213045,11.4971266155819,467
-7.6926,53.28823,2021/08/21 23:00:00+00,Sun 22 Aug 2021,8004,12254,161,3426549,3057506,235290,3661839,3292796,77.7640968488016,69.9269703139179,468
-7.6926,53.28823,2021/05/08 23:00:00+00,Sun 09 May 2021,19674,926,5,1408709,541653,667,1409376,542320,29.9300028647837,11.5168976579915,469
-7.6926,53.28823,2021/08/22 23:00:00+00,Mon 23 Aug 2021,10870,15387,291,3437419,3072893,235581,3673000,3308474,78.0011157578606,70.259913818642,470
-7.6926,53.28823,2021/05/09 23:00:00+00,Mon 10 May 2021,28844,4650,171,1437553,546303,838,1438391,547141,30.5461755774748,11.6192781042395,471
-7.6926,53.28823,2021/08/23 23:00:00+00,Tue 24 Aug 2021,9717,22926,384,3447136,3095819,235965,3683101,3331784,78.2156241352823,70.7549331511538,472
-7.6926,53.28823,2021/05/10 23:00:00+00,Tue 11 May 2021,33928,14808,153,1471481,561111,991,1472472,562102,31.2699316423111,11.9369951455826,473
-7.6926,53.28823,2021/08/24 23:00:00+00,Wed 25 Aug 2021,9418,19531,316,3456554,3115350,236281,3692835,3351631,78.4223387720335,71.1764110015339,474
-7.6926,53.28823,2021/05/11 23:00:00+00,Wed 12 May 2021,31293,20920,173,1502774,582031,1164,1503938,583195,31.9381546503254,12.3849334888117,475
-7.6926,53.28823,2021/08/25 23:00:00+00,Thu 26 Aug 2021,8586,19444,369,3465140,3134794,236650,3701790,3371444,78.6125102916664,71.5971668159936,476
-7.6926,53.28823,2021/05/12 23:00:00+00,Thu 13 May 2021,36003,25468,152,1538777,607499,1316,1540093,608815,32.7059549063084,12.9290087912121,477
-7.6926,53.28823,2021/08/26 23:00:00+00,Fri 27 Aug 2021,9726,19215,432,3474866,3154009,237082,3711948,3391091,78.8282291410724,72.0143973962535,478
-7.6926,53.28823,2021/05/13 23:00:00+00,Fri 14 May 2021,38221,27945,236,1576998,635444,1552,1578550,636996,33.5226412413751,13.5274703875018,479
-7.6926,53.28823,2021/08/27 23:00:00+00,Sat 28 Aug 2021,9923,7927,153,3484789,3161936,237235,3722024,3399171,79.0422066097292,72.1859871091105,480
-7.6926,53.28823,2021/05/14 23:00:00+00,Sat 15 May 2021,28861,12455,22,1605859,647899,1574,1607433,649473,34.1360107557868,13.7924363339518,481
-7.6926,53.28823,2021/05/15 23:00:00+00,Sun 16 May 2021,23182,1175,10,1629041,649074,1584,1630625,650658,34.6285241989277,13.8176014094141,482
-7.6926,53.28823,2021/05/16 23:00:00+00,Mon 17 May 2021,35389,3953,118,1664430,653027,1702,1666132,654729,35.3825632997211,13.9040545927112,483
-7.6926,53.28823,2021/05/17 23:00:00+00,Tue 18 May 2021,39013,12501,128,1703443,665528,1830,1705273,667358,36.213775298599,14.1722484644526,484
-7.6926,53.28823,2021/05/18 23:00:00+00,Wed 19 May 2021,37026,17590,211,1740469,683118,2041,1742510,685159,37.0045532859324,14.5502767415029,485
-7.6926,53.28823,2021/05/19 23:00:00+00,Thu 20 May 2021,39090,19643,136,1779559,702761,2177,1781736,704938,37.8375703746113,14.9703105200421,486
-7.6926,53.28823,2021/05/20 23:00:00+00,Fri 21 May 2021,25837,23246,14934,1805396,726007,17111,1822507,743118,38.703397624969,15.7811143859923,487
-7.6926,53.28823,2021/05/21 23:00:00+00,Sat 22 May 2021,16588,10248,13523,1821984,736255,30634,1852618,766889,39.3428453779189,16.2859236761312,488
-7.6926,53.28823,2021/05/22 23:00:00+00,Sun 23 May 2021,8219,5527,10205,1830203,741782,40839,1871042,782621,39.7341039013937,16.6200139437878,489
-7.6926,53.28823,2021/05/23 23:00:00+00,Mon 24 May 2021,22551,8217,8450,1852754,749999,49289,1902043,799288,40.3924520063785,16.9739601992564,490
-7.6926,53.28823,2021/05/24 23:00:00+00,Tue 25 May 2021,30345,16503,3224,1883099,766502,52513,1935612,819015,41.1053350597071,17.3928896875644,491
-7.6926,53.28823,2021/05/25 23:00:00+00,Wed 26 May 2021,19981,25453,3054,1903080,791955,55567,1958647,847522,41.5945143958035,17.9982743341502,492
-7.6926,53.28823,2021/05/26 23:00:00+00,Thu 27 May 2021,17016,36040,550,1920096,827995,56117,1976213,884112,41.9675521304626,18.7753124026446,493
-7.6926,53.28823,2021/05/27 23:00:00+00,Fri 28 May 2021,27044,31827,1559,1947140,859822,57676,2004816,917498,42.574975466706,19.4843092038131,494
-7.6926,53.28823,2021/05/28 23:00:00+00,Sat 29 May 2021,24482,7386,534,1971622,867208,58210,2029832,925418,43.1062240133432,19.6525011005739,495
-7.6926,53.28823,2021/05/29 23:00:00+00,Sun 30 May 2021,24253,1679,209,1995875,868887,58419,2054294,927306,43.6257076217475,19.6925953305088,496
-7.6926,53.28823,2021/05/30 23:00:00+00,Mon 31 May 2021,22588,7306,3443,2018463,876193,61862,2080325,938055,44.1785110642448,19.92086486312,497
-7.6926,53.28823,2021/05/31 23:00:00+00,Tue 01 Jun 2021,27581,11515,3653,2046044,887708,65515,2111559,953223,44.8418072389198,20.2429778290376,498
-7.6926,53.28823,2021/06/01 23:00:00+00,Wed 02 Jun 2021,18701,20904,4008,2064745,908612,69523,2134268,978135,45.3240635247203,20.7720177952123,499
-7.6926,53.28823,2021/06/02 23:00:00+00,Thu 03 Jun 2021,16695,30701,1977,2081440,939313,71500,2152940,1010813,45.7205886631441,21.4659792601553,500
-7.6926,53.28823,2021/06/03 23:00:00+00,Fri 04 Jun 2021,28985,23339,153,2110425,962652,71653,2182078,1034305,46.3393734469591,21.9648636084764,501
-7.6926,53.28823,2021/06/04 23:00:00+00,Sat 05 Jun 2021,20967,11493,33,2131392,974145,71686,2203078,1045831,46.7853368095824,22.2096337855048,502
-7.6926,53.28823,2021/06/05 23:00:00+00,Sun 06 Jun 2021,19947,3913,47,2151339,978058,71733,2223072,1049791,47.2099364035009,22.2937297338852,503
-7.6926,53.28823,2021/06/06 23:00:00+00,Mon 07 Jun 2021,19823,4593,45,2171162,982651,71778,2242940,1054429,47.6318602172436,22.3922239279731,504
-7.6926,53.28823,2021/06/07 23:00:00+00,Tue 08 Jun 2021,26413,18345,45,2197575,1000996,71823,2269398,1072819,48.1937315814477,22.7827604155274,505
-7.6926,53.28823,2021/06/08 23:00:00+00,Wed 09 Jun 2021,32806,20115,174,2230381,1021111,71997,2302378,1093108,48.8941064242721,23.2136247328733,506
-7.6926,53.28823,2021/06/09 23:00:00+00,Thu 10 Jun 2021,27701,27492,273,2258082,1048603,72270,2330352,1120873,49.4881720959875,23.8032520073129,507
-7.6926,53.28823,2021/06/10 23:00:00+00,Fri 11 Jun 2021,26443,32904,40,2284525,1081507,72310,2356835,1153817,50.0505743689565,24.5028623415158,508
-7.6926,53.28823,2021/06/11 23:00:00+00,Sat 12 Jun 2021,12213,19721,105,2296738,1101228,72415,2369153,1173643,50.312163735661,24.9238942285333,509
-7.6926,53.28823,2021/06/12 23:00:00+00,Sun 13 Jun 2021,8551,18174,834,2305289,1119402,73249,2378538,1192651,50.5114668860523,25.3275547807591,510
-7.6926,53.28823,2021/06/13 23:00:00+00,Mon 14 Jun 2021,16021,31306,52,2321310,1150708,73301,2394611,1224009,50.8527987492639,25.9934842629086,511
-7.6926,53.28823,2021/06/14 23:00:00+00,Tue 15 Jun 2021,14703,41591,205,2336013,1192299,73506,2409519,1265805,51.1693902640252,26.8810787726324,512
-7.6926,53.28823,2021/06/15 23:00:00+00,Wed 16 Jun 2021,13473,48391,217,2349486,1240690,73723,2423209,1314413,51.4601159037543,27.9133353026509,513
-7.6926,53.28823,2021/06/16 23:00:00+00,Thu 17 Jun 2021,21571,42690,535,2371057,1283380,74258,2445315,1357638,51.9295666701423,28.8312765573837,514
-7.6926,53.28823,2021/06/17 23:00:00+00,Fri 18 Jun 2021,12019,50021,554,2383076,1333401,74812,2457888,1408213,52.19657130625,29.9053049890346,515
-7.6926,53.28823,2021/06/18 23:00:00+00,Sat 19 Jun 2021,6322,32808,433,2389398,1366209,75245,2464643,1441454,52.3400228545605,30.611222519366,516
-7.6926,53.28823,2021/06/19 23:00:00+00,Sun 20 Jun 2021,8518,26142,177,2397916,1392351,75422,2473338,1467773,52.5246729230371,31.1701420308365,517
-7.6926,53.28823,2021/06/20 23:00:00+00,Mon 21 Jun 2021,15484,32337,574,2413400,1424688,75996,2489396,1500684,52.8656862409897,31.8690515654694,518
-7.6926,53.28823,2021/06/21 23:00:00+00,Tue 22 Jun 2021,15149,43544,722,2428549,1468232,76718,2505267,1544950,53.2027283613798,32.809099861178,519
-7.6926,53.28823,2021/06/22 23:00:00+00,Wed 23 Jun 2021,20091,39392,883,2448640,1507624,77601,2526241,1585225,53.6481395788874,33.6643938816375,520
-7.6926,53.28823,2021/06/23 23:00:00+00,Thu 24 Jun 2021,19022,44275,1032,2467662,1551899,78633,2546295,1630532,54.074013353842,34.6265492183218,521
-7.6926,53.28823,2021/06/24 23:00:00+00,Fri 25 Jun 2021,15211,50124,843,2482873,1602023,79476,2562349,1681499,54.4149417263921,35.7089022994083,522
-7.6926,53.28823,2021/06/25 23:00:00+00,Sat 26 Jun 2021,9066,30562,511,2491939,1632585,79987,2571926,1712572,54.6183222560989,36.3687794216365,523
-7.6926,53.28823,2021/06/26 23:00:00+00,Sun 27 Jun 2021,8736,30478,59,2500675,1663063,80046,2580721,1743109,54.8050959596356,37.0172738599424,524
-7.6926,53.28823,2021/06/27 23:00:00+00,Mon 28 Jun 2021,24236,24650,524,2524911,1687713,80570,2605481,1768283,55.330908000519,37.5518777499747,525
-7.6926,53.28823,2021/06/28 23:00:00+00,Tue 29 Jun 2021,28145,31044,811,2553056,1718757,81381,2634437,1800138,55.9458277685246,38.2283616983729,526
-7.6926,53.28823,2021/06/29 23:00:00+00,Wed 30 Jun 2021,22577,36870,590,2575633,1755627,81971,2657604,1837598,56.4378103029004,39.0238753918903,527
-7.6926,53.28823,2021/06/30 23:00:00+00,Thu 01 Jul 2021,15030,48306,640,2590663,1803933,82611,2673274,1886544,56.7705839168198,40.063309808412,528
-7.6926,53.28823,2021/07/01 23:00:00+00,Fri 02 Jul 2021,13687,47269,818,2604350,1851202,83429,2687779,1934631,57.0786171822888,41.0845021997674,529
-7.6926,53.28823,2021/07/02 23:00:00+00,Sat 03 Jul 2021,9317,30479,505,2613667,1881681,83934,2697601,1965615,57.2872006178929,41.742489286792,530
-7.6926,53.28823,2021/07/03 23:00:00+00,Sun 04 Jul 2021,6454,27784,233,2620121,1909465,84167,2704288,1993632,57.4292080943625,42.3374681215832,531
-7.6926,53.28823,2021/07/04 23:00:00+00,Mon 05 Jul 2021,15618,33464,5343,2635739,1942929,89510,2725249,2032439,57.8743432393122,43.1615871793603,532
-7.6926,53.28823,2021/07/05 23:00:00+00,Tue 06 Jul 2021,12412,48300,5487,2648151,1991229,94997,2743148,2086226,58.2544526787214,44.303826769142,533
-7.6926,53.28823,2021/07/06 23:00:00+00,Wed 07 Jul 2021,19707,43760,5059,2667858,2034989,100056,2767914,2135045,58.7803921377084,45.3405641691373,534
-7.6926,53.28823,2021/07/07 23:00:00+00,Thu 08 Jul 2021,17784,45595,5998,2685642,2080584,106054,2791696,2186638,59.2854350277039,46.4362112057002,535
-7.6926,53.28823,2021/07/08 23:00:00+00,Fri 09 Jul 2021,13530,45090,6531,2699172,2125674,112585,2811757,2238259,59.7114574571127,47.5324528600798,536
-7.6926,53.28823,2021/07/09 23:00:00+00,Sat 10 Jul 2021,8639,23872,4364,2707811,2149546,116949,2824760,2266495,59.9875937239788,48.1320824556527,537
-7.6926,53.28823,2021/07/10 23:00:00+00,Sun 11 Jul 2021,15238,16112,2153,2723049,2165658,119102,2842151,2284760,60.3569150972827,48.5199643993819,538
-7.6926,53.28823,2021/07/11 23:00:00+00,Mon 12 Jul 2021,17110,31771,6092,2740159,2197429,125194,2865353,2322623,60.8496409039295,49.3240363421915,539
-7.6926,53.28823,2021/07/12 23:00:00+00,Tue 13 Jul 2021,20109,36568,8491,2760268,2233997,133685,2893953,2367682,61.4570005311211,50.2809250639267,540
-7.6926,53.28823,2021/07/13 23:00:00+00,Wed 14 Jul 2021,20801,35712,9335,2781069,2269709,143020,2924089,2412729,62.096979192836,51.2375589494547,541
-7.6926,53.28823,2021/07/14 23:00:00+00,Thu 15 Jul 2021,23648,28832,9586,2804717,2298541,152606,2957323,2451147,62.8027480687132,52.053417066848,542
-7.6926,53.28823,2021/07/15 23:00:00+00,Fri 16 Jul 2021,23528,27431,9167,2828245,2325972,161773,2990018,2487745,63.4970705516163,52.8306250261473,543
-7.6926,53.28823,2021/07/16 23:00:00+00,Sat 17 Jul 2021,11510,19430,4677,2839755,2345402,166450,3006205,2511852,63.8408233587964,53.3425697300881,544
-7.6926,53.28823,2021/07/17 23:00:00+00,Sun 18 Jul 2021,16866,15818,1932,2856621,2361220,168382,3025003,2529602,64.240024277396,53.7195149532577,545
-7.6926,53.28823,2021/07/18 23:00:00+00,Mon 19 Jul 2021,24892,18441,6255,2881513,2379661,174637,3056150,2554298,64.9014728895687,54.2439678677026,546
-7.6926,53.28823,2021/08/28 23:00:00+00,Sun 29 Aug 2021,8800,9191,30,3493589,3171127,237265,3730854,3408392,79.2297235855369,72.3818074980032,547
-7.6926,53.28823,2021/08/29 23:00:00+00,Mon 30 Aug 2021,5065,11138,84,3498654,3182265,237349,3736003,3419614,79.339069554782,72.6201218244489,548
-7.6926,53.28823,2021/08/30 23:00:00+00,Tue 31 Aug 2021,4067,12898,145,3502721,3195163,237494,3740215,3432657,79.4285170635139,72.8971075453391,549
-7.6926,53.28823,2021/08/31 23:00:00+00,Wed 01 Sep 2021,4965,12542,181,3507686,3207705,237675,3745361,3445380,79.5377993237072,73.1672976340369,550
-7.6926,53.28823,2021/09/01 23:00:00+00,Thu 02 Sep 2021,5011,12364,248,3512697,3220069,237923,3750620,3457992,79.6494812915184,73.4351304878181,551
-7.6926,53.28823,2021/09/02 23:00:00+00,Fri 03 Sep 2021,4775,16076,166,3517472,3236145,238089,3755561,3474234,79.7544100998385,73.7800512942813,552
-7.6926,53.28823,2021/09/03 23:00:00+00,Sat 04 Sep 2021,4628,10584,135,3522100,3246729,238224,3760324,3484953,79.8555588377515,74.0076837363745,553
-7.6926,53.28823,2021/09/04 23:00:00+00,Sun 05 Sep 2021,5309,11905,1,3527409,3258634,238225,3765634,3496859,79.9683238594434,74.2605237266312,554
-7.6926,53.28823,2021/09/05 23:00:00+00,Mon 06 Sep 2021,2163,9683,75,3529572,3268317,238300,3767872,3506617,80.0158508120887,74.4677480357968,555
-7.6926,53.28823,2021/09/06 23:00:00+00,Tue 07 Sep 2021,3031,10025,160,3532603,3278342,238460,3771063,3516802,80.0836160068568,74.6840402666691,556
-7.6926,53.28823,2021/09/07 23:00:00+00,Wed 08 Sep 2021,2611,14800,190,3535214,3293142,238650,3773864,3531792,80.1430990248905,75.0023731621797,557
-7.6926,53.28823,2021/09/08 23:00:00+00,Thu 09 Sep 2021,3117,14812,138,3538331,3307954,238788,3777119,3546742,80.2122233460971,75.3198566036662,558
-7.6926,53.28823,2021/09/09 23:00:00+00,Fri 10 Sep 2021,3386,13945,116,3541717,3321899,238904,3780621,3560803,80.2865930459022,75.6184609294683,559
-7.6926,53.28823,2021/09/10 23:00:00+00,Sat 11 Sep 2021,2560,11340,62,3544277,3333239,238966,3783243,3572205,80.3422747571783,75.8605977990222,560
-7.6926,53.28823,2021/09/11 23:00:00+00,Sun 12 Sep 2021,2043,12883,1,3546320,3346122,238967,3785287,3585089,80.3856818578069,76.1342069401668,561
-7.6926,53.28823,2021/09/12 23:00:00+00,Mon 13 Sep 2021,1618,7744,52,3547938,3353866,239019,3786957,3592885,80.4211465633108,76.299765529453,562
-7.6926,53.28823,2021/09/13 23:00:00+00,Tue 14 Sep 2021,1548,10786,82,3549486,3364652,239101,3788587,3603753,80.4557618147906,76.5305621877858,563
-7.6926,53.28823,2021/09/14 23:00:00+00,Wed 15 Sep 2021,3283,12368,137,3552769,3377020,239238,3792007,3616258,80.5283901338463,76.7961227520527,564
-7.6926,53.28823,2021/09/15 23:00:00+00,Thu 16 Sep 2021,1915,10576,115,3554684,3387596,239353,3794037,3626949,80.5714999255666,77.0231605763291,565
-7.6926,53.28823,2021/09/16 23:00:00+00,Fri 17 Sep 2021,2563,14615,94,3557247,3402211,239447,3796694,3641658,80.6279249091137,77.3355260573207,566
-7.6926,53.28823,2021/09/17 23:00:00+00,Sat 18 Sep 2021,2289,11233,47,3559536,3413444,239494,3799030,3652938,80.6775330241179,77.5750720921012,567
-7.6926,53.28823,2021/09/18 23:00:00+00,Sun 19 Sep 2021,1862,8491,16,3561398,3421935,239510,3800908,3661445,80.7174148905468,77.7557297266648,568
-7.6926,53.28823,2021/09/19 23:00:00+00,Mon 20 Sep 2021,957,5627,35,3562355,3427562,239545,3801900,3667107,80.7384813503431,77.8759699437683,569
-7.6926,53.28823,2021/09/20 23:00:00+00,Tue 21 Sep 2021,1469,6673,90,3563824,3434235,239635,3803459,3673870,80.7715888209302,78.0195913828835,570
-7.6926,53.28823,2021/09/21 23:00:00+00,Wed 22 Sep 2021,1896,8153,97,3565720,3442388,239732,3805452,3682120,80.8139128676782,78.1947912753427,571
-7.6926,53.28823,2021/09/22 23:00:00+00,Thu 23 Sep 2021,1699,8728,89,3567419,3451116,239821,3807240,3690937,80.851883462553,78.3820321785926,572
-7.6926,53.28823,2021/09/23 23:00:00+00,Fri 24 Sep 2021,1913,7385,79,3569332,3458501,239900,3809232,3698401,80.8941862729504,78.5405402994793,573
-7.6926,53.28823,2021/09/24 23:00:00+00,Sat 25 Sep 2021,2422,6602,53,3571754,3465103,239953,3811707,3705056,80.9467462406881,78.6818682127296,574
-7.6926,53.28823,2021/09/25 23:00:00+00,Sun 26 Sep 2021,1549,7099,0,3573303,3472202,239953,3813256,3712155,80.9796413477692,78.8326250656469,575
-7.6926,53.28823,2021/09/26 23:00:00+00,Mon 27 Sep 2021,1177,3825,45,3574480,3476027,239998,3814478,3716025,81.0055921682038,78.9148097424732,576
-7.6926,53.28823,2021/09/27 23:00:00+00,Tue 28 Sep 2021,1450,5137,93,3575930,3481164,240091,3816021,3721255,81.0383598571813,79.0258758561169,577
-7.6926,53.28823,2021/09/28 23:00:00+00,Wed 29 Sep 2021,1651,3630,80,3577581,3484794,240171,3817752,3724965,81.0751199800718,79.104662716847,578
-7.6926,53.28823,2021/09/29 23:00:00+00,Thu 30 Sep 2021,1281,3976,78,3578862,3488770,240249,3819111,3729019,81.1039801805387,79.1907548821839,579
-7.6926,53.28823,2021/09/30 23:00:00+00,Fri 01 Oct 2021,1860,5186,42,3580722,3493956,240291,3821013,3734247,81.144371719382,79.3017785231265,580
-7.6926,53.28823,2021/10/01 23:00:00+00,Sat 02 Oct 2021,1705,4096,40,3582427,3498052,240331,3822758,3738383,81.1814291511809,79.3896120692127,581
-7.6926,53.28823,2021/10/02 23:00:00+00,Sun 03 Oct 2021,1196,3021,9,3583623,3501073,240340,3823963,3741413,81.2070189536553,79.453958211534,582
-7.6926,53.28823,2021/10/03 23:00:00+00,Mon 04 Oct 2021,339,1243,18,3583962,3502316,240358,3824320,3742674,81.2146003308199,79.480737249642,583
-7.6926,53.28823,2021/10/04 23:00:00+00,Tue 05 Oct 2021,959,2828,70,3584921,3505144,240428,3825349,3745572,81.2364525355884,79.542280193684,584
-7.6926,53.28823,2021/10/05 23:00:00+00,Wed 06 Oct 2021,975,2577,40,3585896,3507721,240468,3826364,3748189,81.2580074314485,79.5978557232071,585
-7.6926,53.28823,2021/10/06 23:00:00+00,Thu 07 Oct 2021,1215,2703,44,3587111,3510424,240512,3827623,3750936,81.2847439968553,79.6561919783083,586
-7.6926,53.28823,2021/10/07 23:00:00+00,Fri 08 Oct 2021,937,2776,48,3588048,3513200,240560,3828608,3753760,81.3056618021974,79.7161634324059,587
-7.6926,53.28823,2021/10/08 23:00:00+00,Sat 09 Oct 2021,732,2377,23,3588780,3515577,240583,3829363,3756160,81.3216952469012,79.7671306738485,588
-7.6926,53.28823,2021/10/09 23:00:00+00,Sun 10 Oct 2021,1508,3919,2,3590288,3519496,240585,3830873,3760081,81.3537621363089,79.8503984045554,589
-7.6926,53.28823,2021/10/10 23:00:00+00,Mon 11 Oct 2021,334,1130,19,3590622,3520626,240604,3831226,3761230,81.3612585680711,79.8747989713961,590
-7.6926,53.28823,2021/10/11 23:00:00+00,Tue 12 Oct 2021,563,1615,20,3591185,3522241,240624,3831809,3762865,81.3736393604715,79.9095204046289,591
-7.6926,53.28823,2021/10/12 23:00:00+00,Wed 13 Oct 2021,992,2074,11,3592177,3524315,240635,3832812,3764950,81.3949394201245,79.9537981956322,592
-7.6926,53.28823,2021/10/13 23:00:00+00,Thu 14 Oct 2021,670,1605,8,3592847,3525920,240643,3833490,3766563,81.409337665832,79.9880524291518,593
-7.6926,53.28823,2021/10/14 23:00:00+00,Fri 15 Oct 2021,957,2075,9,3593804,3527995,240652,3834456,3768647,81.4298519805127,80.0323089838045,594
-7.6926,53.28823,2021/10/15 23:00:00+00,Sat 16 Oct 2021,1374,2648,14,3595178,3530643,240666,3835844,3771309,81.459328035147,80.0888401491047,595
-7.6926,53.28823,2021/10/16 23:00:00+00,Sun 17 Oct 2021,1700,2892,2,3596878,3533535,240668,3837546,3774203,81.4954723038701,80.1502981477443,596
-7.6926,53.28823,2021/10/17 23:00:00+00,Mon 18 Oct 2021,675,1247,6,3597553,3534782,240674,3838227,3775456,81.5099342586294,80.1769072950475,597
-7.6926,53.28823,2021/10/18 23:00:00+00,Tue 19 Oct 2021,1336,1802,13,3598889,3536584,240687,3839576,3777271,81.5385820955903,80.2154512713885,598
-7.6926,53.28823,2021/10/19 23:00:00+00,Wed 20 Oct 2021,2255,2329,0,3601144,3538913,240687,3841831,3779600,81.5864700661958,80.2649107319384,599
-7.6926,53.28823,2021/10/20 23:00:00+00,Thu 21 Oct 2021,1731,1844,11,3602875,3540757,240698,3843573,3781455,81.623463788943,80.3043041623035,600
-7.6926,53.28823,2021/10/21 23:00:00+00,Fri 22 Oct 2021,1505,1932,3,3604380,3542689,240701,3845081,3783390,81.6554882056494,80.3453965007166,601
-7.6926,53.28823,2021/10/22 23:00:00+00,Sat 23 Oct 2021,2018,1701,1,3606398,3544390,240702,3847100,3785092,81.6983643975131,80.3815407694397,602
-7.6926,53.28823,2021/10/23 23:00:00+00,Sun 24 Oct 2021,1952,2186,2,3608350,3546576,240704,3849054,3787280,81.7398602265876,80.4280059045549,603
-7.6926,53.28823,2021/10/24 23:00:00+00,Mon 25 Oct 2021,1227,853,2,3609577,3547429,240706,3850283,3788135,81.7659597014764,80.4461629843189,604
-7.6926,53.28823,2021/10/25 23:00:00+00,Tue 26 Oct 2021,1237,1230,6,3610814,3548659,240712,3851526,3789371,81.7923564852735,80.4724111136618,605
-7.6926,53.28823,2021/10/26 23:00:00+00,Wed 27 Oct 2021,1555,1422,6,3612369,3550081,240718,3853087,3790799,81.8255064285619,80.5027366223202,606
-7.6926,53.28823,2021/10/27 23:00:00+00,Thu 28 Oct 2021,2148,1691,5,3614517,3551772,240723,3855240,3792495,81.8712282914061,80.5387534729397,607
-7.6926,53.28823,2021/10/28 23:00:00+00,Fri 29 Oct 2021,2138,1363,2,3616655,3553135,240725,3857380,3793860,81.9166740816924,80.5677410915102,608
