X,Y,VaccinationDate,VaccineText,Dose1,Dose2,SingleDose,Dose1Cum,Dose2Cum,SingleDoseCum,PartiallyVacc,FullyVacc,PartialPercent,FullyPercent,ObjectId
-7.6926,53.28823,2020/12/28 00:00:00+00,Mon 28 Dec 2020,111,8,5,111,8,5,116,13,0.00274360491710765,0.000307472964848272,1
-7.6926,53.28823,2020/12/29 00:00:00+00,Tue 29 Dec 2020,68,1,0,179,9,5,184,14,0.00435192504092938,0.000331124731375062,2
-7.6926,53.28823,2020/12/30 00:00:00+00,Wed 30 Dec 2020,1042,0,0,1221,9,5,1226,14,0.0289970657618447,0.000331124731375062,3
-7.6926,53.28823,2020/12/31 00:00:00+00,Thu 31 Dec 2020,1020,1,0,2241,10,5,2246,15,0.0531218676191706,0.000354776497901852,4
-7.6926,53.28823,2021/01/01 00:00:00+00,Fri 01 Jan 2021,792,0,0,3033,10,5,3038,15,0.0718540667083884,0.000354776497901852,5
-7.6926,53.28823,2021/01/02 00:00:00+00,Sat 02 Jan 2021,1009,0,0,4042,10,5,4047,15,0.0957186991339196,0.000354776497901852,6
-7.6926,53.28823,2021/01/03 00:00:00+00,Sun 03 Jan 2021,12,0,0,4054,10,5,4059,15,0.0960025203322411,0.000354776497901852,7
-7.6926,53.28823,2021/01/04 00:00:00+00,Mon 04 Jan 2021,1167,1,0,5221,11,5,5226,16,0.123604131869005,0.000378428264428642,8
-7.6926,53.28823,2021/01/05 00:00:00+00,Tue 05 Jan 2021,3490,3,0,8711,14,5,8716,19,0.206148797047503,0.000449383564009012,9
-7.6926,53.28823,2021/01/06 00:00:00+00,Wed 06 Jan 2021,6735,2,0,15446,16,5,15451,21,0.365443444605434,0.000496687097062593,10
-7.6926,53.28823,2021/01/07 00:00:00+00,Thu 07 Jan 2021,11698,2,0,27144,18,5,27149,23,0.642121809435825,0.000543990630116173,11
-7.6926,53.28823,2021/01/08 00:00:00+00,Fri 08 Jan 2021,12650,1,0,39794,19,5,39799,24,0.94131665599972,0.000567642396642963,12
-7.6926,53.28823,2021/01/09 00:00:00+00,Sat 09 Jan 2021,8054,1,0,47848,20,5,47853,25,1.13180798360649,0.000591294163169753,13
-7.6926,53.28823,2021/01/10 00:00:00+00,Sun 10 Jan 2021,4752,1,1,52600,21,6,52606,27,1.24422482990832,0.000638597696223333,14
-7.6926,53.28823,2021/01/11 00:00:00+00,Mon 11 Jan 2021,8307,3,0,60907,24,6,60913,30,1.44070005444637,0.000709552995803704,15
-7.6926,53.28823,2021/01/12 00:00:00+00,Tue 12 Jan 2021,8834,4,0,69741,28,6,69747,34,1.64963975994403,0.000804160061910864,16
-7.6926,53.28823,2021/01/13 00:00:00+00,Wed 13 Jan 2021,9833,2,0,79574,30,6,79580,36,1.88220758020196,0.000851463594964444,17
-7.6926,53.28823,2021/01/14 00:00:00+00,Thu 14 Jan 2021,8033,2,0,87607,32,6,87613,38,2.07220222071166,0.000898767128018024,18
-7.6926,53.28823,2021/01/15 00:00:00+00,Fri 15 Jan 2021,7631,2,0,95238,34,6,95244,40,2.2526888510776,0.000946070661071605,19
-7.6926,53.28823,2021/01/16 00:00:00+00,Sat 16 Jan 2021,5201,1,0,100439,35,6,100445,41,2.37570168878343,0.000969722427598395,20
-7.6926,53.28823,2021/01/17 00:00:00+00,Sun 17 Jan 2021,1093,3,0,101532,38,6,101538,44,2.40155306959722,0.00104067772717877,21
-7.6926,53.28823,2021/01/18 00:00:00+00,Mon 18 Jan 2021,8659,4,0,110191,42,6,110197,48,2.60635371595269,0.00113528479328593,22
-7.6926,53.28823,2021/01/19 00:00:00+00,Tue 19 Jan 2021,8339,14,0,118530,56,6,118536,62,2.80358579701959,0.00146640952466099,23
-7.6926,53.28823,2021/01/20 00:00:00+00,Wed 20 Jan 2021,8406,953,0,126936,1009,6,126942,1015,3.00240254644379,0.024006543024692,24
-7.6926,53.28823,2021/01/21 00:00:00+00,Thu 21 Jan 2021,8930,955,0,135866,1964,6,135872,1970,3.21361282152803,0.0465939800577765,25
-7.6926,53.28823,2021/01/22 00:00:00+00,Fri 22 Jan 2021,6712,961,0,142578,2925,6,142584,2931,3.37236347845584,0.0693233276900218,26
-7.6926,53.28823,2021/01/23 00:00:00+00,Sat 23 Jan 2021,4142,456,0,146720,3381,6,146726,3387,3.47032909540981,0.0801085332262381,27
-7.6926,53.28823,2021/01/24 00:00:00+00,Sun 24 Jan 2021,1159,393,0,147879,3774,6,147885,3780,3.49774149281436,0.0894036774712667,28
-7.6926,53.28823,2021/01/25 00:00:00+00,Mon 25 Jan 2021,1320,1279,0,149199,5053,6,149205,5059,3.52896182462972,0.119654286859031,29
-7.6926,53.28823,2021/01/26 00:00:00+00,Tue 26 Jan 2021,972,3491,0,150171,8544,6,150177,8550,3.55195134169376,0.202222603804056,30
-7.6926,53.28823,2021/01/27 00:00:00+00,Wed 27 Jan 2021,2129,6690,0,152300,15234,6,152306,15240,3.6023059526293,0.360452921868281,31
-7.6926,53.28823,2021/01/28 00:00:00+00,Thu 28 Jan 2021,938,11536,0,153238,26770,6,153244,26776,3.62449130963143,0.633299700521332,32
-7.6926,53.28823,2021/01/29 00:00:00+00,Fri 29 Jan 2021,1528,11517,0,154766,38287,6,154772,38293,3.66063120888436,0.905697095610374,33
-7.6926,53.28823,2021/01/30 00:00:00+00,Sat 30 Jan 2021,591,7789,0,155357,46076,6,155363,46082,3.67460940290169,1.08992070508754,34
-7.6926,53.28823,2021/01/31 00:00:00+00,Sun 31 Jan 2021,199,4078,0,155556,50154,6,155562,50160,3.67931610444052,1.18637260898379,35
-7.6926,53.28823,2021/02/01 00:00:00+00,Mon 01 Feb 2021,966,8324,0,156522,58478,6,156528,58484,3.7021637109054,1.38324991355279,36
-7.6926,53.28823,2021/02/02 00:00:00+00,Tue 02 Feb 2021,779,5088,0,157301,63566,6,157307,63572,3.72058843702977,1.5035901016411,37
-7.6926,53.28823,2021/02/03 00:00:00+00,Wed 03 Feb 2021,1351,6853,0,158652,70419,6,158658,70425,3.75254197360747,1.66567565764919,38
-7.6926,53.28823,2021/02/04 00:00:00+00,Thu 04 Feb 2021,1376,10524,0,160028,80943,6,160034,80949,3.78508680434833,1.91458684857713,39
-7.6926,53.28823,2021/02/05 00:00:00+00,Fri 05 Feb 2021,3350,8594,0,163378,89537,6,163384,89543,3.86432022221308,2.11785013010837,40
-7.6926,53.28823,2021/02/06 00:00:00+00,Sat 06 Feb 2021,863,3858,0,164241,93395,6,164247,93401,3.8847316967257,2.20909864536872,41
-7.6926,53.28823,2021/02/07 00:00:00+00,Sun 07 Feb 2021,298,1289,0,164539,94684,6,164545,94690,3.89177992315068,2.23958577242176,42
-7.6926,53.28823,2021/02/08 00:00:00+00,Mon 08 Feb 2021,1117,867,0,165656,95551,6,165662,95557,3.9181989463611,2.26009185400048,43
-7.6926,53.28823,2021/02/09 00:00:00+00,Tue 09 Feb 2021,4181,522,0,169837,96073,6,169843,96079,4.01708698220961,2.27243807612747,44
-7.6926,53.28823,2021/02/10 00:00:00+00,Wed 10 Feb 2021,8781,569,0,178618,96642,6,178624,96648,4.22477314408136,2.28589593128121,45
-7.6926,53.28823,2021/02/11 00:00:00+00,Thu 11 Feb 2021,6115,422,0,184733,97064,6,184739,97070,4.36940369639268,2.29587697675552,46
-7.6926,53.28823,2021/02/12 00:00:00+00,Fri 12 Feb 2021,4348,511,0,189081,97575,6,189087,97581,4.47224157725116,2.30796302945071,47
-7.6926,53.28823,2021/02/13 00:00:00+00,Sat 13 Feb 2021,1171,1909,0,190252,99484,6,190258,99490,4.49993779585403,2.35311425175035,48
-7.6926,53.28823,2021/02/14 00:00:00+00,Sun 14 Feb 2021,2665,16,0,192917,99500,6,192923,99506,4.56296975364793,2.35349268001478,49
-7.6926,53.28823,2021/02/15 00:00:00+00,Mon 15 Feb 2021,1917,7859,0,194834,107359,6,194840,107365,4.60831019007979,2.53937191314882,50
-7.6926,53.28823,2021/02/16 00:00:00+00,Tue 16 Feb 2021,5588,8134,0,200422,115493,6,200428,115499,4.74047626143149,2.73175538207773,51
-7.6926,53.28823,2021/02/17 00:00:00+00,Wed 17 Feb 2021,9690,8448,0,210112,123941,6,210118,123947,4.96966187907609,2.93156550569606,52
-7.6926,53.28823,2021/02/18 00:00:00+00,Thu 18 Feb 2021,8413,8319,0,218525,132260,6,218531,132266,5.16864419086597,3.12832455143242,53
-7.6926,53.28823,2021/02/19 00:00:00+00,Fri 19 Feb 2021,9355,6559,0,227880,138819,6,227886,138825,5.38990646672409,3.28345648808164,54
-7.6926,53.28823,2021/02/20 00:00:00+00,Sat 20 Feb 2021,5844,3557,1,233724,142376,7,233731,142383,5.52815104207318,3.36760947338396,55
-7.6926,53.28823,2021/02/21 00:00:00+00,Sun 21 Feb 2021,1073,1014,2,234797,143390,9,234806,143399,5.55357669108948,3.39163966817518,56
-7.6926,53.28823,2021/02/22 00:00:00+00,Mon 22 Feb 2021,3895,1093,1,238692,144483,10,238702,144493,5.64572397347786,3.41751470075548,57
-7.6926,53.28823,2021/02/23 00:00:00+00,Tue 23 Feb 2021,13309,1049,0,252001,145532,10,252011,145542,5.9605053341829,3.44232540384209,58
-7.6926,53.28823,2021/02/24 00:00:00+00,Wed 24 Feb 2021,16863,2076,2,268864,147608,12,268876,147620,6.35939237665722,3.49147377468476,59
-7.6926,53.28823,2021/02/25 00:00:00+00,Thu 25 Feb 2021,17989,1728,1,286853,149336,13,286866,149349,6.78488765647417,3.53236767900958,60
-7.6926,53.28823,2021/02/26 00:00:00+00,Fri 26 Feb 2021,16005,2737,0,302858,152073,13,302871,152086,7.16343417973545,3.5971025639934,61
-7.6926,53.28823,2021/02/27 00:00:00+00,Sat 27 Feb 2021,8931,696,1,311789,152769,14,311803,152783,7.37469175835274,3.61358784526257,62
-7.6926,53.28823,2021/02/28 00:00:00+00,Sun 28 Feb 2021,2410,44,1,314199,152813,15,314214,152828,7.43171616744883,3.61465217475628,63
-7.6926,53.28823,2021/03/01 00:00:00+00,Mon 01 Mar 2021,5518,772,0,319717,153585,15,319732,153600,7.56222661514366,3.63291133851496,64
-7.6926,53.28823,2021/03/02 00:00:00+00,Tue 02 Mar 2021,12102,1584,0,331819,155169,15,331834,155184,7.84846029365087,3.6703757366934,65
-7.6926,53.28823,2021/03/03 00:00:00+00,Wed 03 Mar 2021,12755,1476,1,344574,156645,16,344590,156661,8.15016222746661,3.70530939585347,66
-7.6926,53.28823,2021/03/04 00:00:00+00,Thu 04 Mar 2021,18623,1667,0,363197,158312,16,363213,158328,8.59062907549502,3.74473689065363,67
-7.6926,53.28823,2021/03/05 00:00:00+00,Fri 05 Mar 2021,18346,2374,1,381543,160686,17,381560,160703,9.02456803596204,3.80090983615475,68
-7.6926,53.28823,2021/03/06 00:00:00+00,Sat 06 Mar 2021,10349,120,0,391892,160806,17,391909,160823,9.26934016774779,3.80374804813797,69
-7.6926,53.28823,2021/03/07 00:00:00+00,Sun 07 Mar 2021,1470,5,0,393362,160811,17,393379,160828,9.30410826454217,3.8038663069706,70
-7.6926,53.28823,2021/03/08 00:00:00+00,Mon 08 Mar 2021,6570,1472,1,399932,162283,18,399950,162301,9.45952402238971,3.83870535906456,71
-7.6926,53.28823,2021/03/09 00:00:00+00,Tue 09 Mar 2021,13696,3075,1,413628,165358,19,413647,165377,9.78348226850715,3.91145819290097,72
-7.6926,53.28823,2021/03/10 00:00:00+00,Wed 10 Mar 2021,13609,3955,0,427237,169313,19,427256,169332,10.1053591591702,4.00500092951442,73
-7.6926,53.28823,2021/03/11 00:00:00+00,Thu 11 Mar 2021,18339,2073,0,445576,171386,19,445595,171405,10.539108905505,4.05403104152446,74
-7.6926,53.28823,2021/03/12 00:00:00+00,Fri 12 Mar 2021,17199,1311,1,462775,172697,20,462795,172717,10.9459192897658,4.08506215920761,75
-7.6926,53.28823,2021/03/13 00:00:00+00,Sat 13 Mar 2021,8198,155,0,470973,172852,20,470993,172872,11.1398164717525,4.08872818301926,76
-7.6926,53.28823,2021/03/14 00:00:00+00,Sun 14 Mar 2021,319,7,1,471292,172859,21,471313,172880,11.147385037041,4.08891739715148,77
-7.6926,53.28823,2021/03/15 00:00:00+00,Mon 15 Mar 2021,2523,962,0,473815,173821,21,473836,173842,11.2070584439881,4.11167039655025,78
-7.6926,53.28823,2021/03/16 00:00:00+00,Tue 16 Mar 2021,8832,3783,0,482647,177604,21,482668,177625,11.4159508459527,4.20114502932109,79
-7.6926,53.28823,2021/03/17 00:00:00+00,Wed 17 Mar 2021,4797,2382,4,487444,179986,25,487469,180011,11.5295029770479,4.25757814425402,80
-7.6926,53.28823,2021/03/18 00:00:00+00,Thu 18 Mar 2021,11583,4650,1,499027,184636,26,499053,184662,11.8034850404942,4.36758251037012,81
-7.6926,53.28823,2021/03/19 00:00:00+00,Fri 19 Mar 2021,10211,6086,1,509238,190722,27,509265,190749,12.0450168802658,4.51155081321869,82
-7.6926,53.28823,2021/03/20 00:00:00+00,Sat 20 Mar 2021,5107,3090,0,514345,193812,27,514372,193839,12.1658064519181,4.58463477178647,83
-7.6926,53.28823,2021/03/21 00:00:00+00,Sun 21 Mar 2021,3536,39,0,517881,193851,27,517908,193878,12.2494390983568,4.58555719068101,84
-7.6926,53.28823,2021/03/22 00:00:00+00,Mon 22 Mar 2021,7278,2364,0,525159,196215,27,525186,196242,12.4215766551388,4.64146996675035,85
-7.6926,53.28823,2021/03/23 00:00:00+00,Tue 23 Mar 2021,12408,7346,1,537567,203561,28,537595,203589,12.7150714259697,4.81523949542267,86
-7.6926,53.28823,2021/03/24 00:00:00+00,Wed 24 Mar 2021,13483,9732,0,551050,213293,28,551078,213321,13.0339681940504,5.0454184872614,87
-7.6926,53.28823,2021/03/25 00:00:00+00,Thu 25 Mar 2021,20715,10175,1,571765,223468,29,571794,223497,13.5239381894194,5.28609886343801,88
-7.6926,53.28823,2021/03/26 00:00:00+00,Fri 26 Mar 2021,19547,9421,0,591312,232889,29,591341,232918,13.9862592697186,5.5089221558869,89
-7.6926,53.28823,2021/03/27 00:00:00+00,Sat 27 Mar 2021,11591,5291,1,602903,238180,30,602933,238210,14.2604305472971,5.63408730434667,90
-7.6926,53.28823,2021/03/28 00:00:00+00,Sun 28 Mar 2021,2404,459,0,605307,238639,30,605337,238669,14.3172893940275,5.64494346518247,91
-7.6926,53.28823,2021/03/28 23:00:00+00,Mon 29 Mar 2021,9129,3060,0,614436,241699,30,614466,241729,14.5332063706506,5.71731787075445,92
-7.6926,53.28823,2021/03/29 23:00:00+00,Tue 30 Mar 2021,13181,8605,1,627617,250304,31,627648,250335,14.8449839570068,5.920864973484,93
-7.6926,53.28823,2021/03/30 23:00:00+00,Wed 31 Mar 2021,15626,10416,0,643243,260720,31,643274,260751,15.2145664607544,6.16722177362705,94
-7.6926,53.28823,2021/03/31 23:00:00+00,Thu 01 Apr 2021,19534,11530,0,662777,272250,31,662808,272281,15.6765800680887,6.43992664168094,95
-7.6926,53.28823,2021/04/01 23:00:00+00,Fri 02 Apr 2021,19997,13666,0,682774,285916,31,682805,285947,16.1495444433249,6.76315168303605,96
-7.6926,53.28823,2021/04/02 23:00:00+00,Sat 03 Apr 2021,7419,4583,0,690193,290499,31,690224,290530,16.3250168991872,6.87154772902833,97
-7.6926,53.28823,2021/04/03 23:00:00+00,Sun 04 Apr 2021,2930,146,0,693123,290645,31,693154,290676,16.3943165751107,6.87500088694124,98
-7.6926,53.28823,2021/04/04 23:00:00+00,Mon 05 Apr 2021,3321,567,0,696444,291212,31,696475,291243,16.4728640917461,6.88841143856193,99
-7.6926,53.28823,2021/04/05 23:00:00+00,Tue 06 Apr 2021,11824,8099,1,708268,299311,32,708300,299343,16.7525462309254,7.07999074742894,100
-7.6926,53.28823,2021/04/06 23:00:00+00,Wed 07 Apr 2021,18169,10403,1,726437,309714,33,726470,309747,17.1822988287172,7.32606372637366,101
-7.6926,53.28823,2021/04/07 23:00:00+00,Thu 08 Apr 2021,20008,10488,0,746445,320202,33,746478,320235,17.6555233733852,7.57412345370663,102
-7.6926,53.28823,2021/04/08 23:00:00+00,Fri 09 Apr 2021,20546,9080,0,766991,329282,33,767024,329315,18.1414725684447,7.78888149376989,103
-7.6926,53.28823,2021/04/09 23:00:00+00,Sat 10 Apr 2021,11014,4124,2,778005,333406,35,778040,333441,18.4020204285038,7.88646868245942,104
-7.6926,53.28823,2021/04/10 23:00:00+00,Sun 11 Apr 2021,2776,312,0,780781,333718,35,780816,333753,18.4676777323822,7.89384803361578,105
-7.6926,53.28823,2021/04/11 23:00:00+00,Mon 12 Apr 2021,7642,2704,1,788423,336422,36,788459,336458,18.6484481839464,7.95782606207075,106
-7.6926,53.28823,2021/04/12 23:00:00+00,Tue 13 Apr 2021,11374,8508,0,799797,344930,36,799833,344966,18.9174633764221,8.15905529168068,107
-7.6926,53.28823,2021/04/13 23:00:00+00,Wed 14 Apr 2021,20194,6523,2,819991,351453,38,820029,351491,19.3951344531972,8.31338306826799,108
-7.6926,53.28823,2021/04/14 23:00:00+00,Thu 15 Apr 2021,26954,10707,0,846945,362160,38,846983,362198,20.0326441681603,8.56662253247033,109
-7.6926,53.28823,2021/04/15 23:00:00+00,Fri 16 Apr 2021,27811,9748,1,874756,371908,39,874795,371947,20.6904470988034,8.79720360434001,110
-7.6926,53.28823,2021/04/16 23:00:00+00,Sat 17 Apr 2021,15699,4482,1,890455,376390,40,890495,376430,21.061779833274,8.9032344736796,111
-7.6926,53.28823,2021/04/17 23:00:00+00,Sun 18 Apr 2021,985,430,0,891440,376820,40,891480,376860,21.0850768233029,8.91340473328613,112
-7.6926,53.28823,2021/08/08 23:00:00+00,Mon 09 Aug 2021,5438,22700,583,3238566,2752406,224860,3463426,2977266,81.9161431348146,70.4176003201503,113
-7.6926,53.28823,2021/08/09 23:00:00+00,Tue 10 Aug 2021,9204,25663,685,3247770,2778069,225545,3473315,3003614,82.150035453998,71.0407770645982,114
-7.6926,53.28823,2021/08/10 23:00:00+00,Wed 11 Aug 2021,6905,30900,633,3254675,2808969,226178,3480853,3035147,82.328322470077,71.7865882184875,115
-7.6926,53.28823,2021/08/11 23:00:00+00,Thu 12 Aug 2021,6635,37975,849,3261310,2846944,227027,3488337,3073971,82.5053322907635,72.7048444021235,116
-7.6926,53.28823,2021/08/12 23:00:00+00,Fri 13 Aug 2021,10803,27913,843,3272113,2874857,227870,3499983,3102727,82.7807807637345,73.3849746003679,117
-7.6926,53.28823,2021/08/13 23:00:00+00,Sat 14 Aug 2021,18041,5642,267,3290154,2880499,228137,3518291,3108636,83.2137973053069,73.5247328887747,118
-7.6926,53.28823,2021/08/14 23:00:00+00,Sun 15 Aug 2021,16955,3605,39,3307109,2884104,228176,3535285,3112280,83.6157354256632,73.6109199259984,119
-7.6926,53.28823,2021/08/15 23:00:00+00,Mon 16 Aug 2021,10101,22870,350,3317210,2906974,228526,3545736,3135500,83.8629200376347,74.1601139447504,120
-7.6926,53.28823,2021/08/16 23:00:00+00,Tue 17 Aug 2021,12772,26611,511,3329982,2933585,229037,3559019,3162622,84.17708645241,74.80159715649,121
-7.6926,53.28823,2021/08/17 23:00:00+00,Wed 18 Aug 2021,15140,25515,645,3345122,2959100,229682,3574804,3188782,84.5504295870354,75.4203273688309,122
-7.6926,53.28823,2021/08/18 23:00:00+00,Thu 19 Aug 2021,11291,25456,522,3356413,2984556,230204,3586617,3214760,84.8298279050164,76.0347529596638,123
-7.6926,53.28823,2021/08/19 23:00:00+00,Fri 20 Aug 2021,14741,22021,664,3371154,3006577,230868,3602022,3237445,85.1941833683616,76.571293283324,124
-7.6926,53.28823,2021/08/20 23:00:00+00,Sat 21 Aug 2021,11802,7813,224,3382956,3014390,231092,3614048,3245482,85.4786195126128,76.7613825308999,125
-7.6926,53.28823,2021/08/21 23:00:00+00,Sun 22 Aug 2021,7984,12160,156,3390940,3026550,231248,3622188,3257798,85.6711448921408,77.0526776874438,126
-7.6926,53.28823,2021/08/22 23:00:00+00,Mon 23 Aug 2021,10796,15146,271,3401736,3041696,231519,3633255,3273215,85.9328989922928,77.4173169719873,127
-7.6926,53.28823,2021/08/23 23:00:00+00,Tue 24 Aug 2021,9638,22708,368,3411374,3064404,231887,3643261,3296291,86.1695585681599,77.9631051363595,128
-7.6926,53.28823,2021/08/24 23:00:00+00,Wed 25 Aug 2021,9340,19268,305,3420714,3083672,232192,3652906,3315864,86.3976798563108,78.4260411625884,129
-7.6926,53.28823,2021/08/25 23:00:00+00,Thu 26 Aug 2021,8507,19222,358,3429221,3102894,232550,3661771,3335444,86.6073527665708,78.8891427511829,130
-7.6926,53.28823,2021/08/26 23:00:00+00,Fri 27 Aug 2021,9651,19016,425,3438872,3121910,232975,3671847,3354885,86.8456679660947,79.3489567442303,131
-7.6926,53.28823,2021/08/27 23:00:00+00,Sat 28 Aug 2021,9877,7764,145,3448749,3129674,233120,3681869,3362794,87.0827059702262,79.5360185656907,132
-7.6926,53.28823,2021/08/28 23:00:00+00,Sun 29 Aug 2021,8782,9121,23,3457531,3138795,233143,3690674,3371938,87.2909597744946,79.7522903188116,133
-7.6926,53.28823,2021/08/29 23:00:00+00,Mon 30 Aug 2021,5015,10950,77,3462546,3149745,233220,3695766,3382965,87.411394569649,80.0130983483025,134
-7.6926,53.28823,2021/08/30 23:00:00+00,Tue 31 Aug 2021,4009,12668,134,3466555,3162413,233354,3699909,3395767,87.5093838383695,80.3158882633785,135
-7.6926,53.28823,2021/08/31 23:00:00+00,Wed 01 Sep 2021,4895,12362,171,3471450,3174775,233525,3704975,3408300,87.6292036875942,80.6123158532588,136
-7.6926,53.28823,2021/09/01 23:00:00+00,Thu 02 Sep 2021,4959,12228,243,3476409,3187003,233768,3710177,3420771,87.7522401770666,80.9072770336144,137
-7.6926,53.28823,2021/09/02 23:00:00+00,Fri 03 Sep 2021,4719,15881,159,3481128,3202884,233927,3715055,3436811,87.8676134941843,81.2866513687041,138
-7.6926,53.28823,2021/09/03 23:00:00+00,Sat 04 Sep 2021,4600,10497,128,3485728,3213381,234055,3719783,3447436,87.9794390463229,81.5379513880512,139
-7.6926,53.28823,2021/09/04 23:00:00+00,Sun 05 Sep 2021,5290,11833,0,3491018,3225214,234055,3725073,3459269,88.1045568912497,81.8178227413627,140
-7.6926,53.28823,2021/09/05 23:00:00+00,Mon 06 Sep 2021,2103,9563,68,3493121,3234777,234123,3727244,3468900,88.1559048763793,82.0456129047822,141
-7.6926,53.28823,2021/09/06 23:00:00+00,Tue 07 Sep 2021,2994,9887,134,3496115,3244664,234257,3730372,3478921,88.2298876020751,82.2826272571472,142
-7.6926,53.28823,2021/09/07 23:00:00+00,Wed 08 Sep 2021,2568,14676,178,3498683,3259340,234435,3733118,3493775,88.2948353529577,82.6339505971361,143
-7.6926,53.28823,2021/09/08 23:00:00+00,Thu 09 Sep 2021,3074,14677,135,3501757,3274017,234570,3736327,3508587,88.3707338717421,82.984280562931,144
-7.6926,53.28823,2021/09/09 23:00:00+00,Fri 10 Sep 2021,3348,13839,107,3505105,3287856,234677,3739782,3522533,88.4524507250922,83.3141280989136,145
-7.6926,53.28823,2021/09/10 23:00:00+00,Sat 11 Sep 2021,2537,11227,57,3507642,3299083,234734,3742376,3533817,88.5138034074627,83.5810146324019,146
-7.6926,53.28823,2021/09/11 23:00:00+00,Sun 12 Sep 2021,2022,12842,0,3509664,3311925,234734,3744398,3546659,88.5616272793799,83.8847506181389,147
-7.6926,53.28823,2021/09/12 23:00:00+00,Mon 13 Sep 2021,1573,7636,46,3511237,3319561,234780,3746017,3554341,88.5999194893867,84.0664434885977,148
-7.6926,53.28823,2021/09/13 23:00:00+00,Tue 14 Sep 2021,1515,10672,79,3512752,3330233,234859,3747611,3565092,88.6376204052305,84.3207236305272,149
-7.6926,53.28823,2021/09/14 23:00:00+00,Wed 15 Sep 2021,3244,12307,130,3515996,3342540,234989,3750985,3577529,88.7174214654918,84.6148806508209,150
-7.6926,53.28823,2021/09/15 23:00:00+00,Thu 16 Sep 2021,1881,10499,109,3517877,3353039,235098,3752975,3588137,88.7644884808801,84.8657785901371,151
-7.6926,53.28823,2021/09/16 23:00:00+00,Fri 17 Sep 2021,2534,14515,89,3520411,3367554,235187,3755598,3602741,88.8265270644799,85.2111889884944,152
-7.6926,53.28823,2021/09/17 23:00:00+00,Sat 18 Sep 2021,2268,11165,40,3522679,3378719,235227,3757906,3613946,88.8811153416238,85.476207032427,153
-7.6926,53.28823,2021/09/18 23:00:00+00,Sun 19 Sep 2021,1853,8455,11,3524532,3387174,235238,3759770,3622412,88.9252022344297,85.6764428878429,154
-7.6926,53.28823,2021/09/19 23:00:00+00,Mon 20 Sep 2021,946,5549,29,3525478,3392723,235267,3760745,3627990,88.9482627067933,85.8083724415293,155
-7.6926,53.28823,2021/09/20 23:00:00+00,Tue 21 Sep 2021,1440,6588,89,3526918,3399311,235356,3762274,3634667,88.9844262578128,85.9662952866287,156
-7.6926,53.28823,2021/09/21 23:00:00+00,Wed 22 Sep 2021,1881,8064,94,3528799,3407375,235450,3764249,3642825,89.0311384967032,86.1592463979542,157
-7.6926,53.28823,2021/09/22 23:00:00+00,Thu 23 Sep 2021,1677,8679,85,3530476,3416054,235535,3766011,3651589,89.0728129093234,86.366530479795,158
-7.6926,53.28823,2021/09/23 23:00:00+00,Fri 24 Sep 2021,1895,7294,79,3532371,3423348,235614,3767985,3658962,89.1195014964473,86.540914954397,159
-7.6926,53.28823,2021/09/24 23:00:00+00,Sat 25 Sep 2021,2399,6532,50,3534770,3429880,235664,3770434,3665544,89.1774246726714,86.6965908816764,160
-7.6926,53.28823,2021/09/25 23:00:00+00,Sun 26 Sep 2021,1535,7077,0,3536305,3436957,235664,3771969,3672621,89.21373013429,86.8639744333865,161
-7.6926,53.28823,2021/09/26 23:00:00+00,Mon 27 Sep 2021,1164,3697,45,3537469,3440654,235709,3773178,3676363,89.2423251200209,86.9524793437297,162
-7.6926,53.28823,2021/09/27 23:00:00+00,Tue 28 Sep 2021,1434,5039,89,3538903,3445693,235798,3774701,3681491,89.2783467604412,87.0737656024791,163
-7.6926,53.28823,2021/09/28 23:00:00+00,Wed 29 Sep 2021,1630,3533,72,3540533,3449226,235870,3776403,3685096,89.3186020670698,87.1590302208082,164
-7.6926,53.28823,2021/09/29 23:00:00+00,Thu 30 Sep 2021,1265,3877,77,3541798,3453103,235947,3777745,3689050,89.3503427377487,87.2525493056551,165
-7.6926,53.28823,2021/09/30 23:00:00+00,Fri 01 Oct 2021,1830,5088,37,3543628,3458191,235984,3779612,3694175,89.3945005858542,87.3737646091049,166
-7.6926,53.28823,2021/10/01 23:00:00+00,Sat 02 Oct 2021,1703,4035,39,3545331,3462226,236023,3781354,3698249,89.4357019631439,87.470121905935,167
-7.6926,53.28823,2021/10/02 23:00:00+00,Sun 03 Oct 2021,1202,2989,8,3546533,3465215,236031,3782564,3701246,89.4643206006413,87.5410062502158,168
-7.6926,53.28823,2021/10/03 23:00:00+00,Mon 04 Oct 2021,328,1156,16,3546861,3466371,236047,3782908,3702418,89.4724568083266,87.5687261205852,169
-7.6926,53.28823,2021/10/04 23:00:00+00,Tue 05 Oct 2021,970,2748,68,3547831,3469119,236115,3783946,3705234,89.4970073419814,87.6353294951247,170
-7.6926,53.28823,2021/10/05 23:00:00+00,Wed 06 Oct 2021,971,2488,34,3548802,3471607,236149,3784951,3707756,89.5207773673408,87.6949792503052,171
-7.6926,53.28823,2021/10/06 23:00:00+00,Thu 07 Oct 2021,1197,2626,41,3549999,3474233,236190,3786189,3710423,89.550058254301,87.7580585116322,172
-7.6926,53.28823,2021/10/07 23:00:00+00,Fri 08 Oct 2021,980,2680,42,3550979,3476913,236232,3787211,3713145,89.5742303596913,87.8224386201181,173
-7.6926,53.28823,2021/10/08 23:00:00+00,Sat 09 Oct 2021,728,2317,18,3551707,3479230,236250,3787957,3715480,89.5918745775203,87.8776654949582,174
-7.6926,53.28823,2021/10/09 23:00:00+00,Sun 10 Oct 2021,1526,3888,0,3553233,3483118,236250,3789483,3719368,89.6279671732402,87.9696235632143,175
-7.6926,53.28823,2021/10/10 23:00:00+00,Mon 11 Oct 2021,323,1065,12,3553556,3484183,236262,3789818,3720445,89.6358905150267,87.9950965157637,176
-7.6926,53.28823,2021/10/11 23:00:00+00,Tue 12 Oct 2021,545,1562,20,3554101,3485745,236282,3790383,3722027,89.6492537631143,88.032513610409,177
-7.6926,53.28823,2021/10/12 23:00:00+00,Wed 13 Oct 2021,997,1974,9,3555098,3487719,236291,3791389,3724010,89.6730474402403,88.0794150634317,178
-7.6926,53.28823,2021/10/13 23:00:00+00,Thu 14 Oct 2021,695,1510,7,3555793,3489229,236298,3792091,3725527,89.6896509803421,88.1152947932528,179
-7.6926,53.28823,2021/10/14 23:00:00+00,Fri 15 Oct 2021,949,1997,5,3556742,3491226,236303,3793045,3727529,89.7122147656086,88.1626456298394,180
-7.6926,53.28823,2021/10/15 23:00:00+00,Sat 16 Oct 2021,1375,2589,11,3558117,3493815,236314,3794431,3730129,89.7449961140148,88.2241402228091,181
-7.6926,53.28823,2021/10/16 23:00:00+00,Sun 17 Oct 2021,1708,2868,1,3559825,3496683,236315,3796140,3732998,89.785416983009,88.2919971409745,182
-7.6926,53.28823,2021/10/17 23:00:00+00,Mon 18 Oct 2021,667,1168,3,3560492,3497851,236318,3796810,3734169,89.801263666582,88.3196933595773,183
-7.6926,53.28823,2021/10/18 23:00:00+00,Tue 19 Oct 2021,1326,1727,10,3561818,3499578,236328,3798146,3735906,89.8328624266618,88.3607764780344,184
-7.6926,53.28823,2021/10/19 23:00:00+00,Wed 20 Oct 2021,2243,2246,0,3564061,3501824,236328,3800389,3738152,89.8859133389814,88.4138983456535,185
-7.6926,53.28823,2021/10/20 23:00:00+00,Thu 21 Oct 2021,1745,1760,8,3565806,3503584,236336,3802142,3739920,89.9273748857028,88.4557146688729,186
-7.6926,53.28823,2021/10/21 23:00:00+00,Fri 22 Oct 2021,1485,1886,0,3567291,3505470,236336,3803627,3741806,89.9624977589951,88.5003219005424,187
-7.6926,53.28823,2021/10/22 23:00:00+00,Sat 23 Oct 2021,2002,1658,0,3569293,3507128,236336,3805629,3743464,90.0098485955818,88.5395365294439,188
-7.6926,53.28823,2021/10/23 23:00:00+00,Sun 24 Oct 2021,1942,2171,0,3571235,3509299,236336,3807571,3745635,90.0557803261768,88.5908845145735,189
-7.6926,53.28823,2021/10/24 23:00:00+00,Mon 25 Oct 2021,1210,805,0,3572445,3510104,236336,3808781,3746440,90.0843989636742,88.6099241866276,190
-7.6926,53.28823,2021/10/25 23:00:00+00,Tue 26 Oct 2021,1232,1158,5,3573677,3511262,236341,3810018,3747603,90.1136561988678,88.6374311910982,191
-7.6926,53.28823,2021/10/26 23:00:00+00,Wed 27 Oct 2021,1550,1382,4,3575227,3512644,236345,3811572,3748989,90.1504110440505,88.6702125395044,192
-7.6926,53.28823,2021/10/27 23:00:00+00,Thu 28 Oct 2021,2137,1638,2,3577364,3514282,236347,3813711,3750629,90.2010021726513,88.7090014366083,193
-7.6926,53.28823,2021/10/28 23:00:00+00,Fri 29 Oct 2021,2117,1310,0,3579481,3515592,236347,3815828,3751939,90.2510729623885,88.7399852507584,194
-7.6926,53.28823,2021/10/29 23:00:00+00,Sat 30 Oct 2021,1997,1417,0,3581478,3517009,236347,3817825,3753356,90.2983055401425,88.7734998039269,195
-7.6926,53.28823,2021/10/30 23:00:00+00,Sun 31 Oct 2021,1622,1309,0,3583100,3518318,236347,3819447,3754665,90.3366687054489,88.8044599663104,196
-7.6926,53.28823,2021/11/01 00:00:00+00,Mon 01 Nov 2021,245,240,0,3583345,3518558,236347,3819692,3754905,90.342463388248,88.8101363902769,197
-7.6926,53.28823,2021/11/02 00:00:00+00,Tue 02 Nov 2021,1078,1046,9,3584423,3519604,236356,3820779,3755960,90.3681728584626,88.8350890039626,198
-7.6926,53.28823,2021/11/03 00:00:00+00,Wed 03 Nov 2021,2517,1772,5,3586940,3521376,236361,3823301,3757737,90.4278226136432,88.8771181930807,199
-7.6926,53.28823,2021/11/04 00:00:00+00,Thu 04 Nov 2021,1541,1208,0,3588481,3522584,236361,3824842,3758945,90.464269985861,88.9056895270451,200
-7.6926,53.28823,2021/11/05 00:00:00+00,Fri 05 Nov 2021,1590,998,0,3590071,3523582,236361,3826432,3759943,90.5018762946386,88.9292939900388,201
-7.6926,53.28823,2021/11/06 00:00:00+00,Sat 06 Nov 2021,1818,1308,5,3591889,3524890,236366,3828255,3761256,90.5449934650169,88.9603487594885,202
-7.6926,53.28823,2021/11/07 00:00:00+00,Sun 07 Nov 2021,727,763,0,3592616,3525653,236366,3828982,3762019,90.5621882992819,88.9783950573484,203
-7.6926,53.28823,2021/11/08 00:00:00+00,Mon 08 Nov 2021,499,481,1,3593115,3526134,236367,3829482,3762501,90.5740141825453,88.9897952088143,204
-7.6926,53.28823,2021/11/09 00:00:00+00,Tue 09 Nov 2021,1365,978,1,3594480,3527112,236368,3830848,3763480,90.6063224956209,89.0129502882441,205
-7.6926,53.28823,2021/11/10 00:00:00+00,Wed 10 Nov 2021,1562,1266,0,3596042,3528378,236368,3832410,3764746,90.6432665549357,89.042893424667,206
-7.6926,53.28823,2021/11/11 00:00:00+00,Thu 11 Nov 2021,1384,1028,1,3597426,3529406,236369,3833795,3765775,90.6760242515753,89.0672310924231,207
-7.6926,53.28823,2021/11/12 00:00:00+00,Fri 12 Nov 2021,1124,1043,5,3598550,3530449,236374,3834924,3766823,90.7027270959841,89.0920181437431,208
-7.6926,53.28823,2021/11/13 00:00:00+00,Sat 13 Nov 2021,1399,1320,1,3599949,3531769,236375,3836324,3768144,90.7358395691216,89.123262127325,209
-7.6926,53.28823,2021/11/14 00:00:00+00,Sun 14 Nov 2021,1642,1788,0,3601591,3533557,236375,3837966,3769932,90.7746757697586,89.1655514858749,210
-7.6926,53.28823,2021/11/15 00:00:00+00,Mon 15 Nov 2021,1236,525,0,3602827,3534082,236375,3839202,3770457,90.8039093531857,89.1779686633015,211
-7.6926,53.28823,2021/11/16 00:00:00+00,Tue 16 Nov 2021,1296,992,4,3604123,3535074,236379,3840502,3771453,90.8346566496705,89.2015258227622,212
-7.6926,53.28823,2021/11/17 00:00:00+00,Wed 17 Nov 2021,1490,1013,0,3605613,3536087,236379,3841992,3772466,90.8698977817954,89.2254850622538,213
-7.6926,53.28823,2021/11/18 00:00:00+00,Thu 18 Nov 2021,1597,2388,5,3607210,3538475,236384,3843594,3774859,90.9077879117713,89.2820837395524,214
-7.6926,53.28823,2021/11/19 00:00:00+00,Fri 19 Nov 2021,1102,1399,0,3608312,3539874,236384,3844696,3776258,90.9338521584839,89.3151725609234,215
-7.6926,53.28823,2021/11/20 00:00:00+00,Sat 20 Nov 2021,1484,2856,10,3609796,3542730,236394,3846190,3779124,90.9691878976749,89.3829585237892,216
-7.6926,53.28823,2021/11/21 00:00:00+00,Sun 21 Nov 2021,1774,2740,0,3611570,3545470,236394,3847964,3781864,91.0111461314934,89.4477643640726,217
-7.6926,53.28823,2021/11/22 00:00:00+00,Mon 22 Nov 2021,675,430,2,3612245,3545900,236396,3848641,3782296,91.027158377432,89.4579819272122,218
-7.6926,53.28823,2021/11/23 00:00:00+00,Tue 23 Nov 2021,2129,1490,4,3614374,3547390,236400,3850774,3783790,91.0776075954337,89.4933176664032,219
-7.6926,53.28823,2021/11/24 00:00:00+00,Wed 24 Nov 2021,1553,2980,0,3615927,3550370,236400,3852327,3786770,91.1143387888498,89.563799930653,220
-7.6926,53.28823,2021/11/25 00:00:00+00,Thu 25 Nov 2021,869,1015,0,3616796,3551385,236400,3853196,3787785,91.1348921739616,89.5878064736777,221
-7.6926,53.28823,2021/11/26 00:00:00+00,Fri 26 Nov 2021,1148,871,13,3617944,3552256,236413,3854357,3788669,91.1623518748992,89.6087146352874,222
-7.6926,53.28823,2021/11/27 00:00:00+00,Sat 27 Nov 2021,1184,1450,0,3619128,3553706,236413,3855541,3790119,91.1903555664669,89.6430096967512,223
-7.6926,53.28823,2021/11/28 00:00:00+00,Sun 28 Nov 2021,1956,2211,0,3621084,3555917,236413,3857497,3792330,91.2366184217933,89.695303752542,224
-7.6926,53.28823,2021/04/18 23:00:00+00,Mon 19 Apr 2021,6617,2176,0,898057,378996,40,898097,379036,21.2415805624106,8.96487097724842,225
-7.6926,53.28823,2021/04/19 23:00:00+00,Tue 20 Apr 2021,14921,7225,0,912978,386221,40,913018,386261,21.5944885707569,9.13575499040448,226
-7.6926,53.28823,2021/04/20 23:00:00+00,Wed 21 Apr 2021,26520,9765,0,939498,395986,40,939538,396026,22.2217334190473,9.36671449053858,227
-7.6926,53.28823,2021/04/21 23:00:00+00,Thu 22 Apr 2021,31451,12081,0,970949,408067,40,970989,408107,22.9656051280814,9.65245148194874,228
-7.6926,53.28823,2021/04/22 23:00:00+00,Fri 23 Apr 2021,33415,12295,0,1004364,420362,40,1004404,420402,23.7559289065741,9.94324995139562,229
-7.6926,53.28823,2021/04/23 23:00:00+00,Sat 24 Apr 2021,23525,6927,0,1027889,427289,40,1027929,427329,24.3123367141168,10.1070857381267,230
-7.6926,53.28823,2021/04/24 23:00:00+00,Sun 25 Apr 2021,9656,240,0,1037545,427529,40,1037585,427569,24.5407181716995,10.1127621620931,231
-7.6926,53.28823,2021/04/25 23:00:00+00,Mon 26 Apr 2021,15430,2945,0,1052975,430474,40,1053015,430514,24.9056649292079,10.1824166145145,232
-7.6926,53.28823,2021/04/26 23:00:00+00,Tue 27 Apr 2021,25741,7716,1,1078716,438190,41,1078757,438231,25.5145087031405,10.3649372968018,233
-7.6926,53.28823,2021/04/27 23:00:00+00,Wed 28 Apr 2021,25877,8496,1,1104593,446686,42,1104635,446728,26.1265691173208,10.5659063569799,234
-7.6926,53.28823,2021/04/28 23:00:00+00,Thu 29 Apr 2021,31533,11231,0,1136126,457917,42,1136168,457959,26.8723802712101,10.8315393468423,235
-7.6926,53.28823,2021/04/29 23:00:00+00,Fri 30 Apr 2021,35924,13443,0,1172050,471360,42,1172092,471402,27.7220463319185,11.1494900442619,236
-7.6926,53.28823,2021/04/30 23:00:00+00,Sat 01 May 2021,16382,6598,0,1188432,477958,42,1188474,478000,28.1095095711604,11.3055443998057,237
-7.6926,53.28823,2021/05/01 23:00:00+00,Sun 02 May 2021,12310,858,1,1200742,478816,43,1200785,478859,28.4006864688717,11.3258612672522,238
-7.6926,53.28823,2021/05/02 23:00:00+00,Mon 03 May 2021,14100,846,1,1214842,479662,44,1214886,479706,28.7342000286659,11.3458943135004,239
-7.6926,53.28823,2021/05/03 23:00:00+00,Tue 04 May 2021,26444,6692,1,1241286,486354,45,1241331,486399,29.3596709944669,11.5041955868642,240
-7.6926,53.28823,2021/05/04 23:00:00+00,Wed 05 May 2021,31853,13318,62,1273139,499672,107,1273246,499779,30.1145171231694,11.8206562229926,241
-7.6926,53.28823,2021/05/05 23:00:00+00,Thu 06 May 2021,37066,14260,119,1310205,513932,226,1310431,514158,30.9940080614681,12.1607449738814,242
-7.6926,53.28823,2021/05/06 23:00:00+00,Fri 07 May 2021,40344,14951,81,1350549,528883,307,1350856,529190,31.9501307233136,12.5162783283121,243
-7.6926,53.28823,2021/05/07 23:00:00+00,Sat 08 May 2021,25394,6958,2,1375943,535841,309,1376252,536150,32.550790986028,12.6808946233385,244
-7.6926,53.28823,2021/05/08 23:00:00+00,Sun 09 May 2021,19546,864,0,1395489,536705,309,1395798,537014,33.0130884145606,12.7013297496177,245
-7.6926,53.28823,2021/05/09 23:00:00+00,Mon 10 May 2021,28595,4527,154,1424084,541232,463,1424547,541695,33.6930530504393,12.8120436687296,246
-7.6926,53.28823,2021/05/10 23:00:00+00,Tue 11 May 2021,34110,14707,142,1458194,555939,605,1458799,556544,34.5031733575149,13.1632487498859,247
-7.6926,53.28823,2021/05/11 23:00:00+00,Wed 12 May 2021,31029,20807,143,1489223,576746,748,1489971,577494,35.240446223688,13.6587532586221,248
-7.6926,53.28823,2021/05/12 23:00:00+00,Thu 13 May 2021,35763,25367,133,1524986,602113,881,1525867,602994,36.0894500349337,14.2618733050553,249
-7.6926,53.28823,2021/05/13 23:00:00+00,Fri 14 May 2021,37967,27849,221,1562953,629962,1102,1564055,631064,36.9926636950587,14.9257783914623,250
-7.6926,53.28823,2021/05/14 23:00:00+00,Sat 15 May 2021,28613,12339,0,1591566,642301,1102,1592668,643403,37.6694116906898,15.2176175386363,251
-7.6926,53.28823,2021/05/15 23:00:00+00,Sun 16 May 2021,23008,1106,0,1614574,643407,1102,1615676,644509,38.2135915349382,15.243776392415,252
-7.6926,53.28823,2021/05/16 23:00:00+00,Mon 17 May 2021,35179,3857,100,1649753,647264,1202,1650955,648466,39.0480022062368,15.3373664325615,253
-7.6926,53.28823,2021/05/17 23:00:00+00,Tue 18 May 2021,38789,12359,108,1688542,659623,1310,1689852,660933,39.9679849688293,15.632233005851,254
-7.6926,53.28823,2021/05/18 23:00:00+00,Wed 19 May 2021,36759,17471,193,1725301,677094,1503,1726804,678597,40.8419650455273,16.0500178097802,255
-7.6926,53.28823,2021/05/19 23:00:00+00,Thu 20 May 2021,38808,19515,107,1764109,696609,1610,1765719,698219,41.7623735399173,16.5141127725689,256
-7.6926,53.28823,2021/05/20 23:00:00+00,Fri 21 May 2021,25570,23070,14908,1789679,719679,16518,1806197,736197,42.7197497453887,17.4123595617233,257
-7.6926,53.28823,2021/05/21 23:00:00+00,Sat 22 May 2021,16372,10143,13489,1806051,729822,30007,1836058,759829,43.4260151456452,17.9712981082844,258
-7.6926,53.28823,2021/05/22 23:00:00+00,Sun 23 May 2021,8058,5469,10189,1814109,735291,40196,1854305,775487,43.8575889294596,18.3416374685609,259
-7.6926,53.28823,2021/05/23 23:00:00+00,Mon 24 May 2021,22299,8083,8425,1836408,743374,48621,1885029,791995,44.5842658042287,18.7320808303851,260
-7.6926,53.28823,2021/05/24 23:00:00+00,Tue 25 May 2021,30048,16348,3205,1866456,759722,51826,1918282,811548,45.370757996544,19.1945438212835,261
-7.6926,53.28823,2021/05/25 23:00:00+00,Wed 26 May 2021,19663,25284,3026,1886119,785006,54852,1940971,839858,45.9073929272703,19.8641253316569,262
-7.6926,53.28823,2021/05/26 23:00:00+00,Thu 27 May 2021,16721,35839,539,1902840,820845,55391,1958231,876236,46.3156224175227,20.7245292943685,263
-7.6926,53.28823,2021/05/27 23:00:00+00,Fri 28 May 2021,26745,31692,1513,1929585,852537,56904,1986489,909441,46.9839740360368,21.5098862018905,264
-7.6926,53.28823,2021/05/28 23:00:00+00,Sat 29 May 2021,24247,7299,493,1953832,859836,57397,2011229,917233,47.5691187399096,21.6941807666673,265
-7.6926,53.28823,2021/05/29 23:00:00+00,Sun 30 May 2021,24071,1602,182,1977903,861438,57579,2035482,919017,48.1427450334838,21.7363755181511,266
-7.6926,53.28823,2021/05/30 23:00:00+00,Mon 31 May 2021,22270,7207,3409,2000173,868645,60988,2061161,929633,48.7500987461252,21.9874626715995,267
-7.6926,53.28823,2021/05/31 23:00:00+00,Tue 01 Jun 2021,27156,11346,3617,2027329,879991,64605,2091934,944596,49.4779345574542,22.3413640541398,268
-7.6926,53.28823,2021/06/01 23:00:00+00,Wed 02 Jun 2021,18358,20743,3970,2045687,900734,68575,2114262,969309,50.0060312004643,22.9258701603164,269
-7.6926,53.28823,2021/06/02 23:00:00+00,Thu 03 Jun 2021,16416,30531,1951,2062103,931265,70526,2132629,1001791,50.4404431962619,23.6941268406396,270
-7.6926,53.28823,2021/06/03 23:00:00+00,Fri 04 Jun 2021,28729,23158,112,2090832,954423,70638,2161470,1025061,51.122583794661,24.244503447718,271
-7.6926,53.28823,2021/06/04 23:00:00+00,Sat 05 Jun 2021,20680,11347,1,2111512,965770,70639,2182151,1036409,51.6117259782016,24.512903694264,272
-7.6926,53.28823,2021/06/05 23:00:00+00,Sun 06 Jun 2021,19733,3794,7,2131245,969564,70646,2201891,1040210,52.0786118494404,24.6028040588324,273
-7.6926,53.28823,2021/06/06 23:00:00+00,Mon 07 Jun 2021,19526,4389,0,2150771,973953,70646,2221417,1044599,52.5404362426425,24.7066116621184,274
-7.6926,53.28823,2021/06/07 23:00:00+00,Tue 08 Jun 2021,26257,18335,12,2177028,992288,70658,2247686,1062946,53.1617444975348,25.1405506225855,275
-7.6926,53.28823,2021/06/08 23:00:00+00,Wed 09 Jun 2021,32573,19900,141,2209601,1012188,70799,2280400,1082987,53.9354883876922,25.6145556755488,276
-7.6926,53.28823,2021/06/09 23:00:00+00,Thu 10 Jun 2021,27402,27291,234,2237003,1039479,71033,2308036,1110512,54.5891286074266,26.2655705491987,277
-7.6926,53.28823,2021/06/10 23:00:00+00,Fri 11 Jun 2021,26183,32695,0,2263186,1072174,71033,2334219,1143207,55.2084028103975,27.0388650557922,278
-7.6926,53.28823,2021/06/11 23:00:00+00,Sat 12 Jun 2021,11945,19532,75,2275131,1091706,71108,2346239,1162814,55.4926970440495,27.5026052420829,279
-7.6926,53.28823,2021/06/12 23:00:00+00,Sun 13 Jun 2021,8396,18059,807,2283527,1109765,71915,2355442,1181680,55.7103642513956,27.9488194693774,280
-7.6926,53.28823,2021/06/13 23:00:00+00,Mon 14 Jun 2021,15770,31071,9,2299297,1140836,71924,2371221,1212760,56.0835654754218,28.68391637303,281
-7.6926,53.28823,2021/06/14 23:00:00+00,Tue 15 Jun 2021,14415,41263,175,2313712,1182099,72099,2385811,1254198,56.4286447490477,29.6639982743671,282
-7.6926,53.28823,2021/06/15 23:00:00+00,Wed 16 Jun 2021,13148,48072,190,2326860,1230171,72289,2399149,1302460,56.744112010982,30.8054798304831,283
-7.6926,53.28823,2021/06/16 23:00:00+00,Thu 17 Jun 2021,21270,42379,497,2348130,1272550,72786,2420916,1345336,57.2589400129706,31.8195729720857,284
-7.6926,53.28823,2021/06/17 23:00:00+00,Fri 18 Jun 2021,11794,49785,521,2359924,1322335,73307,2433231,1395642,57.5502115177481,33.0093987389824,285
-7.6926,53.28823,2021/06/18 23:00:00+00,Sat 19 Jun 2021,6068,32592,400,2365992,1354927,73707,2439699,1428634,57.7031911436433,33.7897178202343,286
-7.6926,53.28823,2021/06/19 23:00:00+00,Sun 20 Jun 2021,8339,26001,158,2374331,1380928,73865,2448196,1454793,57.9041602038215,34.4084243808086,287
-7.6926,53.28823,2021/06/20 23:00:00+00,Mon 21 Jun 2021,15212,32092,532,2389543,1413020,74397,2463940,1487417,58.2765336160192,35.1800396119786,288
-7.6926,53.28823,2021/06/21 23:00:00+00,Tue 22 Jun 2021,14879,43289,686,2404422,1456309,75083,2479505,1531392,58.6446733620087,36.2201260449942,289
-7.6926,53.28823,2021/06/22 23:00:00+00,Wed 23 Jun 2021,19794,39093,847,2424216,1495402,75930,2500146,1571332,59.1328694748882,37.1647776000742,290
-7.6926,53.28823,2021/06/23 23:00:00+00,Thu 24 Jun 2021,18781,43975,999,2442997,1539377,76929,2519926,1616306,59.6007014167881,38.22849214785,291
-7.6926,53.28823,2021/06/24 23:00:00+00,Fri 25 Jun 2021,14924,49857,784,2457921,1589234,77713,2535634,1666947,59.9722233653909,39.4262412565332,292
-7.6926,53.28823,2021/06/25 23:00:00+00,Sat 26 Jun 2021,8798,30293,451,2466719,1619527,78164,2544883,1697691,60.1909785539972,40.1533911666328,293
-7.6926,53.28823,2021/06/26 23:00:00+00,Sun 27 Jun 2021,8565,30271,32,2475284,1649798,78196,2553480,1727994,60.394312790828,40.8701106476942,294
-7.6926,53.28823,2021/06/27 23:00:00+00,Mon 28 Jun 2021,23989,24359,448,2499273,1674157,78644,2577917,1752801,60.9722910094432,41.4568400199242,295
-7.6926,53.28823,2021/06/28 23:00:00+00,Tue 29 Jun 2021,27856,30694,754,2527129,1704851,79398,2606527,1784249,61.6489680497747,42.2006407736587,296
-7.6926,53.28823,2021/06/29 23:00:00+00,Wed 30 Jun 2021,22252,36498,529,2549381,1741349,79927,2629308,1821276,62.1877789430215,43.0763947328462,297
-7.6926,53.28823,2021/06/30 23:00:00+00,Thu 01 Jul 2021,14583,48031,581,2563964,1789380,80508,2644472,1869888,62.5464343306337,44.2261544072465,298
-7.6926,53.28823,2021/07/01 23:00:00+00,Fri 02 Jul 2021,13339,46935,767,2577303,1836315,81275,2658578,1917590,62.8800661492606,45.3543909741075,299
-7.6926,53.28823,2021/07/02 23:00:00+00,Sat 03 Jul 2021,9096,30154,455,2586399,1866469,81730,2668129,1948199,63.105964171358,46.078347895726,300
-7.6926,53.28823,2021/07/03 23:00:00+00,Sun 04 Jul 2021,6278,27626,196,2592677,1894095,81926,2674603,1976021,63.2590857078524,46.7363873440343,301
-7.6926,53.28823,2021/07/04 23:00:00+00,Mon 05 Jul 2021,15228,33051,5302,2607905,1927146,87228,2695133,2014374,63.7446564746474,47.6435035456363,302
-7.6926,53.28823,2021/07/05 23:00:00+00,Tue 06 Jul 2021,12114,48063,5433,2620019,1975209,92661,2712680,2067870,64.159674021893,48.9087784477535,303
-7.6926,53.28823,2021/07/06 23:00:00+00,Wed 07 Jul 2021,19415,43388,4987,2639434,2018597,97648,2737082,2116245,64.7368244286798,50.052932653487,304
-7.6926,53.28823,2021/07/07 23:00:00+00,Thu 08 Jul 2021,17526,45276,5941,2656960,2063873,103589,2760549,2167462,65.2918604337639,51.2643051796896,305
-7.6926,53.28823,2021/07/08 23:00:00+00,Fri 09 Jul 2021,13281,44772,6491,2670241,2108645,110080,2780321,2218725,65.7595031615316,52.4767656871524,306
-7.6926,53.28823,2021/07/09 23:00:00+00,Sat 10 Jul 2021,8415,23564,4316,2678656,2132209,114396,2793052,2246605,66.0606138011842,53.1361769379193,307
-7.6926,53.28823,2021/07/10 23:00:00+00,Sun 11 Jul 2021,15094,15936,2129,2693750,2148145,116525,2810275,2264670,66.4679681760751,53.5634461002258,308
-7.6926,53.28823,2021/07/11 23:00:00+00,Mon 12 Jul 2021,16917,31407,6034,2710667,2179552,122559,2833226,2302111,67.0107998696315,54.4489918907553,309
-7.6926,53.28823,2021/07/12 23:00:00+00,Tue 13 Jul 2021,19884,36192,8443,2730551,2215744,131002,2861553,2346746,67.6807834600358,55.5046884896786,310
-7.6926,53.28823,2021/07/13 23:00:00+00,Wed 14 Jul 2021,20578,35312,9279,2751129,2251056,140281,2891410,2391337,68.3869542532262,56.5593444108747,311
-7.6926,53.28823,2021/07/14 23:00:00+00,Thu 15 Jul 2021,23386,28449,9521,2774515,2279505,149802,2924317,2429307,69.1652629343233,57.4574019858969,312
-7.6926,53.28823,2021/07/15 23:00:00+00,Fri 16 Jul 2021,23333,27017,9113,2797848,2306522,158915,2956763,2465437,69.9326681510515,58.3119403105098,313
-7.6926,53.28823,2021/07/16 23:00:00+00,Sat 17 Jul 2021,11354,19118,4629,2809202,2325640,163544,2972746,2489184,70.3106943354492,58.8735988102215,314
-7.6926,53.28823,2021/07/17 23:00:00+00,Sun 18 Jul 2021,16737,15593,1907,2825939,2341233,165451,2991390,2506684,70.7516578705747,59.2875047244404,315
-7.6926,53.28823,2021/07/18 23:00:00+00,Mon 19 Jul 2021,24659,18057,6188,2850598,2359290,171639,3022237,2530929,71.4812439126266,59.8609418038824,316
-7.6926,53.28823,2021/07/19 23:00:00+00,Tue 20 Jul 2021,30374,17752,7651,2880972,2377042,179290,3060262,2556332,72.3806023348078,60.4617676289624,317
-7.6926,53.28823,2021/07/20 23:00:00+00,Wed 21 Jul 2021,30095,19460,6830,2911067,2396502,186120,3097187,2582622,73.2539438138095,61.0835725709518,318
-7.6926,53.28823,2021/07/21 23:00:00+00,Thu 22 Jul 2021,33322,15550,6873,2944389,2412052,192993,3137382,2605045,74.2046265693538,61.613916131782,319
-7.6926,53.28823,2021/07/22 23:00:00+00,Fri 23 Jul 2021,26906,20443,5546,2971295,2432495,198539,3169834,2631034,74.9721736966812,62.2286018920467,320
-7.6926,53.28823,2021/07/23 23:00:00+00,Sat 24 Jul 2021,15306,14492,2231,2986601,2446987,200770,3187371,2647757,75.3869547262615,62.6241303836742,321
-7.6926,53.28823,2021/07/24 23:00:00+00,Sun 25 Jul 2021,14625,13453,1016,3001226,2460440,201786,3203012,2662226,75.7568920065071,62.9663477935503,322
-7.6926,53.28823,2021/07/25 23:00:00+00,Mon 26 Jul 2021,23671,17812,3370,3024897,2478252,205156,3230053,2683408,76.396459425158,63.4673395121208,323
-7.6926,53.28823,2021/07/26 23:00:00+00,Tue 27 Jul 2021,25292,23441,3606,3050189,2501693,208762,3258951,2710455,77.0799481742492,64.1070488413709,324
-7.6926,53.28823,2021/07/27 23:00:00+00,Wed 28 Jul 2021,23258,24910,3225,3073447,2526603,211987,3285434,2738590,77.7063179071782,64.7724912926022,325
-7.6926,53.28823,2021/07/28 23:00:00+00,Thu 29 Jul 2021,19113,27493,2920,3092560,2554096,214907,3307467,2769003,78.2274372790629,65.4918124679814,326
-7.6926,53.28823,2021/07/29 23:00:00+00,Fri 30 Jul 2021,21767,22542,2080,3114327,2576638,216987,3331314,2793625,78.7914609554273,66.074166263404,327
-7.6926,53.28823,2021/07/30 23:00:00+00,Sat 31 Jul 2021,13624,12183,883,3127951,2588821,217870,3345821,2806691,79.1345771324314,66.3832002448431,328
-7.6926,53.28823,2021/07/31 23:00:00+00,Sun 01 Aug 2021,10977,9134,355,3138928,2597955,218225,3357153,2816180,79.402598950713,66.6076318574158,329
-7.6926,53.28823,2021/08/01 23:00:00+00,Mon 02 Aug 2021,14872,15627,393,3153800,2613582,218618,3372418,2832200,79.7636431667445,66.986533157175,330
-7.6926,53.28823,2021/08/02 23:00:00+00,Tue 03 Aug 2021,17189,25091,1084,3170989,2638673,219702,3390691,2858375,80.1958318964885,67.6056181460137,331
-7.6926,53.28823,2021/08/03 23:00:00+00,Wed 04 Aug 2021,21942,16929,1554,3192931,2655602,221256,3414187,2876858,80.751553802802,68.0427737467284,332
-7.6926,53.28823,2021/08/04 23:00:00+00,Thu 05 Aug 2021,13372,29702,1401,3206303,2685304,222657,3428960,2907961,81.1009613497022,68.7784146410111,333
-7.6926,53.28823,2021/08/05 23:00:00+00,Fri 06 Aug 2021,12028,24420,922,3218331,2709724,223579,3441910,2933303,81.4072517262242,69.377797708333,334
-7.6926,53.28823,2021/08/06 23:00:00+00,Sat 07 Aug 2021,6251,8196,559,3224582,2717920,224138,3448720,2942058,81.5683202562716,69.5848689242751,335
-7.6926,53.28823,2021/08/07 23:00:00+00,Sun 08 Aug 2021,8546,11786,139,3233128,2729706,224277,3457405,2953983,81.7737358485568,69.8669162401071,336
