X,Y,VaccinationDate,VaccineText,Dose1,Dose2,SingleDose,Dose1Cum,Dose2Cum,SingleDoseCum,PartiallyVacc,FullyVacc,PartialPercent,FullyPercent,ObjectId
-7.6926,53.28823,2020/12/28 00:00:00+00,Mon 28 Dec 2020,204,17,0,204,17,0,204,17,0.00433221552262553,0.000361017960218794,1
-7.6926,53.28823,2021/12/23 00:00:00+00,Thu 23 Dec 2021,959,1341,0,3677834,3622921,240209,3918043,3863130,83.2049348182073,82.0387830976488,2
-7.6926,53.28823,2020/12/29 00:00:00+00,Tue 29 Dec 2020,74,2,0,278,19,0,278,19,0.00590370546710733,0.000403490661421005,3
-7.6926,53.28823,2021/12/24 00:00:00+00,Fri 24 Dec 2021,105,140,0,3677939,3623061,240209,3918148,3863270,83.2071646350204,82.0417561867329,4
-7.6926,53.28823,2020/12/30 00:00:00+00,Wed 30 Dec 2020,1057,1,0,1335,20,0,1335,20,0.0283505280524759,0.00042472701202211,5
-7.6926,53.28823,2021/12/25 00:00:00+00,Sat 25 Dec 2021,2,0,0,3677941,3623061,240209,3918150,3863270,83.2072071077216,82.0417561867329,6
-7.6926,53.28823,2020/12/31 00:00:00+00,Thu 31 Dec 2020,1031,1,0,2366,21,0,2366,21,0.0502452055222157,0.000445963362623216,7
-7.6926,53.28823,2021/12/26 00:00:00+00,Sun 26 Dec 2021,10,7,0,3677951,3623068,240209,3918160,3863277,83.2074194712276,82.0419048411871,8
-7.6926,53.28823,2021/12/27 00:00:00+00,Mon 27 Dec 2021,388,582,0,3678339,3623650,240209,3918548,3863859,83.2156591752608,82.054264397237,9
-7.6926,53.28823,2021/01/01 00:00:00+00,Fri 01 Jan 2021,808,0,0,3174,21,0,3174,21,0.0674041768079089,0.000445963362623216,10
-7.6926,53.28823,2021/12/28 00:00:00+00,Tue 28 Dec 2021,465,738,0,3678804,3624388,240209,3919013,3864597,83.2255340782904,82.0699368239806,11
-7.6926,53.28823,2021/01/02 00:00:00+00,Sat 02 Jan 2021,1015,0,0,4189,21,0,4189,21,0.088959072668031,0.000445963362623216,12
-7.6926,53.28823,2021/12/29 00:00:00+00,Wed 29 Dec 2021,1079,1284,0,3679883,3625672,240209,3920092,3865881,83.2484481005889,82.0972042981524,13
-7.6926,53.28823,2021/01/03 00:00:00+00,Sun 03 Jan 2021,20,2,1,4209,23,1,4210,24,0.0894050360306543,0.000509672414426533,14
-7.6926,53.28823,2021/12/30 00:00:00+00,Thu 30 Dec 2021,1072,1176,1,3680955,3626848,240210,3921165,3867058,83.2712347047839,82.1221994828099,15
-7.6926,53.28823,2021/01/04 00:00:00+00,Mon 04 Jan 2021,1186,3,0,5395,26,1,5396,27,0.114591347843565,0.000573381466229849,16
-7.6926,53.28823,2021/12/31 00:00:00+00,Fri 31 Dec 2021,721,1668,0,3681676,3628516,240210,3921886,3868726,83.2865461135673,82.1576217156126,17
-7.6926,53.28823,2021/01/05 00:00:00+00,Tue 05 Jan 2021,3524,10,0,8919,36,1,8920,37,0.189428247361861,0.000785744972240904,18
-7.6926,53.28823,2022/01/01 00:00:00+00,Sat 01 Jan 2022,69,95,0,3681745,3628611,240210,3921955,3868821,83.2880114217588,82.1596391689197,19
-7.6926,53.28823,2021/01/06 00:00:00+00,Wed 06 Jan 2021,6772,8,0,15691,44,1,15692,45,0.333240813632548,0.000955635777049748,20
-7.6926,53.28823,2022/01/02 00:00:00+00,Sun 02 Jan 2022,271,623,0,3682016,3629234,240210,3922226,3869444,83.2937664727717,82.1728694153442,21
-7.6926,53.28823,2021/01/07 00:00:00+00,Thu 07 Jan 2021,11719,8,0,27410,52,1,27411,53,0.582109606326903,0.00112552658185859,22
-7.6926,53.28823,2022/01/03 00:00:00+00,Mon 03 Jan 2022,3630,717,1,3685646,3629951,240211,3925857,3870162,83.3708756618043,82.1881171150758,23
-7.6926,53.28823,2021/01/08 00:00:00+00,Fri 08 Jan 2021,12675,5,0,40085,57,1,40086,58,0.851280350195916,0.00123170833486412,24
-7.6926,53.28823,2021/04/26 23:00:00+00,Tue 27 Apr 2021,25909,7803,9,1088330,441537,248,1088578,441785,23.1174240646502,9.3819011503094,25
-7.6926,53.28823,2022/01/04 00:00:00+00,Tue 04 Jan 2022,1192,763,0,3686838,3630714,240211,3927049,3870925,83.3961893917208,82.2043204505844,26
-7.6926,53.28823,2021/01/09 00:00:00+00,Sat 09 Jan 2021,8072,6,0,48157,63,1,48158,64,1.02270017224804,0.00135912643847075,27
-7.6926,53.28823,2022/01/05 00:00:00+00,Wed 05 Jan 2022,2144,884,0,3688982,3631598,240211,3929193,3871809,83.4417201274096,82.2230933845158,28
-7.6926,53.28823,2021/04/27 23:00:00+00,Wed 28 Apr 2021,26019,8584,5,1114349,450121,253,1114602,450374,23.6700788526934,9.5643001656223,29
-7.6926,53.28823,2021/01/10 00:00:00+00,Sun 10 Jan 2021,4777,4,1,52934,67,2,52936,69,1.12416745542012,0.00146530819147628,30
-7.6926,53.28823,2022/01/06 00:00:00+00,Thu 06 Jan 2022,2465,1668,0,3691447,3633266,240211,3931658,3873477,83.4940677316413,82.2585156173184,31
-7.6926,53.28823,2021/04/28 23:00:00+00,Thu 29 Apr 2021,31685,11329,6,1146034,461450,259,1146293,461709,24.3430800395931,9.80501419968583,32
-7.6926,53.28823,2022/01/07 00:00:00+00,Fri 07 Jan 2022,4858,765,0,3696305,3634031,240211,3936516,3874242,83.5972339228615,82.2747614255283,33
-7.6926,53.28823,2021/01/11 00:00:00+00,Mon 11 Jan 2021,8336,7,0,61270,74,2,61272,76,1.30119367403094,0.00161396264568402,34
-7.6926,53.28823,2021/04/29 23:00:00+00,Fri 30 Apr 2021,36113,13518,8,1182147,474968,267,1182414,475235,25.1101582596556,10.0922570779164,35
-7.6926,53.28823,2022/01/08 00:00:00+00,Sat 08 Jan 2022,9792,732,1,3706097,3634763,240212,3946309,3874975,83.8052015042981,82.2903276705189,36
-7.6926,53.28823,2021/01/12 00:00:00+00,Tue 12 Jan 2021,8877,9,0,70147,83,2,70149,85,1.48970875831695,0.00180508980109397,37
-7.6926,53.28823,2021/04/30 23:00:00+00,Sat 01 May 2021,16557,6685,18,1198704,481653,285,1198989,481938,25.4621507708689,10.2346043359956,38
-7.6926,53.28823,2022/01/09 00:00:00+00,Sun 09 Jan 2022,7114,662,0,3713211,3635425,240212,3953423,3875637,83.9562769024744,82.3043861346168,39
-7.6926,53.28823,2021/01/13 00:00:00+00,Wed 13 Jan 2021,9876,6,0,80023,89,2,80025,91,1.69943895685347,0.0019325079047006,40
-7.6926,53.28823,2021/05/01 23:00:00+00,Sun 02 May 2021,12433,907,14,1211137,482560,299,1211436,482859,25.7264796268009,10.2541630148992,41
-7.6926,53.28823,2022/01/10 00:00:00+00,Mon 10 Jan 2022,6658,488,0,3719869,3635913,240212,3960081,3876125,84.0976685247766,82.3147494737101,42
-7.6926,53.28823,2021/01/14 00:00:00+00,Thu 14 Jan 2021,8076,4,0,88099,93,2,88101,95,1.870943724308,0.00201745330710502,43
-7.6926,53.28823,2021/05/02 23:00:00+00,Mon 03 May 2021,14244,914,21,1225381,483474,320,1225701,483794,26.0294161681256,10.2740190027112,44
-7.6926,53.28823,2022/01/11 00:00:00+00,Tue 11 Jan 2022,4776,1343,1,3724645,3637256,240213,3964858,3877469,84.199114571598,82.343291128918,45
-7.6926,53.28823,2021/01/15 00:00:00+00,Fri 15 Jan 2021,7685,2,0,95784,95,2,95786,97,2.03414507867749,0.00205992600830724,46
-7.6926,53.28823,2021/05/03 23:00:00+00,Tue 04 May 2021,26638,6779,9,1252019,490253,329,1252348,490582,26.5953012025933,10.4181713505915,47
-7.6926,53.28823,2022/01/12 00:00:00+00,Wed 12 Jan 2022,7560,887,1,3732205,3638143,240214,3972419,3878357,84.359682618493,82.3621490082518,48
-7.6926,53.28823,2021/01/16 00:00:00+00,Sat 16 Jan 2021,5226,3,0,101010,98,2,101012,100,2.14512624691887,0.00212363506011055,49
-7.6926,53.28823,2021/05/04 23:00:00+00,Wed 05 May 2021,32083,13449,69,1284102,503702,398,1284500,504100,27.27809234712,10.7052443380173,50
-7.6926,53.28823,2021/08/24 23:00:00+00,Wed 25 Aug 2021,9403,19479,312,3451139,3111294,235721,3686860,3347015,78.2954515771919,71.0783840071592,51
-7.6926,53.28823,2021/05/05 23:00:00+00,Thu 06 May 2021,37260,14373,132,1321362,518075,530,1321892,518605,28.0721619687966,11.0132776034863,52
-7.6926,53.28823,2021/05/06 23:00:00+00,Fri 07 May 2021,40581,15065,97,1361943,533140,627,1362570,533767,28.9360142385484,11.3352631513003,53
-7.6926,53.28823,2021/05/07 23:00:00+00,Sat 08 May 2021,25600,7035,10,1387543,540175,637,1388180,540812,29.4798771774427,11.4848732412851,54
-7.6926,53.28823,2021/05/08 23:00:00+00,Sun 09 May 2021,19660,920,4,1407203,541095,641,1407844,541736,29.8974687756628,11.5044956292405,55
-7.6926,53.28823,2021/05/09 23:00:00+00,Mon 10 May 2021,28816,4631,170,1436019,545726,811,1436830,546537,30.5130256341864,11.6064513484764,56
-7.6926,53.28823,2021/05/10 23:00:00+00,Tue 11 May 2021,33912,14806,152,1469931,560532,963,1470894,561495,31.2364206810625,11.9241046807677,57
-7.6926,53.28823,2021/05/11 23:00:00+00,Wed 12 May 2021,31273,20928,169,1501204,581460,1132,1502336,582592,31.9041340166625,12.3721279693993,58
-7.6926,53.28823,2021/05/12 23:00:00+00,Thu 13 May 2021,35983,25478,151,1537187,606938,1283,1538470,608221,32.6714883092828,12.916394398955,59
-7.6926,53.28823,2021/05/13 23:00:00+00,Fri 14 May 2021,38202,27958,235,1575389,634896,1518,1576907,636414,33.4877499173375,13.515110831452,60
-7.6926,53.28823,2021/05/14 23:00:00+00,Sat 15 May 2021,28840,12441,20,1604229,647337,1538,1605767,648875,34.1006309956854,13.7797369962923,61
-7.6926,53.28823,2021/05/15 23:00:00+00,Sun 16 May 2021,23160,1166,9,1627389,648503,1547,1628936,650050,34.5926560027624,13.8046897082486,62
-7.6926,53.28823,2021/05/16 23:00:00+00,Mon 17 May 2021,35375,3935,114,1662764,652438,1661,1664425,654099,35.3463128492451,13.8906756918325,63
-7.6926,53.28823,2021/05/17 23:00:00+00,Tue 18 May 2021,39029,12482,124,1701793,664920,1785,1703578,666705,36.1777796843301,14.1583811275101,64
-7.6926,53.28823,2021/05/18 23:00:00+00,Wed 19 May 2021,37007,17588,204,1738800,682508,1989,1740789,684497,36.9680055265479,14.5362182774049,65
-7.6926,53.28823,2021/05/19 23:00:00+00,Thu 20 May 2021,39062,19641,134,1777862,702149,2123,1779985,704272,37.8003855247088,14.9561671105418,66
-7.6926,53.28823,2021/05/20 23:00:00+00,Fri 21 May 2021,25813,23246,14933,1803675,725395,17056,1820731,742451,38.6656818663015,15.7669497401414,67
-7.6926,53.28823,2021/05/21 23:00:00+00,Sat 22 May 2021,16575,10245,13522,1820250,735640,30578,1850828,766218,39.3048323103429,16.2716740848779,68
-7.6926,53.28823,2021/05/22 23:00:00+00,Sun 23 May 2021,8206,5518,10204,1828456,741158,40782,1869238,781940,39.6957935249093,16.6055519890285,69
-7.6926,53.28823,2021/05/23 23:00:00+00,Mon 24 May 2021,22525,8206,8448,1850981,749364,49230,1900211,798594,40.3535470120773,16.9592221719393,70
-7.6926,53.28823,2021/05/24 23:00:00+00,Tue 25 May 2021,30300,16479,3221,1881281,765843,52451,1933732,818294,41.065410720577,17.377578278781,71
-7.6926,53.28823,2021/05/25 23:00:00+00,Wed 26 May 2021,19947,25382,3048,1901228,791225,55499,1956727,846724,41.5537406026494,17.9813277263705,72
-7.6926,53.28823,2021/05/26 23:00:00+00,Thu 27 May 2021,16976,36014,551,1918204,827239,56050,1974254,883289,41.925950119635,18.7578348860999,73
-7.6926,53.28823,2021/05/27 23:00:00+00,Fri 28 May 2021,27006,31812,1558,1945210,859051,57608,2002818,916659,42.532545238205,19.4664919056588,74
-7.6926,53.28823,2021/05/28 23:00:00+00,Sat 29 May 2021,24450,7381,533,1969660,866432,58141,2027801,924573,43.0630929852724,19.6345563843159,75
-7.6926,53.28823,2021/05/29 23:00:00+00,Sun 30 May 2021,24222,1670,209,1993882,868102,58350,2052232,926452,43.581918266808,19.6744594870954,76
-7.6926,53.28823,2021/05/30 23:00:00+00,Mon 31 May 2021,22551,7314,3441,2016433,875416,61791,2078224,937207,44.1338934916319,19.9028564378103,77
-7.6926,53.28823,2021/05/31 23:00:00+00,Tue 01 Jun 2021,27496,11505,3650,2043929,886921,65441,2109370,952362,44.795320867454,20.2246933311701,78
-7.6926,53.28823,2021/06/01 23:00:00+00,Wed 02 Jun 2021,18657,20879,4005,2062586,907800,69446,2132032,977246,45.2765790447762,20.753138679528,79
-7.6926,53.28823,2021/06/02 23:00:00+00,Thu 03 Jun 2021,16644,30697,1974,2079230,938497,71420,2150650,1009917,45.6719574202676,21.4469514900167,80
-7.6926,53.28823,2021/06/03 23:00:00+00,Fri 04 Jun 2021,28973,23335,150,2108203,961832,71570,2179773,1033402,46.2904236588236,21.9456871838836,81
-7.6926,53.28823,2021/06/04 23:00:00+00,Sat 05 Jun 2021,20929,11479,33,2129132,973311,71603,2200735,1044914,46.735580040124,22.1901600520036,82
-7.6926,53.28823,2021/06/05 23:00:00+00,Sun 06 Jun 2021,19908,3894,40,2149040,977205,71643,2220683,1048848,47.1592027619148,22.2737038552683,83
-7.6926,53.28823,2021/06/06 23:00:00+00,Mon 07 Jun 2021,19774,4568,40,2168814,981773,71683,2240497,1053456,47.5799798127251,22.3715609588382,84
-7.6926,53.28823,2021/06/07 23:00:00+00,Tue 08 Jun 2021,26370,18333,41,2195184,1000106,71724,2266908,1071830,48.1408530684509,22.7617576647829,85
-7.6926,53.28823,2021/06/08 23:00:00+00,Wed 09 Jun 2021,32755,20094,172,2227939,1020200,71896,2299835,1092096,48.8401023846935,23.1921335460649,86
-7.6926,53.28823,2021/06/09 23:00:00+00,Thu 10 Jun 2021,27645,27477,268,2255584,1047677,72164,2327748,1119841,49.4328726390222,23.7813360934926,87
-7.6926,53.28823,2021/06/10 23:00:00+00,Fri 11 Jun 2021,26399,32882,40,2281983,1080559,72204,2354187,1152763,49.9943405125648,24.4804792279822,88
-7.6926,53.28823,2021/06/11 23:00:00+00,Sat 12 Jun 2021,12182,19708,103,2294165,1100267,72307,2366472,1172574,50.2552290796994,24.9011925697407,89
-7.6926,53.28823,2021/06/12 23:00:00+00,Sun 13 Jun 2021,8528,18159,829,2302693,1118426,73136,2375829,1191562,50.4539376122739,25.3044283949545,90
-7.6926,53.28823,2021/06/13 23:00:00+00,Mon 14 Jun 2021,15989,31290,45,2318682,1149716,73181,2391863,1222897,50.7944412578121,25.9698694410401,91
-7.6926,53.28823,2021/06/14 23:00:00+00,Tue 15 Jun 2021,14665,41561,201,2333347,1191277,73382,2406729,1264659,51.1101408458481,26.8567419148435,92
-7.6926,53.28823,2021/06/15 23:00:00+00,Wed 16 Jun 2021,13425,48370,211,2346772,1239647,73593,2420365,1313240,51.3997197226448,27.8884250633958,93
-7.6926,53.28823,2021/06/16 23:00:00+00,Thu 17 Jun 2021,21541,42658,534,2368313,1282305,74127,2442440,1356432,51.8685121621642,28.8056655185588,94
-7.6926,53.28823,2021/06/17 23:00:00+00,Fri 18 Jun 2021,11985,50025,548,2380298,1332330,74675,2454973,1407005,52.1346673442478,29.8796514775085,95
-7.6926,53.28823,2021/06/18 23:00:00+00,Sat 19 Jun 2021,6289,32778,431,2386587,1365108,75106,2461693,1440214,52.2773756202873,30.5848894446206,96
-7.6926,53.28823,2021/06/19 23:00:00+00,Sun 20 Jun 2021,8493,26130,173,2395080,1391238,75279,2470359,1466517,52.4614098345964,31.1434691744815,97
-7.6926,53.28823,2021/06/20 23:00:00+00,Mon 21 Jun 2021,15439,32312,568,2410519,1423550,75847,2486366,1499397,52.8013400986683,31.8417203822458,98
-7.6926,53.28823,2021/06/21 23:00:00+00,Tue 22 Jun 2021,15104,43516,716,2425623,1467066,76563,2502186,1543629,53.1372991651778,32.7810466420339,99
-7.6926,53.28823,2021/06/22 23:00:00+00,Wed 23 Jun 2021,20056,39366,878,2445679,1506432,77441,2523120,1583873,53.5818609286614,33.6356823356248,100
-7.6926,53.28823,2021/06/23 23:00:00+00,Thu 24 Jun 2021,18988,44240,1030,2464667,1550672,78471,2543138,1629143,54.0069701949943,34.5970519273368,101
-7.6926,53.28823,2021/06/24 23:00:00+00,Fri 25 Jun 2021,15174,50106,834,2479841,1600778,79305,2559146,1680083,54.3469216954168,35.6788316269572,102
-7.6926,53.28823,2021/06/25 23:00:00+00,Sat 26 Jun 2021,9019,30530,497,2488860,1631308,79802,2568662,1711110,54.5490068077369,36.3377318770577,103
-7.6926,53.28823,2021/06/26 23:00:00+00,Sun 27 Jun 2021,8706,30453,55,2497566,1661761,79857,2577423,1741618,54.7350584753532,36.9856104611962,104
-7.6926,53.28823,2021/06/27 23:00:00+00,Mon 28 Jun 2021,24195,24620,515,2521761,1686381,80372,2602133,1766753,55.2598086987065,37.519386133555,105
-7.6926,53.28823,2021/06/28 23:00:00+00,Tue 29 Jun 2021,28117,30990,805,2549878,1717371,81177,2631055,1798548,55.8740064307917,38.1945959009171,106
-7.6926,53.28823,2021/06/29 23:00:00+00,Wed 30 Jun 2021,22528,36836,575,2572406,1754207,81752,2654158,1835959,56.364629838729,38.9890690132551,107
-7.6926,53.28823,2021/06/30 23:00:00+00,Thu 01 Jul 2021,14948,48291,633,2587354,1802498,82385,2669739,1884883,56.6955134174449,40.0280362300636,108
-7.6926,53.28823,2021/07/01 23:00:00+00,Fri 02 Jul 2021,13619,47229,812,2600973,1849727,83197,2684170,1932924,57.0019751929694,41.0482517492913,109
-7.6926,53.28823,2021/07/02 23:00:00+00,Sat 03 Jul 2021,9286,30450,503,2610259,1880177,83700,2693959,1963877,57.2098578290036,41.7055805094473,110
-7.6926,53.28823,2021/07/03 23:00:00+00,Sun 04 Jul 2021,6417,27762,230,2616676,1907939,83930,2700606,1991869,57.3510158514492,42.3000284354735,111
-7.6926,53.28823,2021/07/04 23:00:00+00,Mon 05 Jul 2021,15552,33407,5333,2632228,1941346,89263,2721491,2030609,57.7945370337533,43.1227246577603,112
-7.6926,53.28823,2021/07/05 23:00:00+00,Tue 06 Jul 2021,12368,48263,5480,2644596,1989609,94743,2739339,2084352,58.1735634192818,44.2640298481155,113
-7.6926,53.28823,2021/07/06 23:00:00+00,Wed 07 Jul 2021,19654,43727,5051,2664250,2033336,99794,2764044,2133130,58.6982074608821,45.2998965577362,114
-7.6926,53.28823,2021/07/07 23:00:00+00,Thu 08 Jul 2021,17727,45564,5988,2681977,2078900,105782,2787759,2184682,59.2018275153873,46.3946729039244,115
-7.6926,53.28823,2021/07/08 23:00:00+00,Fri 09 Jul 2021,13489,45076,6524,2695466,2123976,112306,2807772,2236282,59.6268305999672,47.4904685949415,116
-7.6926,53.28823,2021/07/09 23:00:00+00,Sat 10 Jul 2021,8596,23841,4359,2704062,2147817,116665,2820727,2264482,59.9019475220046,48.0893336818926,117
-7.6926,53.28823,2021/07/10 23:00:00+00,Sun 11 Jul 2021,15209,16094,2148,2719271,2163911,118813,2838084,2282724,60.270546859388,48.476727189558,118
-7.6926,53.28823,2021/07/11 23:00:00+00,Mon 12 Jul 2021,17071,31715,6086,2736342,2195626,124899,2861241,2320525,60.7623170302578,49.2794824786304,119
-7.6926,53.28823,2021/07/12 23:00:00+00,Tue 13 Jul 2021,20065,36526,8480,2756407,2232152,133379,2889786,2365531,61.3685086581663,50.2352456737837,120
-7.6926,53.28823,2021/07/13 23:00:00+00,Wed 14 Jul 2021,20760,35658,9327,2777167,2267810,142706,2919873,2410516,62.0074467387018,51.1905629055745,121
-7.6926,53.28823,2021/07/14 23:00:00+00,Thu 15 Jul 2021,23581,28794,9569,2800748,2296604,152275,2953023,2448879,62.7114317611284,52.0052530236847,122
-7.6926,53.28823,2021/07/15 23:00:00+00,Fri 16 Jul 2021,23507,27370,9157,2824255,2323974,161432,2985687,2485406,63.4050959171629,52.7809532020913,123
-7.6926,53.28823,2021/07/16 23:00:00+00,Sat 17 Jul 2021,11466,19396,4671,2835721,2343370,166103,3001824,2509473,63.747786906813,53.2920484520081,124
-7.6926,53.28823,2021/07/17 23:00:00+00,Sun 18 Jul 2021,16831,15781,1924,2852552,2359151,168027,3020579,2527178,64.1460746623367,53.6680380394007,125
-7.6926,53.28823,2021/07/18 23:00:00+00,Mon 19 Jul 2021,24842,18381,6238,2877394,2377532,174265,3051659,2551797,64.8061004390191,54.1908557548493,126
-7.6926,53.28823,2021/07/19 23:00:00+00,Tue 20 Jul 2021,30536,18128,7690,2907930,2395660,181955,3089885,2577615,65.6178811770969,54.7391358546686,127
-7.6926,53.28823,2021/07/20 23:00:00+00,Wed 21 Jul 2021,30308,19796,6879,2938238,2415456,188834,3127072,2604290,66.4075973469002,55.3056155069531,128
-7.6926,53.28823,2021/07/21 23:00:00+00,Thu 22 Jul 2021,33496,15889,6929,2971734,2431345,195763,3167497,2627108,67.2660768199499,55.7901865549691,129
-7.6926,53.28823,2021/07/22 23:00:00+00,Fri 23 Jul 2021,27053,20777,5608,2998787,2452122,201371,3200158,2653493,67.9596772669326,56.3505076655793,130
-7.6926,53.28823,2021/07/23 23:00:00+00,Sat 24 Jul 2021,15410,14771,2264,3014197,2466893,203635,3217832,2670528,68.3350085274566,56.7122688980691,131
-7.6926,53.28823,2021/07/24 23:00:00+00,Sun 25 Jul 2021,14692,13617,1037,3028889,2480510,204672,3233561,2685182,68.6690350860614,57.0234663797777,132
-7.6926,53.28823,2021/07/25 23:00:00+00,Mon 26 Jul 2021,23792,18236,3415,3052681,2498746,208087,3260768,2706833,69.2468124768656,57.4832546066423,133
-7.6926,53.28823,2021/07/26 23:00:00+00,Tue 27 Jul 2021,25462,23841,3661,3078143,2522587,211748,3289891,2734335,69.8652787154216,58.0672967208739,134
-7.6926,53.28823,2021/07/27 23:00:00+00,Wed 28 Jul 2021,23399,25234,3255,3101542,2547821,215003,3316545,2762824,70.4313124043435,58.6722991131488,135
-7.6926,53.28823,2021/07/28 23:00:00+00,Thu 29 Jul 2021,19225,27810,2953,3120767,2575631,217956,3338723,2793587,70.9022921879748,59.3255929666906,136
-7.6926,53.28823,2021/07/29 23:00:00+00,Fri 30 Jul 2021,21915,22885,2113,3142682,2598516,220069,3362751,2818585,71.4125592202182,59.856459259017,137
-7.6926,53.28823,2021/07/30 23:00:00+00,Sat 31 Jul 2021,13713,12434,905,3156395,2610950,220974,3377369,2831924,71.7229921933052,60.1397309396852,138
-7.6926,53.28823,2021/07/31 23:00:00+00,Sun 01 Aug 2021,11075,9287,368,3167470,2620237,221342,3388812,2841579,71.9659997532336,60.3447679047388,139
-7.6926,53.28823,2021/08/01 23:00:00+00,Mon 02 Aug 2021,14984,15953,423,3182454,2636190,221765,3404219,2857955,72.2931882069448,60.6925343821825,140
-7.6926,53.28823,2021/08/02 23:00:00+00,Tue 03 Aug 2021,17306,25394,1104,3199760,2661584,222869,3422629,2884453,72.6841494215112,61.2552552004106,141
-7.6926,53.28823,2021/08/03 23:00:00+00,Wed 04 Aug 2021,22071,17240,1571,3221831,2678824,224440,3446271,2903264,73.1862192224225,61.654732191568,142
-7.6926,53.28823,2021/08/04 23:00:00+00,Thu 05 Aug 2021,13497,29988,1420,3235328,2708812,225860,3461188,2934672,73.5030018643392,62.3217234912475,143
-7.6926,53.28823,2021/08/05 23:00:00+00,Fri 06 Aug 2021,12167,24701,946,3247495,2733513,226806,3474301,2960319,73.7814741297715,62.8663721751141,144
-7.6926,53.28823,2021/08/06 23:00:00+00,Sat 07 Aug 2021,6316,8414,580,3253811,2741927,227386,3481197,2969313,73.9279200035167,63.0573719124204,145
-7.6926,53.28823,2021/08/07 23:00:00+00,Sun 08 Aug 2021,8604,11938,153,3262415,2753865,227539,3489954,2981404,74.1138867257306,63.3141406275384,146
-7.6926,53.28823,2021/08/08 23:00:00+00,Mon 09 Aug 2021,5513,22975,597,3267928,2776840,228136,3496064,3004976,74.2436408279034,63.8147238839077,147
-7.6926,53.28823,2021/08/09 23:00:00+00,Tue 10 Aug 2021,9318,25939,709,3277246,2802779,228845,3506091,3031624,74.4565777153807,64.3806301547259,148
-7.6926,53.28823,2021/08/10 23:00:00+00,Wed 11 Aug 2021,6983,31190,656,3284229,2833969,229501,3513730,3063470,74.6188021976225,65.0569229759687,149
-7.6926,53.28823,2021/08/11 23:00:00+00,Thu 12 Aug 2021,6733,38239,858,3290962,2872208,230359,3521321,3102567,74.7800073350355,65.8872005754202,150
-7.6926,53.28823,2021/08/12 23:00:00+00,Fri 13 Aug 2021,10895,28195,864,3301857,2900403,231223,3533080,3131626,75.0297255817539,66.5043076875377,151
-7.6926,53.28823,2021/08/13 23:00:00+00,Sat 14 Aug 2021,18113,5813,277,3319970,2906216,231500,3551470,3137716,75.4202620693082,66.6336370626984,152
-7.6926,53.28823,2021/08/14 23:00:00+00,Sun 15 Aug 2021,16990,3703,49,3336960,2909919,231549,3568509,3141468,75.7821082472005,66.7133158501538,153
-7.6926,53.28823,2021/08/15 23:00:00+00,Mon 16 Aug 2021,10161,23087,382,3347121,2933006,231931,3579052,3164937,76.0060030915879,67.2117117624111,154
-7.6926,53.28823,2021/08/16 23:00:00+00,Tue 17 Aug 2021,12844,26820,524,3359965,2959826,232455,3592420,3192281,76.2898906264235,67.7923985332477,155
-7.6926,53.28823,2021/08/17 23:00:00+00,Wed 18 Aug 2021,15209,25734,656,3375174,2985560,233111,3608285,3218671,76.62680532871,68.3528258256109,156
-7.6926,53.28823,2021/08/18 23:00:00+00,Thu 19 Aug 2021,11344,25657,539,3386518,3011217,233650,3620168,3244867,76.879156882903,68.9091332659575,157
-7.6926,53.28823,2021/08/19 23:00:00+00,Fri 20 Aug 2021,14822,22202,684,3401340,3033419,234334,3635674,3267753,77.2084477353237,69.3951483858144,158
-7.6926,53.28823,2021/08/20 23:00:00+00,Sat 21 Aug 2021,11859,7946,243,3413199,3041365,234577,3647776,3275942,77.4654500502983,69.5690528608868,159
-7.6926,53.28823,2021/08/21 23:00:00+00,Sun 22 Aug 2021,8000,12236,161,3421199,3053601,234738,3655937,3288339,77.6387599075539,69.8323198992887,160
-7.6926,53.28823,2021/08/22 23:00:00+00,Mon 23 Aug 2021,10847,15334,288,3432046,3068935,235026,3667072,3303961,77.8752266714972,70.1640741683792,161
-7.6926,53.28823,2021/08/23 23:00:00+00,Tue 24 Aug 2021,9690,22880,383,3441736,3091815,235409,3677145,3327224,78.0891404311022,70.6580953924127,162
-7.6926,53.28823,2021/01/17 00:00:00+00,Sun 17 Jan 2021,1109,5,0,102119,103,2,102121,105,2.1686773597355,0.00222981681311608,163
-7.6926,53.28823,2022/01/13 00:00:00+00,Thu 13 Jan 2022,7329,789,0,3739534,3638932,240214,3979748,3879146,84.5153238320485,82.3789044888761,164
-7.6926,53.28823,2021/01/18 00:00:00+00,Mon 18 Jan 2021,8704,7,1,110823,110,3,110826,113,2.35353979171812,0.00239970761792492,165
-7.6926,53.28823,2021/08/25 23:00:00+00,Thu 26 Aug 2021,8562,19393,365,3459701,3130687,236086,3695787,3366773,78.485028479008,71.4979718223358,166
-7.6926,53.28823,2022/01/14 00:00:00+00,Fri 14 Jan 2022,10726,819,0,3750260,3639751,240214,3990474,3879965,84.743104928596,82.3962970600184,167
-7.6926,53.28823,2021/01/19 00:00:00+00,Tue 19 Jan 2021,8371,18,0,119194,128,3,119197,131,2.53130928259997,0.00278196192874482,168
-7.6926,53.28823,2021/08/26 23:00:00+00,Fri 27 Aug 2021,9704,19166,430,3469405,3149853,236516,3705921,3386369,78.7002376559996,71.9141193487151,169
-7.6926,53.28823,2022/01/15 00:00:00+00,Sat 15 Jan 2022,8355,637,0,3758615,3640388,240214,3998829,3880602,84.9205346378682,82.4098246153513,170
-7.6926,53.28823,2021/01/20 00:00:00+00,Wed 20 Jan 2021,8440,961,0,127634,1089,3,127637,1092,2.71054408167331,0.0231900948564072,171
-7.6926,53.28823,2021/08/27 23:00:00+00,Sat 28 Aug 2021,9912,7885,153,3479317,3157738,236669,3715986,3394407,78.9139815247997,72.0848171348468,172
-7.6926,53.28823,2022/01/16 00:00:00+00,Sun 16 Jan 2022,6966,1213,1,3765581,3641601,240215,4005796,3881816,85.0684882925061,82.435605544981,173
-7.6926,53.28823,2021/01/21 00:00:00+00,Thu 21 Jan 2021,8994,962,0,136628,2051,3,136631,2054,2.90154381897965,0.0436194641346707,174
-7.6926,53.28823,2021/08/28 23:00:00+00,Sun 29 Aug 2021,8791,9171,28,3488108,3166909,236697,3724805,3403606,79.1012649007509,72.2801703240264,175
-7.6926,53.28823,2022/01/17 00:00:00+00,Mon 17 Jan 2022,2565,545,0,3768146,3642146,240215,4008361,3882361,85.1229595317979,82.4471793560586,176
-7.6926,53.28823,2021/01/22 00:00:00+00,Fri 22 Jan 2021,6768,967,0,143396,3018,3,143399,3021,3.04527143984793,0.0641550151659398,177
-7.6926,53.28823,2021/08/29 23:00:00+00,Mon 30 Aug 2021,5042,11084,82,3493150,3177993,236779,3729929,3414772,79.2100799612309,72.5172954148383,178
-7.6926,53.28823,2022/01/18 00:00:00+00,Tue 18 Jan 2022,4064,426,3,3772210,3642572,240218,4012428,3882790,85.2093277696926,82.4562897504665,179
-7.6926,53.28823,2021/01/23 00:00:00+00,Sat 23 Jan 2021,4179,460,0,147575,3478,3,147578,3481,3.13401814900995,0.0739237364424483,180
-7.6926,53.28823,2021/08/30 23:00:00+00,Tue 31 Aug 2021,4050,12847,141,3497200,3190840,236920,3734120,3427760,79.2990815066002,72.7931131364455,181
-7.6926,53.28823,2022/01/19 00:00:00+00,Wed 19 Jan 2022,3488,611,0,3775698,3643183,240218,4015916,3883401,85.2834001605893,82.4692651606838,182
-7.6926,53.28823,2021/01/24 00:00:00+00,Sun 24 Jan 2021,1180,397,0,148755,3875,3,148758,3878,3.15907704271925,0.0823545676310872,183
-7.6926,53.28823,2021/08/31 23:00:00+00,Wed 01 Sep 2021,4933,12504,180,3502133,3203344,237100,3739233,3440444,79.4076629672236,73.0624750074699,184
-7.6926,53.28823,2022/01/20 00:00:00+00,Thu 20 Jan 2022,3697,924,1,3779395,3644107,240219,4019614,3884326,85.3619321851122,82.4889087849898,185
-7.6926,53.28823,2021/01/25 00:00:00+00,Mon 25 Jan 2021,1350,1285,0,150105,5160,3,150108,5163,3.18774611603075,0.109643278153508,186
-7.6926,53.28823,2021/09/01 23:00:00+00,Thu 02 Sep 2021,5000,12329,246,3507133,3215673,237346,3744479,3453019,79.519068862477,73.3295221162788,187
-7.6926,53.28823,2022/01/21 00:00:00+00,Fri 21 Jan 2022,3253,967,0,3782648,3645074,240219,4022867,3885293,85.4310140336176,82.5094443360211,188
-7.6926,53.28823,2021/01/26 00:00:00+00,Tue 26 Jan 2021,1000,3498,0,151105,8658,3,151108,8661,3.20898246663185,0.183928032556175,189
-7.6926,53.28823,2021/09/02 23:00:00+00,Fri 03 Sep 2021,4759,16031,165,3511892,3231704,237511,3749403,3469215,79.6236366528369,73.6734660506143,190
-7.6926,53.28823,2022/01/22 00:00:00+00,Sat 22 Jan 2022,4271,637,0,3786919,3645711,240219,4027138,3885930,85.5217144870349,82.522971891354,191
-7.6926,53.28823,2021/01/27 00:00:00+00,Wed 27 Jan 2021,2162,6699,0,153267,15357,3,153270,15360,3.25489545663144,0.326190345232981,192
-7.6926,53.28823,2021/09/03 23:00:00+00,Sat 04 Sep 2021,4619,10554,133,3516511,3242258,237644,3754155,3479902,79.7245517908933,73.9004189294883,193
-7.6926,53.28823,2022/01/23 00:00:00+00,Sun 23 Jan 2022,3092,677,0,3790011,3646388,240219,4030230,3886607,85.5873772830935,82.5373489007109,194
-7.6926,53.28823,2021/01/28 00:00:00+00,Thu 28 Jan 2021,994,11538,0,154261,26895,3,154264,26898,3.27600438912894,0.571215358468536,195
-7.6926,53.28823,2021/01/29 00:00:00+00,Fri 29 Jan 2021,1566,11526,0,155827,38421,3,155830,38424,3.30926051417027,0.815985535496879,196
-7.6926,53.28823,2021/01/30 00:00:00+00,Sat 30 Jan 2021,625,7792,0,156452,46213,3,156455,46216,3.32253323329596,0.981459179380693,197
-7.6926,53.28823,2021/01/31 00:00:00+00,Sun 31 Jan 2021,218,4086,0,156670,50299,3,156673,50302,3.32716275772701,1.06823090793681,198
-7.6926,53.28823,2021/02/01 00:00:00+00,Mon 01 Feb 2021,1013,8334,0,157683,58633,3,157686,58636,3.34867518088593,1.24521465384642,199
-7.6926,53.28823,2021/02/02 00:00:00+00,Tue 02 Feb 2021,823,5106,0,158506,63739,3,158509,63742,3.36615269743064,1.35364746001567,200
-7.6926,53.28823,2021/02/03 00:00:00+00,Wed 03 Feb 2021,1390,6862,0,159896,70601,3,159899,70604,3.39567122476617,1.49937129784045,201
-7.6926,53.28823,2021/02/04 00:00:00+00,Thu 04 Feb 2021,1417,10541,1,161313,81142,4,161317,81146,3.42578436991854,1.72324490587731,202
-7.6926,53.28823,2021/02/05 00:00:00+00,Fri 05 Feb 2021,3380,8612,0,164693,89754,4,164697,89758,3.49756323495028,1.90613235725403,203
-7.6926,53.28823,2021/02/06 00:00:00+00,Sat 06 Feb 2021,890,3866,0,165583,93620,4,165587,93624,3.51646358698526,1.9882320886779,204
-7.6926,53.28823,2021/02/07 00:00:00+00,Sun 07 Feb 2021,324,1299,2,165907,94919,6,165913,94925,3.52338663728122,2.01586058080994,205
-7.6926,53.28823,2021/02/08 00:00:00+00,Mon 08 Feb 2021,1161,878,0,167068,95797,6,167074,95803,3.5480420403291,2.03450609663771,206
-7.6926,53.28823,2021/02/09 00:00:00+00,Tue 09 Feb 2021,4249,536,2,171317,96333,8,171325,96341,3.6383177667344,2.04593125326111,207
-7.6926,53.28823,2021/02/10 00:00:00+00,Wed 10 Feb 2021,8818,580,0,180135,96913,8,180143,96921,3.82557990633495,2.05824833660975,208
-7.6926,53.28823,2021/02/11 00:00:00+00,Thu 11 Feb 2021,6178,444,0,186313,97357,8,186321,97365,3.95677808034858,2.06767727627664,209
-7.6926,53.28823,2021/02/12 00:00:00+00,Fri 12 Feb 2021,4389,522,0,190702,97879,8,190710,97887,4.04998442313683,2.07876265129042,210
-7.6926,53.28823,2021/02/13 00:00:00+00,Sat 13 Feb 2021,1204,1914,0,191906,99793,8,191914,99801,4.07555298926057,2.11940902634093,211
-7.6926,53.28823,2021/02/14 00:00:00+00,Sun 14 Feb 2021,2692,27,0,194598,99820,8,194606,99828,4.13272124507874,2.11998240780716,212
-7.6926,53.28823,2021/02/15 00:00:00+00,Mon 15 Feb 2021,1955,7885,0,196553,107705,8,196561,107713,4.1742383105039,2.28743103229688,213
-7.6926,53.28823,2021/02/16 00:00:00+00,Tue 16 Feb 2021,5643,8157,0,202196,115862,8,202204,115870,4.29407503694594,2.4606559441501,214
-7.6926,53.28823,2021/02/17 00:00:00+00,Wed 17 Feb 2021,9735,8462,0,211931,124324,8,211939,124332,4.5008109100477,2.64035794293665,215
-7.6926,53.28823,2021/02/18 00:00:00+00,Thu 18 Feb 2021,8453,8348,1,220384,132672,9,220393,132681,4.68034301802945,2.81766023410528,216
-7.6926,53.28823,2021/02/19 00:00:00+00,Fri 19 Feb 2021,9385,6581,0,229769,139253,9,229778,139262,4.87964616842082,2.95741665741116,217
-7.6926,53.28823,2021/02/20 00:00:00+00,Sat 20 Feb 2021,5884,3567,2,235653,142820,11,235664,142831,5.00464332805893,3.0332091927065,218
-7.6926,53.28823,2021/02/21 00:00:00+00,Sun 21 Feb 2021,1107,1021,5,236760,143841,16,236776,143857,5.02825814992736,3.05499768842324,219
-7.6926,53.28823,2021/02/22 00:00:00+00,Mon 22 Feb 2021,3938,1120,1,240698,144961,17,240715,144978,5.11190813494512,3.07880363744708,220
-7.6926,53.28823,2021/02/23 00:00:00+00,Tue 23 Feb 2021,13353,1062,0,254051,146023,17,254068,146040,5.39547712452168,3.10135664178545,221
-7.6926,53.28823,2021/02/24 00:00:00+00,Wed 24 Feb 2021,16937,2101,3,270988,148124,20,271008,148144,5.75522090370441,3.14603792345018,222
-7.6926,53.28823,2021/02/25 00:00:00+00,Thu 25 Feb 2021,18080,1753,2,289068,149877,22,289090,149899,6.1392165952736,3.18330771875512,223
-7.6926,53.28823,2021/02/26 00:00:00+00,Fri 26 Feb 2021,16076,2766,0,305144,152643,22,305166,152665,6.48061216753697,3.24204746451777,224
-7.6926,53.28823,2021/02/27 00:00:00+00,Sat 27 Feb 2021,8986,703,1,314130,153346,23,314153,153369,6.6714632503891,3.25699785534095,225
-7.6926,53.28823,2021/02/28 00:00:00+00,Sun 28 Feb 2021,2440,54,2,316570,153400,25,316595,153425,6.723322418557,3.25818709097461,226
-7.6926,53.28823,2021/03/01 00:00:00+00,Mon 01 Mar 2021,5585,787,0,322155,154187,25,322180,154212,6.84192743666418,3.27490009889768,227
-7.6926,53.28823,2021/03/02 00:00:00+00,Tue 02 Mar 2021,12171,1607,0,334326,155794,25,334351,155819,7.10039505983023,3.30902691431366,228
-7.6926,53.28823,2021/03/03 00:00:00+00,Wed 03 Mar 2021,12885,1502,1,347211,157296,26,347237,157322,7.37404667367608,3.34094514926712,229
-7.6926,53.28823,2021/03/04 00:00:00+00,Thu 04 Mar 2021,18733,1685,3,365944,158981,29,365973,159010,7.77193093853839,3.37679210908179,230
-7.6926,53.28823,2021/03/05 00:00:00+00,Fri 05 Mar 2021,18434,2392,6,384378,161373,35,384413,161408,8.16352924362278,3.42771687782324,231
-7.6926,53.28823,2021/03/06 00:00:00+00,Sat 06 Mar 2021,10391,137,4,394769,161510,39,394808,161549,8.38428110812127,3.430711203258,232
-7.6926,53.28823,2021/03/07 00:00:00+00,Sun 07 Mar 2021,1518,10,3,396287,161520,42,396329,161562,8.41658159738555,3.43098727581581,233
-7.6926,53.28823,2021/03/08 00:00:00+00,Mon 08 Mar 2021,6662,1493,5,402949,163013,47,402996,163060,8.55816434684312,3.46279932901627,234
-7.6926,53.28823,2021/03/09 00:00:00+00,Tue 09 Mar 2021,13810,3100,5,416759,166113,52,416811,166165,8.85154453039739,3.5287381976327,235
-7.6926,53.28823,2021/03/10 00:00:00+00,Wed 10 Mar 2021,13724,3982,3,430483,170095,55,430538,170150,9.14305591509877,3.6133650547781,236
-7.6926,53.28823,2021/03/11 00:00:00+00,Thu 11 Mar 2021,18465,2094,3,448948,172189,58,449006,172247,9.53524883799999,3.65789768198862,237
-7.6926,53.28823,2021/03/12 00:00:00+00,Fri 12 Mar 2021,17322,1335,4,466270,173524,62,466332,173586,9.90318984851474,3.6863331554435,238
-7.6926,53.28823,2021/03/13 00:00:00+00,Sat 13 Mar 2021,8298,171,0,474568,173695,62,474630,173757,10.0794090858027,3.68996457139629,239
-7.6926,53.28823,2021/03/14 00:00:00+00,Sun 14 Mar 2021,379,18,2,474947,173713,64,475011,173777,10.0875001353817,3.69038929840831,240
-7.6926,53.28823,2021/03/15 00:00:00+00,Mon 15 Mar 2021,2650,989,0,477597,174702,64,477661,174766,10.1437764644747,3.71139204915281,241
-7.6926,53.28823,2021/03/16 00:00:00+00,Tue 16 Mar 2021,8931,3817,2,486528,178519,66,486594,178585,10.3334807843943,3.79249367209843,242
-7.6926,53.28823,2021/03/17 00:00:00+00,Wed 17 Mar 2021,4893,2417,6,491421,180936,72,491493,181008,10.4375176659892,3.84394934960491,243
-7.6926,53.28823,2021/03/18 00:00:00+00,Thu 18 Mar 2021,11719,4676,5,503140,185612,77,503217,185689,10.6864926404365,3.94335670676868,244
-7.6926,53.28823,2021/03/19 00:00:00+00,Fri 19 Mar 2021,10360,6122,2,513500,191734,79,513579,191813,10.9065437053652,4.07340811784985,245
-7.6926,53.28823,2021/03/20 00:00:00+00,Sat 20 Mar 2021,5236,3116,3,518736,194850,82,518818,194932,11.0178009461644,4.1396442953747,246
-7.6926,53.28823,2021/03/21 00:00:00+00,Sun 21 Mar 2021,3631,53,3,522367,194903,85,522452,194988,11.0949738442488,4.14083353100836,247
-7.6926,53.28823,2021/03/22 00:00:00+00,Mon 22 Mar 2021,7403,2398,1,529770,197301,86,529856,197387,11.2522077840994,4.19177953610042,248
-7.6926,53.28823,2021/03/23 00:00:00+00,Tue 23 Mar 2021,12558,7378,3,542328,204679,89,542417,204768,11.5189575839999,4.34852503988718,249
-7.6926,53.28823,2021/03/24 00:00:00+00,Wed 24 Mar 2021,13621,9781,2,555949,214460,91,556040,214551,11.8082603882387,4.55628025781779,250
-7.6926,53.28823,2021/03/25 00:00:00+00,Thu 25 Mar 2021,20856,10216,3,576805,224676,94,576899,224770,12.2512294254272,4.77329452461049,251
-7.6926,53.28823,2021/03/26 00:00:00+00,Fri 26 Mar 2021,19692,9493,1,596497,234169,95,596592,234264,12.6694368778147,4.97491243721738,252
-7.6926,53.28823,2021/03/27 00:00:00+00,Sat 27 Mar 2021,11734,5341,3,608231,239510,98,608329,239608,12.9186879248199,5.08839949482969,253
-7.6926,53.28823,2021/03/28 00:00:00+00,Sun 28 Mar 2021,2487,482,0,610718,239992,98,610816,240090,12.9715027287649,5.09863541581942,254
-7.6926,53.28823,2021/03/28 23:00:00+00,Mon 29 Mar 2021,9253,3113,3,619971,243105,101,620072,243206,13.1680663899287,5.16480788429247,255
-7.6926,53.28823,2021/03/29 23:00:00+00,Tue 30 Mar 2021,13317,8661,4,633288,251766,105,633393,251871,13.450955816286,5.34882086225105,256
-7.6926,53.28823,2021/03/30 23:00:00+00,Wed 31 Mar 2021,15825,10501,4,649113,262267,109,649222,262376,13.7871060099509,5.57190872531566,257
-7.6926,53.28823,2021/03/31 23:00:00+00,Thu 01 Apr 2021,19681,11577,8,668794,273844,117,668911,273961,14.2052285169361,5.81793184702947,258
-7.6926,53.28823,2021/04/01 23:00:00+00,Fri 02 Apr 2021,20126,13716,7,688920,287560,124,689044,287684,14.6327799635882,6.10935828632844,259
-7.6926,53.28823,2021/04/02 23:00:00+00,Sat 03 Apr 2021,7540,4639,5,696460,292199,129,696589,292328,14.7930082288735,6.20797989851997,260
-7.6926,53.28823,2021/04/03 23:00:00+00,Sun 04 Apr 2021,3023,168,3,699483,292367,132,699615,292499,14.8572694257924,6.21161131447276,261
-7.6926,53.28823,2021/04/04 23:00:00+00,Mon 05 Apr 2021,3421,606,4,702904,292973,136,703040,293109,14.9300039266012,6.22456548833944,262
-7.6926,53.28823,2021/04/05 23:00:00+00,Tue 06 Apr 2021,11979,8158,11,714883,301131,147,715030,301278,15.1846277703085,6.39804523639987,263
-7.6926,53.28823,2021/04/06 23:00:00+00,Wed 07 Apr 2021,18346,10460,9,733229,311591,156,733385,311747,15.5744209855918,6.62036859084284,264
-7.6926,53.28823,2021/04/07 23:00:00+00,Thu 08 Apr 2021,20173,10568,14,753402,322159,170,753572,322329,16.0031191951763,6.84509165290374,265
-7.6926,53.28823,2021/04/08 23:00:00+00,Fri 09 Apr 2021,20682,9155,16,774084,331314,186,774270,331500,16.442669179918,7.03985022426648,266
-7.6926,53.28823,2021/04/09 23:00:00+00,Sat 10 Apr 2021,11159,4160,12,785243,335474,198,785441,335672,16.6799004524829,7.12844827897429,267
-7.6926,53.28823,2021/04/10 23:00:00+00,Sun 11 Apr 2021,2855,356,7,788098,335830,205,788303,336035,16.7406788879033,7.13615707424249,268
-7.6926,53.28823,2021/04/11 23:00:00+00,Mon 12 Apr 2021,7767,2787,13,795865,338617,218,796083,338835,16.9058976955799,7.19561885592559,269
-7.6926,53.28823,2021/04/12 23:00:00+00,Tue 13 Apr 2021,11494,8590,1,807359,347207,219,807578,347426,17.1500095457396,7.37806034393969,270
-7.6926,53.28823,2021/04/13 23:00:00+00,Wed 14 Apr 2021,20340,6591,2,827699,353798,221,827920,354019,17.5819993896673,7.51807160345278,271
-7.6926,53.28823,2021/04/14 23:00:00+00,Thu 15 Apr 2021,27109,10790,1,854808,364588,222,855030,364810,18.1577168544633,7.7472330627893,272
-7.6926,53.28823,2021/04/15 23:00:00+00,Fri 16 Apr 2021,27970,9826,1,882778,374414,223,883001,374637,18.7517188171268,7.95592268014637,273
-7.6926,53.28823,2021/04/16 23:00:00+00,Sat 17 Apr 2021,15839,4548,2,898617,378962,225,898842,379187,19.0881238469989,8.0525480753814,274
-7.6926,53.28823,2021/04/17 23:00:00+00,Sun 18 Apr 2021,1064,478,0,899681,379440,225,899906,379665,19.1107193240385,8.06269905096873,275
-7.6926,53.28823,2021/04/18 23:00:00+00,Mon 19 Apr 2021,6734,2248,0,906415,381688,225,906640,381913,19.2537249089863,8.11043836712001,276
-7.6926,53.28823,2021/04/19 23:00:00+00,Tue 20 Apr 2021,15076,7311,1,921491,388999,226,921717,389225,19.5739053669992,8.2657185627153,277
-7.6926,53.28823,2021/04/20 23:00:00+00,Wed 21 Apr 2021,26704,9870,4,948195,398869,230,948425,399099,20.1410858188535,8.47540628855061,278
-7.6926,53.28823,2021/04/21 23:00:00+00,Thu 22 Apr 2021,31612,12180,1,979807,411049,231,980038,411280,20.8124305704063,8.73408627522268,279
-7.6926,53.28823,2021/04/22 23:00:00+00,Fri 23 Apr 2021,33616,12361,1,1013423,423410,232,1013655,423642,21.5263329685636,8.99661004135355,280
-7.6926,53.28823,2021/04/23 23:00:00+00,Sat 24 Apr 2021,23694,6984,2,1037117,430394,234,1037351,430628,22.0295495324074,9.14496718665287,281
-7.6926,53.28823,2021/04/24 23:00:00+00,Sun 25 Apr 2021,9740,298,2,1046857,430692,236,1047093,430928,22.2364340599634,9.1513380918332,282
-7.6926,53.28823,2021/04/25 23:00:00+00,Mon 26 Apr 2021,15564,3042,3,1062421,433734,239,1062660,433973,22.5670203297708,9.21600277941357,283
-7.6926,53.28823,2022/01/24 00:00:00+00,Mon 24 Jan 2022,646,458,0,3790657,3646846,240219,4030876,3887065,85.6010959655818,82.5470751492862,284
-7.6926,53.28823,2022/01/25 00:00:00+00,Tue 25 Jan 2022,697,1827,0,3791354,3648673,240219,4031573,3888892,85.6158977019508,82.5858739618345,285
-7.6926,53.28823,2021/09/04 23:00:00+00,Sun 05 Sep 2021,5304,11887,1,3521815,3254145,237645,3759460,3491790,79.8372106308322,74.1528766654342,286
-7.6926,53.28823,2022/01/26 00:00:00+00,Wed 26 Jan 2022,701,885,0,3792055,3649558,240219,4032274,3889777,85.6307843837222,82.6046681321164,287
-7.6926,53.28823,2022/01/27 00:00:00+00,Thu 27 Jan 2022,1275,1161,0,3793330,3650719,240219,4033549,3890938,85.6578607307386,82.6293235351643,288
-7.6926,53.28823,2021/09/05 23:00:00+00,Mon 06 Sep 2021,2143,9655,74,3523958,3263800,237719,3761677,3501519,79.8842916201148,74.3594851204324,289
-7.6926,53.28823,2022/01/28 00:00:00+00,Fri 28 Jan 2022,1033,3090,0,3794363,3653809,240219,4034582,3894028,85.6797978809095,82.6949438585217,290
-7.6926,53.28823,2021/09/06 23:00:00+00,Tue 07 Sep 2021,3017,9987,155,3526975,3273787,237874,3764849,3511661,79.9516533242215,74.5748641882288,291
-7.6926,53.28823,2022/01/29 00:00:00+00,Sat 29 Jan 2022,2325,3442,0,3796688,3657251,240219,4036907,3897470,85.7291723960571,82.7680393772907,292
-7.6926,53.28823,2021/09/07 23:00:00+00,Wed 08 Sep 2021,2594,14790,186,3529569,3288577,238060,3767629,3526637,80.0106903788926,74.892899774831,293
-7.6926,53.28823,2021/09/08 23:00:00+00,Thu 09 Sep 2021,3107,14779,137,3532676,3303356,238197,3770873,3541553,80.0795811002426,75.2096611803971,294
-7.6926,53.28823,2022/01/30 00:00:00+00,Sun 30 Jan 2022,1634,7537,0,3798322,3664788,240219,4038541,3905007,85.7638725929393,82.9280977517713,295
-7.6926,53.28823,2021/09/09 23:00:00+00,Fri 10 Sep 2021,3370,13932,115,3536046,3317288,238312,3774358,3555600,80.1535897820874,75.5079681972908,296
-7.6926,53.28823,2021/09/10 23:00:00+00,Sat 11 Sep 2021,2550,11310,62,3538596,3328598,238374,3776970,3566972,80.2090591298575,75.7494679763266,297
-7.6926,53.28823,2022/01/31 00:00:00+00,Mon 31 Jan 2022,480,1385,0,3798802,3666173,240219,4039021,3906392,85.7740660412278,82.9575100973538,298
-7.6926,53.28823,2022/02/01 00:00:00+00,Tue 01 Feb 2022,763,3411,1,3799565,3669584,240220,4039785,3909804,85.7902906130871,83.0299685256048,299
-7.6926,53.28823,2022/02/02 00:00:00+00,Wed 02 Feb 2022,643,2993,0,3800208,3672577,240220,4040428,3912797,85.8039455865236,83.0935289229539,300
-7.6926,53.28823,2022/02/03 00:00:00+00,Thu 03 Feb 2022,911,2428,1,3801119,3675005,240221,4041340,3915226,85.8233131382718,83.145112018564,301
-7.6926,53.28823,2022/02/04 00:00:00+00,Fri 04 Feb 2022,1170,6517,0,3802289,3681522,240221,4042510,3921743,85.8481596684751,83.2835093154314,302
-7.6926,53.28823,2021/09/11 23:00:00+00,Sun 12 Sep 2021,2037,12872,1,3540633,3341470,238375,3779008,3579845,80.2523388123826,76.0228435176146,303
-7.6926,53.28823,2022/02/05 00:00:00+00,Sat 05 Feb 2022,1777,5746,0,3804066,3687268,240221,4044287,3927489,85.8858966634932,83.4055333859853,304
-7.6926,53.28823,2021/09/12 23:00:00+00,Mon 13 Sep 2021,1603,7714,51,3542236,3349184,238426,3780662,3587610,80.2874637362768,76.1877437800322,305
-7.6926,53.28823,2022/02/06 00:00:00+00,Sun 06 Feb 2022,1408,7555,0,3805474,3694823,240221,4045695,3935044,85.9157974451396,83.5659740147767,306
-7.6926,53.28823,2021/09/13 23:00:00+00,Tue 14 Sep 2021,1541,10767,81,3543777,3359951,238507,3782284,3598458,80.3219090969518,76.418115711353,307
-7.6926,53.28823,2022/02/07 00:00:00+00,Mon 07 Feb 2022,439,1348,0,3805913,3696171,240221,4046134,3936392,85.9251202030535,83.594600615387,308
-7.6926,53.28823,2021/09/14 23:00:00+00,Wed 15 Sep 2021,3269,12382,137,3547046,3372333,238644,3785690,3610977,80.3942401070992,76.6839735845282,309
-7.6926,53.28823,2022/02/08 00:00:00+00,Tue 08 Feb 2022,896,1232,0,3806809,3697403,240221,4047030,3937624,85.9441479731921,83.6207637993275,310
-7.6926,53.28823,2021/09/15 23:00:00+00,Thu 16 Sep 2021,1902,10581,113,3548948,3382914,238757,3787705,3621671,80.4370313535604,76.9110751178564,311
-7.6926,53.28823,2022/02/09 00:00:00+00,Wed 09 Feb 2022,1333,1778,0,3808142,3699181,240221,4048363,3939402,85.9724560285433,83.6585220306963,312
-7.6926,53.28823,2021/09/16 23:00:00+00,Fri 17 Sep 2021,2555,14602,92,3551503,3397516,238849,3790352,3636365,80.4932439736015,77.2231220535891,313
-7.6926,53.28823,2021/09/17 23:00:00+00,Sat 18 Sep 2021,2283,11219,45,3553786,3408735,238894,3792680,3647629,80.5426821978009,77.4623283067599,314
-7.6926,53.28823,2021/09/18 23:00:00+00,Sun 19 Sep 2021,1858,8485,13,3555644,3417220,238907,3794551,3656127,80.5824154097755,77.6427948141681,315
-7.6926,53.28823,2021/09/19 23:00:00+00,Mon 20 Sep 2021,950,5599,34,3556594,3422819,238941,3795535,3661760,80.603311978767,77.7624191771042,316
-7.6926,53.28823,2021/09/20 23:00:00+00,Tue 21 Sep 2021,1460,6655,90,3558054,3429474,239031,3797085,3668505,80.6362283221988,77.9056583619086,317
-7.6926,53.28823,2021/09/21 23:00:00+00,Wed 22 Sep 2021,1892,8123,97,3559946,3437597,239128,3799074,3676725,80.6784674235444,78.0802211638497,318
-7.6926,53.28823,2021/09/22 23:00:00+00,Thu 23 Sep 2021,1692,8746,88,3561638,3446343,239216,3800854,3685559,80.7162681276143,78.2678230850599,319
-7.6926,53.28823,2021/09/23 23:00:00+00,Fri 24 Sep 2021,1904,7379,79,3563542,3453722,239295,3802837,3693017,80.7583798108563,78.4262037878429,320
-7.6926,53.28823,2021/09/24 23:00:00+00,Sat 25 Sep 2021,2412,6581,51,3565954,3460303,239346,3805300,3699649,80.8106849423868,78.5670432650294,321
-7.6926,53.28823,2021/09/25 23:00:00+00,Sun 26 Sep 2021,1538,7092,0,3567492,3467395,239346,3806838,3706741,80.8433464496113,78.7176514634925,322
-7.6926,53.28823,2021/09/26 23:00:00+00,Mon 27 Sep 2021,1173,3790,45,3568665,3471185,239391,3808056,3710576,80.8692123246435,78.7990928680477,323
-7.6926,53.28823,2021/09/27 23:00:00+00,Tue 28 Sep 2021,1443,5116,91,3570108,3476301,239482,3809590,3715783,80.9017888864656,78.9096705456277,324
-7.6926,53.28823,2021/09/28 23:00:00+00,Wed 29 Sep 2021,1649,3605,78,3571757,3479906,239560,3811317,3719466,80.9384640639537,78.9878840248916,325
-7.6926,53.28823,2021/09/29 23:00:00+00,Thu 30 Sep 2021,1279,3943,77,3573036,3483849,239637,3812673,3723486,80.9672605553688,79.073254154308,326
-7.6926,53.28823,2021/09/30 23:00:00+00,Fri 01 Oct 2021,1836,5155,42,3574872,3489004,239679,3814551,3728683,81.0071424217977,79.1836194683819,327
-7.6926,53.28823,2021/10/01 23:00:00+00,Sat 02 Oct 2021,1707,4077,40,3576579,3493081,239719,3816298,3732800,81.0442423262978,79.2710495238067,328
-7.6926,53.28823,2021/10/02 23:00:00+00,Sun 03 Oct 2021,1194,3011,9,3577773,3496092,239728,3817501,3735820,81.0697896560709,79.335183302622,329
-7.6926,53.28823,2021/10/03 23:00:00+00,Mon 04 Oct 2021,336,1222,17,3578109,3497314,239745,3817854,3737059,81.0772860878331,79.3614951410168,330
-7.6926,53.28823,2021/10/04 23:00:00+00,Tue 05 Oct 2021,961,2812,69,3579070,3500126,239814,3818884,3739940,81.0991595289523,79.4226770670986,331
-7.6926,53.28823,2021/10/05 23:00:00+00,Wed 06 Oct 2021,972,2550,36,3580042,3502676,239850,3819892,3742526,81.1205657703582,79.4775942697531,332
-7.6926,53.28823,2021/10/06 23:00:00+00,Thu 07 Oct 2021,1206,2683,44,3581248,3505359,239894,3821142,3745253,81.1471112086096,79.5355057978422,333
-7.6926,53.28823,2021/10/07 23:00:00+00,Fri 08 Oct 2021,975,2769,47,3582223,3508128,239941,3822164,3748069,81.1688147589239,79.595307361135,334
-7.6926,53.28823,2021/10/08 23:00:00+00,Sat 09 Oct 2021,730,2368,23,3582953,3510496,239964,3822917,3750460,81.1848057309265,79.6460834754222,335
-7.6926,53.28823,2021/10/09 23:00:00+00,Sun 10 Oct 2021,1501,3910,1,3584454,3514406,239965,3824419,3754371,81.2167027295294,79.7291388426231,336
-7.6926,53.28823,2021/10/10 23:00:00+00,Mon 11 Oct 2021,329,1108,16,3584783,3515514,239981,3824764,3755495,81.2240292704868,79.7530085006988,337
-7.6926,53.28823,2021/10/11 23:00:00+00,Tue 12 Oct 2021,562,1599,20,3585345,3517113,240001,3825346,3757114,81.2363888265366,79.787390152322,338
-7.6926,53.28823,2021/10/12 23:00:00+00,Wed 13 Oct 2021,1004,2050,11,3586349,3519163,240012,3826361,3759175,81.2579437223967,79.8311582709108,339
-7.6926,53.28823,2021/10/13 23:00:00+00,Thu 14 Oct 2021,689,1574,7,3587038,3520737,240019,3827057,3760756,81.2727242224151,79.8647329412112,340
-7.6926,53.28823,2021/10/14 23:00:00+00,Fri 15 Oct 2021,948,2060,7,3587986,3522797,240026,3828012,3762823,81.2930049372392,79.9086284779037,341
-7.6926,53.28823,2021/10/15 23:00:00+00,Sat 16 Oct 2021,1367,2627,13,3589353,3525424,240039,3829392,3765463,81.3223111010687,79.9646924434906,342
-7.6926,53.28823,2021/10/16 23:00:00+00,Sun 17 Oct 2021,1701,2883,2,3591054,3528307,240041,3831095,3768348,81.3584766061424,80.0259593149748,343
-7.6926,53.28823,2021/10/17 23:00:00+00,Mon 18 Oct 2021,669,1225,4,3591723,3529532,240045,3831768,3769577,81.3727686700969,80.0520587898636,344
-7.6926,53.28823,2021/10/18 23:00:00+00,Tue 19 Oct 2021,1329,1779,14,3593052,3531311,240059,3833111,3771370,81.4012890889542,80.0901355664913,345
-7.6926,53.28823,2021/10/19 23:00:00+00,Wed 20 Oct 2021,2245,2301,0,3595297,3533612,240059,3835356,3773671,81.4489646960537,80.1390004092245,346
-7.6926,53.28823,2021/10/20 23:00:00+00,Thu 21 Oct 2021,1744,1808,11,3597041,3535420,240070,3837111,3775490,81.4862344913586,80.1776293309679,347
-7.6926,53.28823,2021/10/21 23:00:00+00,Fri 22 Oct 2021,1496,1908,2,3598537,3537328,240072,3838609,3777400,81.5180465445591,80.218190760616,348
-7.6926,53.28823,2021/10/22 23:00:00+00,Sat 23 Oct 2021,2009,1680,1,3600546,3539008,240073,3840619,3779081,81.5607316092673,80.2538890659765,349
-7.6926,53.28823,2021/10/23 23:00:00+00,Sun 24 Oct 2021,1946,2182,2,3602492,3541190,240075,3842567,3781265,81.6021000202382,80.3002692556893,350
-7.6926,53.28823,2021/10/24 23:00:00+00,Mon 25 Oct 2021,1216,834,2,3603708,3542024,240077,3843785,3782101,81.6279658952704,80.3180228447918,351
-7.6926,53.28823,2021/10/25 23:00:00+00,Tue 26 Oct 2021,1236,1198,6,3604944,3543222,240083,3845027,3783305,81.654341442717,80.3435914109155,352
-7.6926,53.28823,2021/10/26 23:00:00+00,Wed 27 Oct 2021,1555,1405,5,3606499,3544627,240088,3846587,3784715,81.6874701496547,80.3735346652631,353
-7.6926,53.28823,2021/10/27 23:00:00+00,Thu 28 Oct 2021,2144,1671,4,3608643,3546298,240092,3848735,3786390,81.7330858307459,80.4091055525199,354
-7.6926,53.28823,2021/10/28 23:00:00+00,Fri 29 Oct 2021,2133,1347,0,3610776,3547645,240092,3850868,3787737,81.778382966578,80.4377109167796,355
-7.6926,53.28823,2021/10/29 23:00:00+00,Sat 30 Oct 2021,2009,1438,0,3612785,3549083,240092,3852877,3789175,81.8210467949356,80.468248788944,356
-7.6926,53.28823,2021/10/30 23:00:00+00,Sun 31 Oct 2021,1592,1315,0,3614377,3550398,240092,3854469,3790490,81.8548550650926,80.4961745899845,357
-7.6926,53.28823,2021/11/01 00:00:00+00,Mon 01 Nov 2021,261,260,2,3614638,3550658,240094,3854732,3790752,81.8604402253007,80.501738513842,358
-7.6926,53.28823,2021/11/02 00:00:00+00,Tue 02 Nov 2021,1088,1077,9,3615726,3551735,240103,3855829,3791838,81.8837365019101,80.5248011905948,359
-7.6926,53.28823,2021/11/03 00:00:00+00,Wed 03 Nov 2021,2533,1843,6,3618259,3553578,240109,3858368,3793687,81.9376555960863,80.5640672028562,360
-7.6926,53.28823,2021/11/04 00:00:00+00,Thu 04 Nov 2021,1541,1255,1,3619800,3554833,240110,3859910,3794943,81.9704020487132,80.5907400592112,361
-7.6926,53.28823,2021/11/05 00:00:00+00,Fri 05 Nov 2021,1627,1070,2,3621427,3555903,240112,3861539,3796015,82.0049960638424,80.6135054270556,362
-7.6926,53.28823,2021/11/06 00:00:00+00,Sat 06 Nov 2021,1815,1338,5,3623242,3557241,240117,3863359,3797358,82.0436462219364,80.6420258459129,363
-7.6926,53.28823,2021/11/07 00:00:00+00,Sun 07 Nov 2021,695,767,0,3623937,3558008,240117,3864054,3798125,82.0584054856042,80.6583141268239,364
-7.6926,53.28823,2021/11/08 00:00:00+00,Mon 08 Nov 2021,512,518,2,3624449,3558526,240119,3864568,3798645,82.0693209698132,80.6693570291365,365
-7.6926,53.28823,2021/11/09 00:00:00+00,Tue 09 Nov 2021,1373,1043,1,3625822,3559569,240120,3865942,3799689,82.0984997155391,80.691527779164,366
-7.6926,53.28823,2021/11/10 00:00:00+00,Wed 10 Nov 2021,1626,1329,0,3627448,3560898,240120,3867568,3801018,82.1330300216165,80.7197508891129,367
-7.6926,53.28823,2021/11/11 00:00:00+00,Thu 11 Nov 2021,1394,1090,2,3628842,3561988,240122,3868964,3802110,82.1626759670556,80.7429409839693,368
-7.6926,53.28823,2021/11/12 00:00:00+00,Fri 12 Nov 2021,1151,1120,5,3629993,3563108,240127,3870120,3803235,82.1872251883505,80.7668318783956,369
-7.6926,53.28823,2021/11/13 00:00:00+00,Sat 13 Nov 2021,1405,1359,0,3631398,3564467,240127,3871525,3804594,82.2170622609451,80.7956920788625,370
-7.6926,53.28823,2021/11/14 00:00:00+00,Sun 14 Nov 2021,1646,1801,0,3633044,3566268,240127,3873171,3806395,82.2520172940345,80.833938746295,371
-7.6926,53.28823,2021/11/15 00:00:00+00,Mon 15 Nov 2021,1246,574,1,3634290,3566842,240128,3874418,3806970,82.278499023234,80.8461496478907,372
-7.6926,53.28823,2021/11/16 00:00:00+00,Tue 16 Nov 2021,1317,1054,5,3635607,3567896,240133,3875740,3808029,82.3065734787287,80.8686389431773,373
-7.6926,53.28823,2021/11/17 00:00:00+00,Wed 17 Nov 2021,1515,1092,0,3637122,3568988,240133,3877255,3809121,82.3387465498894,80.8918290380337,374
-7.6926,53.28823,2021/11/18 00:00:00+00,Thu 18 Nov 2021,1663,2476,5,3638785,3571464,240138,3878923,3811602,82.374168782692,80.944516423875,375
-7.6926,53.28823,2021/11/19 00:00:00+00,Fri 19 Nov 2021,1177,1527,0,3639962,3572991,240138,3880100,3813129,82.3991639673495,80.9769443312429,376
-7.6926,53.28823,2021/11/20 00:00:00+00,Sat 20 Nov 2021,1540,2923,12,3641502,3575914,240150,3881652,3816064,82.4321227834825,81.0392730202571,377
-7.6926,53.28823,2021/11/21 00:00:00+00,Sun 21 Nov 2021,1786,2754,0,3643288,3578668,240150,3883438,3818818,82.470050905656,81.0977579298126,378
-7.6926,53.28823,2021/11/22 00:00:00+00,Mon 22 Nov 2021,707,493,2,3643995,3579161,240152,3884147,3819313,82.4851074782322,81.1082699233601,379
-7.6926,53.28823,2021/11/23 00:00:00+00,Tue 23 Nov 2021,2162,1563,6,3646157,3580724,240158,3886315,3820882,82.5311478863354,81.1415897574533,380
-7.6926,53.28823,2021/11/24 00:00:00+00,Wed 24 Nov 2021,1623,3119,2,3647780,3583843,240160,3887940,3824003,82.5656569560622,81.2078684076793,381
-7.6926,53.28823,2021/11/25 00:00:00+00,Thu 25 Nov 2021,993,1164,1,3648773,3585007,240161,3888934,3825168,82.5867658885597,81.2326087561296,382
-7.6926,53.28823,2021/11/26 00:00:00+00,Fri 26 Nov 2021,1288,1082,12,3650061,3586089,240173,3890234,3826262,82.6143731443411,81.2558413236872,383
-7.6926,53.28823,2021/11/27 00:00:00+00,Sat 27 Nov 2021,1220,1553,5,3651281,3587642,240178,3891459,3827820,82.6403876738275,81.2889275579237,384
-7.6926,53.28823,2021/11/28 00:00:00+00,Sun 28 Nov 2021,1967,2252,0,3653248,3589894,240178,3893426,3830072,82.6821595754599,81.3367518194774,385
-7.6926,53.28823,2021/11/29 00:00:00+00,Mon 29 Nov 2021,544,980,1,3653792,3590874,240179,3893971,3831053,82.6937333865375,81.3575846794171,386
-7.6926,53.28823,2021/11/30 00:00:00+00,Tue 30 Nov 2021,1923,1621,6,3655715,3592495,240185,3895900,3832680,82.734698306847,81.3921362218451,387
-7.6926,53.28823,2021/12/01 00:00:00+00,Wed 01 Dec 2021,1077,1352,1,3656792,3593847,240186,3896978,3834033,82.757591092795,81.4208690042084,388
-7.6926,53.28823,2021/12/02 00:00:00+00,Thu 02 Dec 2021,1771,1397,0,3658563,3595244,240186,3898749,3835430,82.7952006697096,81.4505361859982,389
-7.6926,53.28823,2021/12/03 00:00:00+00,Fri 03 Dec 2021,1048,1167,3,3659611,3596411,240189,3899800,3836600,82.8175200741913,81.4753827162015,390
-7.6926,53.28823,2021/12/04 00:00:00+00,Sat 04 Dec 2021,1201,1696,1,3660812,3598107,240190,3901002,3838297,82.8430461676138,81.5114208031715,391
-7.6926,53.28823,2021/12/05 00:00:00+00,Sun 05 Dec 2021,1348,1772,1,3662160,3599879,240191,3902351,3840070,82.8716940045747,81.5490728527873,392
-7.6926,53.28823,2021/12/06 00:00:00+00,Mon 06 Dec 2021,932,1278,0,3663092,3601157,240191,3903283,3841348,82.891486283335,81.5762129088555,393
-7.6926,53.28823,2021/12/07 00:00:00+00,Tue 07 Dec 2021,486,730,1,3663578,3601887,240192,3903770,3842079,82.9018283860777,81.5917366811449,394
-7.6926,53.28823,2021/12/08 00:00:00+00,Wed 08 Dec 2021,807,1492,0,3664385,3603379,240192,3904577,3843571,82.9189661210128,81.6234213162417,395
-7.6926,53.28823,2021/12/09 00:00:00+00,Thu 09 Dec 2021,795,1190,0,3665180,3604569,240192,3905372,3844761,82.9358490197407,81.6486925734571,396
-7.6926,53.28823,2021/12/10 00:00:00+00,Fri 10 Dec 2021,893,1593,1,3666073,3606162,240193,3906266,3846355,82.9548343171781,81.6825433163152,397
-7.6926,53.28823,2021/12/11 00:00:00+00,Sat 11 Dec 2021,638,834,0,3666711,3606996,240193,3906904,3847189,82.9683831088616,81.7002544327166,398
-7.6926,53.28823,2021/12/12 00:00:00+00,Sun 12 Dec 2021,691,1188,0,3667402,3608184,240193,3907595,3848377,82.9830574271269,81.7254832172307,399
-7.6926,53.28823,2021/12/13 00:00:00+00,Mon 13 Dec 2021,725,1046,1,3668127,3609230,240194,3908321,3849424,82.9984750176633,81.74771767631,400
-7.6926,53.28823,2021/12/14 00:00:00+00,Tue 14 Dec 2021,626,1186,1,3668753,3610416,240195,3908948,3850611,83.0117902094902,81.7729252244735,401
-7.6926,53.28823,2021/12/15 00:00:00+00,Wed 15 Dec 2021,798,1229,1,3669551,3611645,240196,3909747,3851841,83.0287580536205,81.7990459357129,402
-7.6926,53.28823,2021/12/16 00:00:00+00,Thu 16 Dec 2021,1063,1517,7,3670614,3613162,240203,3910817,3853365,83.0514809487637,81.831410134029,403
-7.6926,53.28823,2021/12/17 00:00:00+00,Fri 17 Dec 2021,1213,2434,1,3671827,3615596,240204,3912031,3855800,83.0772618783934,81.8831206477427,404
-7.6926,53.28823,2021/12/18 00:00:00+00,Sat 18 Dec 2021,1262,1172,0,3673089,3616768,240204,3913293,3856972,83.104062152852,81.9080096506472,405
-7.6926,53.28823,2021/12/19 00:00:00+00,Sun 19 Dec 2021,561,878,0,3673650,3617646,240204,3913854,3857850,83.1159757455392,81.9266551664749,406
-7.6926,53.28823,2021/12/20 00:00:00+00,Mon 20 Dec 2021,540,593,0,3674190,3618239,240204,3914394,3858443,83.1274433748639,81.9392483223814,407
-7.6926,53.28823,2021/12/21 00:00:00+00,Tue 21 Dec 2021,1459,1784,3,3675649,3620023,240207,3915856,3860230,83.1584909194427,81.9771976809056,408
-7.6926,53.28823,2021/12/22 00:00:00+00,Wed 22 Dec 2021,1226,1557,2,3676875,3621580,240209,3917084,3861789,83.1845691579808,82.0103051514927,409
-7.6926,53.28823,2022/02/10 00:00:00+00,Thu 10 Feb 2022,690,2540,0,3808832,3701721,240221,4049053,3941942,85.9871091104581,83.7124623612231,410
-7.6926,53.28823,2022/02/11 00:00:00+00,Fri 11 Feb 2022,556,4909,0,3809388,3706630,240221,4049609,3946851,85.9989165213923,83.8167116063239,411
-7.6926,53.28823,2022/02/12 00:00:00+00,Sat 12 Feb 2022,1396,5460,0,3810784,3712090,240221,4051005,3952311,86.0285624668315,83.932662080606,412
-7.6926,53.28823,2022/02/13 00:00:00+00,Sun 13 Feb 2022,1567,4706,0,3812351,3716796,240221,4052572,3957017,86.0618398282234,84.0326003465348,413
-7.6926,53.28823,2022/02/14 00:00:00+00,Mon 14 Feb 2022,175,949,1,3812526,3717745,240222,4052748,3957967,86.0655774259292,84.0527748796058,414
-7.6926,53.28823,2022/02/15 00:00:00+00,Tue 15 Feb 2022,649,811,1,3813175,3718556,240223,4053398,3958779,86.0793810538199,84.0700187962939,415
-7.6926,53.28823,2022/02/16 00:00:00+00,Wed 16 Feb 2022,794,1782,0,3813969,3720338,240223,4054192,3960561,86.0962427161972,84.1078619730651,416
-7.6926,53.28823,2022/02/17 00:00:00+00,Thu 17 Feb 2022,795,1185,2,3814764,3721523,240225,4054989,3961748,86.1131680876263,84.1330695212286,417
-7.6926,53.28823,2022/02/18 00:00:00+00,Fri 18 Feb 2022,796,3289,0,3815560,3724812,240225,4055785,3965037,86.1300722227048,84.2029158783556,418
-7.6926,53.28823,2022/02/19 00:00:00+00,Sat 19 Feb 2022,978,3550,0,3816538,3728362,240225,4056763,3968587,86.1508413735926,84.2783049229895,419
-7.6926,53.28823,2022/02/20 00:00:00+00,Sun 20 Feb 2022,1367,3587,0,3817905,3731949,240225,4058130,3972174,86.1798714648643,84.3544797125957,420
-7.6926,53.28823,2022/02/21 00:00:00+00,Mon 21 Feb 2022,253,987,2,3818158,3732936,240227,4058385,3973163,86.1852867342676,84.3754824633402,421
-7.6926,53.28823,2022/02/22 00:00:00+00,Tue 22 Feb 2022,475,971,0,3818633,3733907,240227,4058860,3974134,86.1953740008032,84.3961029597739,422
-7.6926,53.28823,2022/02/23 00:00:00+00,Wed 23 Feb 2022,829,1270,1,3819462,3735177,240228,4059690,3975405,86.2130001718021,84.4230943613879,423
-7.6926,53.28823,2022/02/24 00:00:00+00,Thu 24 Feb 2022,658,1227,0,3820120,3736404,240228,4060348,3976632,86.2269736904976,84.4491513635755,424
-7.6926,53.28823,2022/02/25 00:00:00+00,Fri 25 Feb 2022,689,1219,0,3820809,3737623,240228,4061037,3977851,86.2416055360618,84.4750384749582,425
-7.6926,53.28823,2022/02/26 00:00:00+00,Sat 26 Feb 2022,960,2088,0,3821769,3739711,240228,4061997,3979939,86.2619924326388,84.5193799750133,426
-7.6926,53.28823,2022/02/27 00:00:00+00,Sun 27 Feb 2022,670,1781,0,3822439,3741492,240228,4062667,3981720,86.2762207875416,84.5572019154339,427
-7.6926,53.28823,2022/02/28 00:00:00+00,Mon 28 Feb 2022,86,424,0,3822525,3741916,240228,4062753,3982144,86.2780471136933,84.5662061280888,428
-7.6926,53.28823,2022/03/01 00:00:00+00,Tue 01 Mar 2022,124,939,0,3822649,3742855,240228,4062877,3983083,86.2806804211678,84.5861470613032,429
-7.6926,53.28823,2022/03/02 00:00:00+00,Wed 02 Mar 2022,206,988,2,3822855,3743843,240230,4063085,3984073,86.2850975820928,84.6071710483983,430
-7.6926,53.28823,2022/03/03 00:00:00+00,Thu 03 Mar 2022,273,1274,0,3823128,3745117,240230,4063358,3985347,86.2908951058069,84.6342261590641,431
-7.6926,53.28823,2022/03/04 00:00:00+00,Fri 04 Mar 2022,731,1500,2,3823859,3746617,240232,4064091,3986849,86.3064613507975,84.6661231576669,432
-7.6926,53.28823,2022/03/05 00:00:00+00,Sat 05 Mar 2022,962,3341,0,3824821,3749958,240232,4065053,3990190,86.3268907200758,84.7370738050252,433
-7.6926,53.28823,2022/03/06 00:00:00+00,Sun 06 Mar 2022,456,1914,0,3825277,3751872,240232,4065509,3992104,86.3365744959499,84.7777201800758,434
-7.6926,53.28823,2022/03/07 00:00:00+00,Mon 07 Mar 2022,112,119,0,3825389,3751991,240232,4065621,3992223,86.3389529672172,84.7802473057973,435
-7.6926,53.28823,2022/03/08 00:00:00+00,Tue 08 Mar 2022,119,492,0,3825508,3752483,240232,4065740,3992715,86.3414800929388,84.790695590293,436
-7.6926,53.28823,2022/03/09 00:00:00+00,Wed 09 Mar 2022,124,336,0,3825632,3752819,240232,4065864,3993051,86.3441134004133,84.797831004095,437
-7.6926,53.28823,2022/03/10 00:00:00+00,Thu 10 Mar 2022,255,507,0,3825887,3753326,240232,4066119,3993558,86.3495286698166,84.8085978338498,438
-7.6926,53.28823,2022/03/11 00:00:00+00,Fri 11 Mar 2022,495,2175,0,3826382,3755501,240232,4066614,3995733,86.3600406633641,84.8547868964072,439
-7.6926,53.28823,2022/03/12 00:00:00+00,Sat 12 Mar 2022,472,2387,2,3826854,3757888,240234,4067088,3998122,86.370106693549,84.9055205379932,440
-7.6926,53.28823,2022/03/13 00:00:00+00,Sun 13 Mar 2022,358,1082,0,3827212,3758970,240234,4067446,3999204,86.3777093070643,84.9284982693436,441
-7.6926,53.28823,2022/03/14 00:00:00+00,Mon 14 Mar 2022,107,120,0,3827319,3759090,240234,4067553,3999324,86.3799815965786,84.9310466314157,442
-7.6926,53.28823,2022/03/15 00:00:00+00,Tue 15 Mar 2022,222,755,0,3827541,3759845,240234,4067775,4000079,86.384696066412,84.9470800761196,443
-7.6926,53.28823,2022/03/16 00:00:00+00,Wed 16 Mar 2022,196,795,0,3827737,3760640,240234,4067971,4000874,86.3888583911298,84.9639629748474,444
-7.6926,53.28823,2022/03/18 00:00:00+00,Fri 18 Mar 2022,2,6,0,3827739,3760646,240234,4067973,4000880,86.388900863831,84.9640903929511,445
-7.6926,53.28823,2022/03/19 00:00:00+00,Sat 19 Mar 2022,742,2778,0,3828481,3763424,240234,4068715,4003658,86.4046582359771,85.0230849749209,446
-7.6926,53.28823,2022/03/20 00:00:00+00,Sun 20 Mar 2022,394,1400,0,3828875,3764824,240234,4069109,4005058,86.4130253581139,85.0528158657625,447
-7.6926,53.28823,2022/03/21 00:00:00+00,Mon 21 Mar 2022,53,108,0,3828928,3764932,240234,4069162,4005166,86.4141508846957,85.0551093916274,448
-7.6926,53.28823,2022/03/22 00:00:00+00,Tue 22 Mar 2022,137,569,0,3829065,3765501,240234,4069299,4005735,86.4170602647281,85.0671928751194,449
-7.6926,53.28823,2022/03/23 00:00:00+00,Wed 23 Mar 2022,95,219,0,3829160,3765720,240234,4069394,4005954,86.4190777180352,85.0718436359011,450
-7.6926,53.28823,2022/03/24 00:00:00+00,Thu 24 Mar 2022,148,237,0,3829308,3765957,240234,4069542,4006191,86.4222206979242,85.0768766509935,451
-7.6926,53.28823,2022/03/25 00:00:00+00,Fri 25 Mar 2022,437,1614,0,3829745,3767571,240234,4069979,4007805,86.4315009831369,85.1111521208637,452
-7.6926,53.28823,2022/03/26 00:00:00+00,Sat 26 Mar 2022,871,1847,0,3830616,3769418,240234,4070850,4009652,86.4499978445104,85.150375660424,453
-7.6926,53.28823,2022/03/27 00:00:00+00,Sun 27 Mar 2022,379,802,0,3830995,3770220,240234,4071229,4010454,86.4580464213882,85.1674072136061,454
-7.6926,53.28823,2022/03/27 23:00:00+00,Mon 28 Mar 2022,37,52,0,3831032,3770272,240234,4071266,4010506,86.4588321663605,85.1685115038373,455
-7.6926,53.28823,2022/03/28 23:00:00+00,Tue 29 Mar 2022,137,184,3,3831169,3770456,240237,4071406,4010693,86.4618052554446,85.1724827013997,456
-7.6926,53.28823,2022/03/29 23:00:00+00,Wed 30 Mar 2022,107,133,0,3831276,3770589,240237,4071513,4010826,86.464077544959,85.1753071360297,457
-7.6926,53.28823,2022/03/30 23:00:00+00,Thu 31 Mar 2022,222,349,0,3831498,3770938,240237,4071735,4011175,86.4687920147924,85.1827186223894,458
-7.6926,53.28823,2022/03/31 23:00:00+00,Fri 01 Apr 2022,307,900,0,3831805,3771838,240237,4072042,4012075,86.4753115744269,85.2018313379304,459
-7.6926,53.28823,2022/04/01 23:00:00+00,Sat 02 Apr 2022,724,1538,0,3832529,3773376,240237,4072766,4013613,86.4906866922621,85.2344928451549,460
-7.6926,53.28823,2022/04/02 23:00:00+00,Sun 03 Apr 2022,534,817,0,3833063,3774193,240237,4073300,4014430,86.5020269034831,85.251842943596,461
-7.6926,53.28823,2022/04/03 23:00:00+00,Mon 04 Apr 2022,45,49,0,3833108,3774242,240237,4073345,4014479,86.5029825392602,85.2528835247755,462
-7.6926,53.28823,2022/04/04 23:00:00+00,Tue 05 Apr 2022,128,165,0,3833236,3774407,240237,4073473,4014644,86.5057007921371,85.2563875226247,463
-7.6926,53.28823,2022/04/05 23:00:00+00,Wed 06 Apr 2022,157,202,0,3833393,3774609,240237,4073630,4014846,86.5090348991815,85.2606772654461,464
-7.6926,53.28823,2022/04/06 23:00:00+00,Thu 07 Apr 2022,117,172,0,3833510,3774781,240237,4073747,4015018,86.5115195522018,85.2643299177495,465
-7.6926,53.28823,2022/04/07 23:00:00+00,Fri 08 Apr 2022,264,408,0,3833774,3775189,240237,4074011,4015426,86.5171259487605,85.2729943487947,466
-7.6926,53.28823,2022/04/08 23:00:00+00,Sat 09 Apr 2022,558,1014,0,3834332,3776203,240237,4074569,4016440,86.5289758323959,85.2945280083043,467
-7.6926,53.28823,2022/04/09 23:00:00+00,Sun 10 Apr 2022,410,718,0,3834742,3776921,240237,4074979,4017158,86.5376827361424,85.3097757080359,468
-7.6926,53.28823,2022/04/10 23:00:00+00,Mon 11 Apr 2022,66,85,0,3834808,3777006,240237,4075045,4017243,86.5390843352821,85.311580797837,469
-7.6926,53.28823,2022/04/11 23:00:00+00,Tue 12 Apr 2022,190,171,0,3834998,3777177,240237,4075235,4017414,86.5431192418963,85.3152122137897,470
-7.6926,53.28823,2022/04/12 23:00:00+00,Wed 13 Apr 2022,145,218,0,3835143,3777395,240237,4075380,4017632,86.5461985127334,85.3198417382208,471
-7.6926,53.28823,2022/04/13 23:00:00+00,Thu 14 Apr 2022,349,409,0,3835492,3777804,240237,4075729,4018041,86.5536099990932,85.3285274056166,472
-7.6926,53.28823,2022/04/14 23:00:00+00,Fri 15 Apr 2022,439,978,0,3835931,3778782,240237,4076168,4019019,86.5629327570071,85.3492965565045,473
-7.6926,53.28823,2022/04/15 23:00:00+00,Sat 16 Apr 2022,42,83,0,3835973,3778865,240237,4076210,4019102,86.5638246837323,85.3510591736044,474
-7.6926,53.28823,2022/04/17 23:00:00+00,Mon 18 Apr 2022,35,61,0,3836008,3778926,240237,4076245,4019163,86.5645679560034,85.3523545909911,475
-7.6926,53.28823,2022/04/18 23:00:00+00,Tue 19 Apr 2022,213,257,1,3836221,3779183,240238,4076459,4019421,86.569112535032,85.3578335694462,476
-7.6926,53.28823,2022/04/19 23:00:00+00,Wed 20 Apr 2022,241,592,0,3836462,3779775,240238,4076700,4020013,86.5742304955269,85.370405489002,477
