X,Y,VaccinationDate,VaccineText,Dose1,Dose2,SingleDose,Dose1Cum,Dose2Cum,SingleDoseCum,PartiallyVacc,FullyVacc,PartialPercent,FullyPercent,ObjectId
-7.6926,53.28823,2021/04/13 23:00:00+00,Wed 14 Apr 2021,20314,6573,2,825921,353314,175,826096,353489,17.5432642861709,7.50681633763419,1
-7.6926,53.28823,2020/12/28 00:00:00+00,Mon 28 Dec 2020,176,23,4,176,23,4,180,27,0.00382254310819899,0.000573381466229849,2
-7.6926,53.28823,2021/04/14 23:00:00+00,Thu 15 Apr 2021,27092,10772,1,853013,364086,176,853189,364262,18.1186207330066,7.7355955426599,3
-7.6926,53.28823,2020/12/29 00:00:00+00,Tue 29 Dec 2020,72,1,0,248,24,4,252,28,0.00535156035147859,0.000594617816830955,4
-7.6926,53.28823,2021/04/15 23:00:00+00,Fri 16 Apr 2021,27932,9809,1,880945,373895,177,881122,374072,18.7118157143473,7.94392414205675,5
-7.6926,53.28823,2020/12/30 00:00:00+00,Wed 30 Dec 2020,1053,1,0,1301,25,4,1305,29,0.0277134375344427,0.00061585416743206,6
-7.6926,53.28823,2021/04/16 23:00:00+00,Sat 17 Apr 2021,15823,4532,2,896768,378427,179,896947,378606,19.0478809626098,8.04020975568216,7
-7.6926,53.28823,2020/12/31 00:00:00+00,Thu 31 Dec 2020,1027,1,0,2328,26,4,2332,30,0.0495231696017781,0.000637090518033166,8
-7.6926,53.28823,2021/04/17 23:00:00+00,Sun 18 Apr 2021,1043,465,0,897811,378892,179,897990,379071,19.0700304762867,8.05008465871167,9
-7.6926,53.28823,2021/01/01 00:00:00+00,Fri 01 Jan 2021,806,0,0,3134,26,4,3138,30,0.0666396681862691,0.000637090518033166,10
-7.6926,53.28823,2021/04/18 23:00:00+00,Mon 19 Apr 2021,6712,2228,0,904523,381120,179,904702,381299,19.2125688615214,8.09739924785093,11
-7.6926,53.28823,2021/01/02 00:00:00+00,Sat 02 Jan 2021,1015,0,0,4149,26,4,4153,30,0.0881945640463912,0.000637090518033166,12
-7.6926,53.28823,2021/01/03 00:00:00+00,Sun 03 Jan 2021,18,2,0,4167,28,4,4171,32,0.0885768183572111,0.000679563219235377,13
-7.6926,53.28823,2021/04/19 23:00:00+00,Tue 20 Apr 2021,15039,7281,1,919562,388401,180,919742,388581,19.531963574562,8.25204235292819,14
-7.6926,53.28823,2021/01/04 00:00:00+00,Mon 04 Jan 2021,1186,3,0,5353,31,4,5357,35,0.113763130170122,0.000743272271038693,15
-7.6926,53.28823,2021/01/05 00:00:00+00,Tue 05 Jan 2021,3514,6,0,8867,37,4,8871,41,0.188387666182407,0.000870690374645326,16
-7.6926,53.28823,2021/04/20 23:00:00+00,Wed 21 Apr 2021,26659,9838,2,946221,398239,182,946403,398421,20.0981459179381,8.46100804284306,17
-7.6926,53.28823,2021/04/21 23:00:00+00,Thu 22 Apr 2021,31582,12157,1,977803,410396,183,977986,410579,20.7688535789728,8.7191995934513,18
-7.6926,53.28823,2021/01/06 00:00:00+00,Wed 06 Jan 2021,6762,7,0,15629,44,4,15633,48,0.331987868947083,0.00101934482885307,19
-7.6926,53.28823,2021/04/22 23:00:00+00,Fri 23 Apr 2021,33551,12347,1,1011354,422743,184,1011538,422927,21.4813756143411,8.98142605067375,20
-7.6926,53.28823,2021/01/07 00:00:00+00,Thu 07 Jan 2021,11714,7,0,27343,51,4,27347,55,0.580750479888433,0.0011679992830608,21
-7.6926,53.28823,2021/01/08 00:00:00+00,Fri 08 Jan 2021,12669,5,0,40012,56,4,40016,60,0.849793805653839,0.00127418103606633,22
-7.6926,53.28823,2021/04/23 23:00:00+00,Sat 24 Apr 2021,23653,6976,1,1035007,429719,185,1035192,429904,21.9837002514596,9.12959206881767,23
-7.6926,53.28823,2021/01/09 00:00:00+00,Sat 09 Jan 2021,8070,5,0,48082,61,4,48086,65,1.02117115500476,0.00138036278907186,24
-7.6926,53.28823,2021/04/24 23:00:00+00,Sun 25 Apr 2021,9719,281,2,1044726,430000,187,1044913,430187,22.190138815653,9.13560195603778,25
-7.6926,53.28823,2021/01/10 00:00:00+00,Sun 10 Jan 2021,4769,3,1,52851,64,5,52856,69,1.12246854737203,0.00146530819147628,26
-7.6926,53.28823,2021/01/11 00:00:00+00,Mon 11 Jan 2021,8332,7,0,61183,71,5,61188,76,1.29940982058044,0.00161396264568402,27
-7.6926,53.28823,2021/04/25 23:00:00+00,Mon 26 Apr 2021,15532,3027,1,1060258,433027,188,1060446,433215,22.5200030495399,9.19990562565793,28
-7.6926,53.28823,2021/01/12 00:00:00+00,Tue 12 Jan 2021,8866,8,0,70049,79,5,70054,84,1.48769130500985,0.00178385345049286,29
-7.6926,53.28823,2021/01/13 00:00:00+00,Wed 13 Jan 2021,9868,5,0,79917,84,5,79922,89,1.69725161274156,0.00189003520349839,30
-7.6926,53.28823,2021/04/26 23:00:00+00,Tue 27 Apr 2021,25873,7779,5,1086131,440806,193,1086324,440999,23.0695573303954,9.36520937873693,31
-7.6926,53.28823,2021/01/14 00:00:00+00,Thu 14 Jan 2021,8064,4,0,87981,88,5,87986,93,1.86850154398887,0.00197498060590281,32
-7.6926,53.28823,2021/04/27 23:00:00+00,Wed 28 Apr 2021,25985,8570,5,1112116,449376,198,1112314,449574,23.6214900825181,9.54731108514141,33
-7.6926,53.28823,2021/01/15 00:00:00+00,Fri 15 Jan 2021,7671,2,0,95652,90,5,95657,95,2.03140558944995,0.00201745330710502,34
-7.6926,53.28823,2021/04/28 23:00:00+00,Thu 29 Apr 2021,31646,11316,4,1143762,460692,202,1143964,460894,24.2936205790431,9.78770657394593,35
-7.6926,53.28823,2021/01/16 00:00:00+00,Sat 16 Jan 2021,5214,2,0,100866,92,5,100871,97,2.14213192148411,0.00205992600830724,36
-7.6926,53.28823,2021/04/29 23:00:00+00,Fri 30 Apr 2021,36073,13499,7,1179835,474191,209,1180044,474400,25.059828108731,10.0745247251645,37
-7.6926,53.28823,2021/01/17 00:00:00+00,Sun 17 Jan 2021,1107,4,0,101973,96,5,101978,101,2.16564056159954,0.00214487141071166,38
-7.6926,53.28823,2021/04/30 23:00:00+00,Sat 01 May 2021,16509,6661,16,1196344,480852,225,1196569,481077,25.4107588024142,10.216319838128,39
-7.6926,53.28823,2021/01/18 00:00:00+00,Mon 18 Jan 2021,8689,6,0,110662,102,5,110667,107,2.35016321197254,0.00227228951431829,40
-7.6926,53.28823,2021/05/01 23:00:00+00,Sun 02 May 2021,12403,891,10,1208747,481743,235,1208982,481978,25.6743656224258,10.2354537900196,41
-7.6926,53.28823,2021/01/19 00:00:00+00,Tue 19 Jan 2021,8363,18,0,119025,120,5,119030,125,2.52776281204959,0.00265454382513819,42
-7.6926,53.28823,2021/05/02 23:00:00+00,Mon 03 May 2021,14213,900,14,1222960,482643,249,1223209,482892,25.9764951824277,10.254863814469,43
-7.6926,53.28823,2021/01/20 00:00:00+00,Wed 20 Jan 2021,8433,957,0,127458,1077,5,127463,1082,2.70684895666871,0.0229777313503962,44
-7.6926,53.28823,2021/05/03 23:00:00+00,Tue 04 May 2021,26581,6752,6,1249541,489395,255,1249796,489650,26.5411060358593,10.3983790718313,45
-7.6926,53.28823,2021/01/21 00:00:00+00,Thu 21 Jan 2021,8975,958,0,136433,2035,5,136438,2040,2.89744520331364,0.0433221552262553,46
-7.6926,53.28823,2021/05/04 23:00:00+00,Wed 05 May 2021,32020,13419,68,1281561,502814,323,1281884,503137,27.2225380539476,10.6847937323884,47
-7.6926,53.28823,2021/01/22 00:00:00+00,Fri 22 Jan 2021,6750,965,0,143183,3000,5,143188,3005,3.0407905698711,0.0638152335563221,48
-7.6926,53.28823,2021/05/05 23:00:00+00,Thu 06 May 2021,37211,14356,130,1318772,517170,453,1319225,517623,28.0155246217434,10.992423507196,49
-7.6926,53.28823,2021/05/06 23:00:00+00,Fri 07 May 2021,40535,15038,92,1359307,532208,545,1359852,532753,28.8782938376145,11.3137294917908,50
-7.6926,53.28823,2021/05/07 23:00:00+00,Sat 08 May 2021,25549,7012,9,1384856,539220,554,1385410,539774,29.4210524862776,11.4628299093611,51
-7.6926,53.28823,2021/05/08 23:00:00+00,Sun 09 May 2021,19623,901,1,1404479,540121,555,1405034,540676,29.8377946304737,11.4819850976033,52
-7.6926,53.28823,2021/05/09 23:00:00+00,Mon 10 May 2021,28761,4605,167,1433240,544726,722,1433962,545448,30.4521197806625,11.5833249626718,53
-7.6926,53.28823,2021/05/10 23:00:00+00,Tue 11 May 2021,33856,14787,149,1467096,559513,871,1467967,560384,31.1742618828531,11.9005110952499,54
-7.6926,53.28823,2021/05/11 23:00:00+00,Wed 12 May 2021,31215,20909,164,1498311,580422,1035,1499346,581457,31.8406373283652,12.348024711467,55
-7.6926,53.28823,2021/05/12 23:00:00+00,Thu 13 May 2021,35920,25456,146,1534231,605878,1181,1535412,607059,32.6065475491446,12.8917177595565,56
-7.6926,53.28823,2021/05/13 23:00:00+00,Fri 14 May 2021,38127,27935,230,1572358,633813,1411,1573769,635224,33.4211102491512,13.4898395742367,57
-7.6926,53.28823,2021/05/14 23:00:00+00,Sat 15 May 2021,28790,12415,13,1601148,646228,1424,1602572,647652,34.0327808555149,13.7537649395072,58
-7.6926,53.28823,2021/05/15 23:00:00+00,Sun 16 May 2021,23112,1147,8,1624260,647375,1432,1625692,648807,34.5237652814124,13.7782929244515,59
-7.6926,53.28823,2021/05/16 23:00:00+00,Mon 17 May 2021,35323,3918,110,1659583,651293,1542,1661125,652835,35.2762328922614,13.8638329446727,60
-7.6926,53.28823,2021/05/17 23:00:00+00,Tue 18 May 2021,38976,12462,118,1698559,663755,1660,1700219,665415,36.106446782661,14.1309862352346,61
-7.6926,53.28823,2021/05/18 23:00:00+00,Wed 19 May 2021,36944,17567,201,1735503,681322,1861,1737364,683183,36.8952710257391,14.5083137127151,62
-7.6926,53.28823,2021/05/19 23:00:00+00,Thu 20 May 2021,39003,19639,128,1774506,700961,1989,1776495,702950,37.726270661111,14.9280926550471,63
-7.6926,53.28823,2021/05/20 23:00:00+00,Fri 21 May 2021,25753,23216,14928,1800259,724177,16917,1817176,741094,38.5901866399145,15.7381320123757,64
-7.6926,53.28823,2021/05/21 23:00:00+00,Sat 22 May 2021,16519,10228,13513,1816778,734405,30430,1847208,764835,39.2279567211669,16.2423042119965,65
-7.6926,53.28823,2021/05/22 23:00:00+00,Sun 23 May 2021,8167,5511,10200,1824945,739916,40630,1865575,780546,39.6180047726574,16.5759485162905,66
-7.6926,53.28823,2021/05/23 23:00:00+00,Mon 24 May 2021,22467,8175,8441,1847412,748091,49071,1896483,797162,40.2743778970364,16.9288117178785,67
-7.6926,53.28823,2021/05/24 23:00:00+00,Tue 25 May 2021,30224,16477,3216,1877636,764568,52287,1929923,816855,40.9845214611374,17.3470191702661,68
-7.6926,53.28823,2021/05/25 23:00:00+00,Wed 26 May 2021,19862,25397,3043,1897498,789965,55330,1952828,845295,41.4709400716557,17.9509809813615,69
-7.6926,53.28823,2021/05/26 23:00:00+00,Thu 27 May 2021,16926,35961,546,1914424,825926,55876,1970300,881802,41.8419815893582,18.7262564327561,70
-7.6926,53.28823,2021/05/27 23:00:00+00,Fri 28 May 2021,26915,31783,1549,1941339,857709,57425,1998764,915134,42.4464530728681,19.4341064709921,71
-7.6926,53.28823,2021/05/28 23:00:00+00,Sat 29 May 2021,24392,7361,523,1965731,865070,57948,2023679,923018,42.9755567480946,19.6015338591312,72
-7.6926,53.28823,2021/05/29 23:00:00+00,Sun 30 May 2021,24176,1655,204,1989907,866725,58152,2048059,924877,43.4932989757496,19.6410122348987,73
-7.6926,53.28823,2021/05/30 23:00:00+00,Mon 31 May 2021,22469,7294,3434,2012376,874019,61586,2073962,935605,44.04338416537,19.8688358041473,74
-7.6926,53.28823,2021/05/31 23:00:00+00,Tue 01 Jun 2021,27410,11460,3637,2039786,885479,65223,2105009,950702,44.7027091424825,20.1894409891722,75
-7.6926,53.28823,2021/06/01 23:00:00+00,Wed 02 Jun 2021,18580,20844,3992,2058366,906323,69215,2127581,975538,45.1820560482507,20.7168669927013,76
-7.6926,53.28823,2021/06/02 23:00:00+00,Thu 03 Jun 2021,16579,30650,1968,2074945,936973,71183,2146128,1008156,45.5759266428494,21.4095542766081,77
-7.6926,53.28823,2021/06/03 23:00:00+00,Fri 04 Jun 2021,28924,23307,141,2103869,960280,71324,2175193,1031604,46.1931611730705,21.9075042255029,78
-7.6926,53.28823,2021/06/04 23:00:00+00,Sat 05 Jun 2021,20859,11446,25,2124728,971726,71349,2196077,1043075,46.636661119024,22.1511064032481,79
-7.6926,53.28823,2021/06/05 23:00:00+00,Sun 06 Jun 2021,19859,3869,33,2144587,975595,71382,2215969,1046977,47.0590946051812,22.2339706432937,80
-7.6926,53.28823,2021/06/06 23:00:00+00,Mon 07 Jun 2021,19703,4522,36,2164290,980117,71418,2235708,1051535,47.4782789296964,22.3307659293335,81
-7.6926,53.28823,2021/06/07 23:00:00+00,Tue 08 Jun 2021,26319,18276,35,2190609,998393,71453,2262062,1069846,48.037941713438,22.7196247451903,82
-7.6926,53.28823,2021/06/08 23:00:00+00,Wed 09 Jun 2021,32680,20050,163,2223289,1018443,71616,2294905,1090059,48.7354071762301,23.1488750998905,83
-7.6926,53.28823,2021/06/09 23:00:00+00,Thu 10 Jun 2021,27583,27418,255,2250872,1045861,71871,2322743,1117732,49.3265847042636,23.7365486300749,84
-7.6926,53.28823,2021/06/10 23:00:00+00,Fri 11 Jun 2021,26338,32831,23,2277210,1078692,71894,2349104,1150586,49.8863961424594,24.4342476927236,85
-7.6926,53.28823,2021/06/11 23:00:00+00,Sat 12 Jun 2021,12109,19666,97,2289319,1098358,71991,2361310,1170349,50.1456070378965,24.8539416896532,86
-7.6926,53.28823,2021/06/12 23:00:00+00,Sun 13 Jun 2021,8495,18136,826,2297814,1116494,72817,2370631,1189311,50.3435510618494,25.2566253697514,87
-7.6926,53.28823,2021/06/13 23:00:00+00,Mon 14 Jun 2021,15938,31248,34,2313752,1147742,72851,2386603,1220593,50.6827380536502,25.9209408892552,88
-7.6926,53.28823,2021/06/14 23:00:00+00,Tue 15 Jun 2021,14603,41470,194,2328355,1189212,73045,2401400,1262257,50.9969723334948,26.8057322006997,89
-7.6926,53.28823,2021/06/15 23:00:00+00,Wed 16 Jun 2021,13330,48311,207,2341685,1237523,73252,2414937,1310775,51.284448811582,27.8360774591641,90
-7.6926,53.28823,2021/06/16 23:00:00+00,Thu 17 Jun 2021,21485,42586,522,2363170,1280109,73774,2436944,1353883,51.7517971792605,28.7515340608765,91
-7.6926,53.28823,2021/06/17 23:00:00+00,Fri 18 Jun 2021,11940,49985,542,2375110,1330094,74316,2449426,1404410,52.0168693074635,29.8245431476986,92
-7.6926,53.28823,2021/06/18 23:00:00+00,Sat 19 Jun 2021,6235,32731,422,2381345,1362825,74738,2456083,1437563,52.1582396934151,30.5285918791771,93
-7.6926,53.28823,2021/06/19 23:00:00+00,Sun 20 Jun 2021,8453,26094,171,2389798,1388919,74909,2464707,1463828,52.341381980999,31.0863646277151,94
-7.6926,53.28823,2021/06/20 23:00:00+00,Mon 21 Jun 2021,15395,32251,557,2405193,1421170,75466,2480659,1496636,52.6801442457878,31.7830868182362,95
-7.6926,53.28823,2021/06/21 23:00:00+00,Tue 22 Jun 2021,15059,43460,710,2420252,1464630,76176,2496428,1540806,53.0150202584167,32.721096424287,96
-7.6926,53.28823,2021/06/22 23:00:00+00,Wed 23 Jun 2021,19991,39310,869,2440243,1503940,77045,2517288,1580985,53.4580105319557,33.5743517550888,97
-7.6926,53.28823,2021/06/23 23:00:00+00,Thu 24 Jun 2021,18928,44173,1025,2459171,1548113,78070,2537241,1626183,53.8817394354996,34.5341923295576,98
-7.6926,53.28823,2021/06/24 23:00:00+00,Fri 25 Jun 2021,15110,50062,814,2474281,1598175,78884,2553165,1677059,54.2199070824716,35.6146129027394,99
-7.6926,53.28823,2021/06/25 23:00:00+00,Sat 26 Jun 2021,8972,30472,484,2483253,1628647,79368,2562621,1708015,54.4207180137556,36.2720053719472,100
-7.6926,53.28823,2021/06/26 23:00:00+00,Sun 27 Jun 2021,8666,30415,49,2491919,1659062,79417,2571336,1738479,54.6057928092443,36.9189495566593,101
-7.6926,53.28823,2021/06/27 23:00:00+00,Mon 28 Jun 2021,24140,24557,502,2516059,1683619,79919,2595978,1763538,55.1290989607567,37.4511112663724,102
-7.6926,53.28823,2021/06/28 23:00:00+00,Tue 29 Jun 2021,28061,30906,792,2544120,1714525,80711,2624831,1795236,55.7418313846504,38.1242611077263,103
-7.6926,53.28823,2021/06/29 23:00:00+00,Wed 30 Jun 2021,22458,36748,564,2566578,1751273,81275,2647853,1832548,56.2307346481891,38.9166318213547,104
-7.6926,53.28823,2021/06/30 23:00:00+00,Thu 01 Jul 2021,14839,48218,619,2581417,1799491,81894,2663311,1881385,56.5590061557809,39.9537514756609,105
-7.6926,53.28823,2021/07/01 23:00:00+00,Fri 02 Jul 2021,13546,47159,801,2594963,1846650,82695,2677658,1929345,56.863684077855,40.9722468504899,106
-7.6926,53.28823,2021/07/02 23:00:00+00,Sat 03 Jul 2021,9233,30385,491,2604196,1877035,83186,2687382,1960221,57.0701863511002,41.6279404116497,107
-7.6926,53.28823,2021/07/03 23:00:00+00,Sun 04 Jul 2021,6381,27725,222,2610577,1904760,83408,2693985,1988168,57.2104099741193,42.2214327018988,108
-7.6926,53.28823,2021/07/04 23:00:00+00,Mon 05 Jul 2021,15467,33319,5321,2626044,1938079,88729,2714773,2026808,57.651871230415,43.0420052891255,109
-7.6926,53.28823,2021/07/05 23:00:00+00,Tue 06 Jul 2021,12288,48245,5469,2638332,1986324,94198,2732530,2080522,58.0289651080389,44.1826946253133,110
-7.6926,53.28823,2021/07/06 23:00:00+00,Wed 07 Jul 2021,19593,43639,5040,2657925,2029963,99238,2757163,2129201,58.5520801323959,45.2164589362245,111
-7.6926,53.28823,2021/07/07 23:00:00+00,Thu 08 Jul 2021,17666,45481,5977,2675591,2075444,105215,2780806,2180659,59.0541711696578,46.3092390654562,112
-7.6926,53.28823,2021/07/08 23:00:00+00,Fri 09 Jul 2021,13430,45002,6516,2689021,2120446,111731,2800752,2232177,59.4777514187475,47.4032933757239,113
-7.6926,53.28823,2021/07/09 23:00:00+00,Sat 10 Jul 2021,8544,23752,4350,2697565,2144198,116081,2813646,2260279,59.7515729233981,48.0000773003162,114
-7.6926,53.28823,2021/07/10 23:00:00+00,Sun 11 Jul 2021,15172,16050,2146,2712737,2160248,118227,2830964,2278475,60.1193440431081,48.3864939358539,115
-7.6926,53.28823,2021/07/11 23:00:00+00,Mon 12 Jul 2021,17025,31631,6069,2729762,2191879,124296,2854058,2316175,60.60977632389,49.1871043535156,116
-7.6926,53.28823,2021/07/12 23:00:00+00,Tue 13 Jul 2021,20012,36428,8472,2749774,2228307,132768,2882542,2361075,61.2146725344119,50.1406164955052,117
-7.6926,53.28823,2021/07/13 23:00:00+00,Wed 14 Jul 2021,20703,35566,9314,2770477,2263873,142082,2912559,2405955,61.8521240704053,51.0937039104828,118
-7.6926,53.28823,2021/07/14 23:00:00+00,Thu 15 Jul 2021,23530,28708,9551,2794007,2292581,151633,2945640,2444214,62.5546437846405,51.9061854481305,119
-7.6926,53.28823,2021/07/15 23:00:00+00,Fri 16 Jul 2021,23463,27283,9151,2817470,2319864,160784,2978254,2480648,63.2472461231449,52.6799106459312,120
-7.6926,53.28823,2021/07/16 23:00:00+00,Sat 17 Jul 2021,11430,19334,4665,2828900,2339198,165449,2994349,2504647,63.5890451860697,53.1895618240071,121
-7.6926,53.28823,2021/07/17 23:00:00+00,Sun 18 Jul 2021,16809,15730,1921,2845709,2354928,167370,3013079,2522298,63.9868020328284,53.5644046484673,122
-7.6926,53.28823,2021/07/18 23:00:00+00,Mon 19 Jul 2021,24792,18287,6224,2870501,2373215,173594,3044095,2546809,64.6454686830723,54.0849288380509,123
-7.6926,53.28823,2021/07/19 23:00:00+00,Tue 20 Jul 2021,30488,18045,7683,2900989,2391260,181277,3082266,2572537,65.4560814218671,54.6312976663162,124
-7.6926,53.28823,2021/07/20 23:00:00+00,Wed 21 Jul 2021,30243,19703,6868,2931232,2410963,188145,3119377,2599108,66.2441836290247,55.1955687381382,125
-7.6926,53.28823,2021/07/21 23:00:00+00,Thu 22 Jul 2021,33439,15795,6915,2964671,2426758,195060,3159731,2621818,67.1011553211817,55.6778462602893,126
-7.6926,53.28823,2021/07/22 23:00:00+00,Fri 23 Jul 2021,27004,20690,5589,2991675,2447448,200649,3192324,2648097,67.7933116963236,56.2359163177357,127
-7.6926,53.28823,2021/07/23 23:00:00+00,Sat 24 Jul 2021,15373,14701,2256,3007048,2462149,202905,3209953,2665054,68.1676873210705,56.5960211148787,128
-7.6926,53.28823,2021/07/24 23:00:00+00,Sun 25 Jul 2021,14671,13575,1029,3021719,2475724,203934,3225653,2679658,68.5010980255078,56.9061567790572,129
-7.6926,53.28823,2021/07/25 23:00:00+00,Mon 26 Jul 2021,23754,18121,3398,3045473,2493845,207332,3252805,2701177,69.077707417029,57.3631418076424,130
-7.6926,53.28823,2021/07/26 23:00:00+00,Tue 27 Jul 2021,25394,23732,3648,3070867,2517577,210980,3281847,2728557,69.6944535111864,57.9445930871007,131
-7.6926,53.28823,2021/07/27 23:00:00+00,Wed 28 Jul 2021,23366,25129,3244,3094233,2542706,214224,3308457,2756930,70.2595528006818,58.5471320627058,132
-7.6926,53.28823,2021/07/28 23:00:00+00,Thu 29 Jul 2021,19185,27735,2943,3113418,2570441,217167,3330585,2787608,70.729470766783,59.1986208264466,133
-7.6926,53.28823,2021/01/23 00:00:00+00,Sat 23 Jan 2021,4174,460,0,147357,3460,5,147362,3465,3.12943109728011,0.0735839548328306,134
-7.6926,53.28823,2021/01/24 00:00:00+00,Sun 24 Jan 2021,1176,397,0,148533,3857,5,148538,3862,3.15440504558701,0.0820147860214695,135
-7.6926,53.28823,2021/01/25 00:00:00+00,Mon 25 Jan 2021,1344,1284,0,149877,5141,5,149882,5146,3.1829467007949,0.109282260193289,136
-7.6926,53.28823,2021/01/26 00:00:00+00,Tue 26 Jan 2021,997,3495,0,150874,8636,5,150879,8641,3.2041193423442,0.183503305544153,137
-7.6926,53.28823,2021/01/27 00:00:00+00,Wed 27 Jan 2021,2151,6697,0,153025,15333,5,153030,15338,3.24979873248718,0.325723145519757,138
-7.6926,53.28823,2021/01/28 00:00:00+00,Thu 28 Jan 2021,976,11535,0,154001,26868,5,154006,26873,3.27052541067386,0.570684449703509,139
-7.6926,53.28823,2021/01/29 00:00:00+00,Fri 29 Jan 2021,1554,11524,0,155555,38392,5,155560,38397,3.30352669950797,0.815412154030649,140
-7.6926,53.28823,2021/01/30 00:00:00+00,Sat 30 Jan 2021,613,7792,0,156168,46184,5,156173,46189,3.31654458242645,0.980885797914463,141
-7.6926,53.28823,2021/01/31 00:00:00+00,Sun 31 Jan 2021,211,4084,0,156379,50268,5,156384,50273,3.32102545240329,1.06761505376938,142
-7.6926,53.28823,2021/02/01 00:00:00+00,Mon 01 Feb 2021,998,8335,0,157377,58603,5,157382,58608,3.34221933030319,1.24462003602959,143
-7.6926,53.28823,2021/02/02 00:00:00+00,Tue 02 Feb 2021,816,5103,0,158193,63706,5,158198,63711,3.35954819239369,1.35298913314703,144
-7.6926,53.28823,2021/02/03 00:00:00+00,Wed 03 Feb 2021,1383,6861,0,159576,70567,5,159581,70572,3.38891806527502,1.49869173462122,145
-7.6926,53.28823,2021/02/04 00:00:00+00,Thu 04 Feb 2021,1410,10535,1,160986,81102,6,160992,81108,3.41888255597318,1.72243792455447,146
-7.6926,53.28823,2021/02/05 00:00:00+00,Fri 05 Feb 2021,3369,8607,0,164355,89709,6,164361,89715,3.4904278211483,1.90521919417818,147
-7.6926,53.28823,2021/02/06 00:00:00+00,Sat 06 Feb 2021,885,3864,0,165240,93573,6,165246,93579,3.50922199143028,1.98727645290085,148
-7.6926,53.28823,2021/02/07 00:00:00+00,Sun 07 Feb 2021,319,1295,1,165559,94868,7,165566,94875,3.51601762362264,2.01479876327989,149
-7.6926,53.28823,2021/02/08 00:00:00+00,Mon 08 Feb 2021,1151,873,0,166710,95741,7,166717,95748,3.54046066316451,2.03333809735465,150
-7.6926,53.28823,2021/02/09 00:00:00+00,Tue 09 Feb 2021,4229,533,2,170939,96274,9,170948,96283,3.63031166255779,2.04469954492624,151
-7.6926,53.28823,2021/02/10 00:00:00+00,Wed 10 Feb 2021,8804,578,0,179743,96852,9,179752,96861,3.81727649324992,2.05697415557368,152
-7.6926,53.28823,2021/02/11 00:00:00+00,Thu 11 Feb 2021,6161,440,0,185904,97292,9,185913,97301,3.94811364930333,2.06631814983817,153
-7.6926,53.28823,2021/02/12 00:00:00+00,Fri 12 Feb 2021,4374,519,0,190278,97811,9,190287,97820,4.04100144683257,2.07733981580014,154
-7.6926,53.28823,2021/02/13 00:00:00+00,Sat 13 Feb 2021,1197,1911,0,191475,99722,9,191484,99731,4.06642135850209,2.11792248179885,155
-7.6926,53.28823,2021/02/14 00:00:00+00,Sun 14 Feb 2021,2686,24,0,194161,99746,9,194170,99755,4.12346219621666,2.11843215421328,156
-7.6926,53.28823,2021/02/15 00:00:00+00,Mon 15 Feb 2021,1946,7876,0,196107,107622,9,196116,107631,4.16478813448641,2.28568965154759,157
-7.6926,53.28823,2021/02/16 00:00:00+00,Tue 16 Feb 2021,5622,8156,0,201729,115778,9,201738,115787,4.28417889756583,2.45889332705021,158
-7.6926,53.28823,2021/02/17 00:00:00+00,Wed 17 Feb 2021,9715,8460,0,211444,124238,9,211453,124247,4.49049004365557,2.63855285313556,159
-7.6926,53.28823,2021/02/18 00:00:00+00,Thu 18 Feb 2021,8447,8342,0,219891,132580,9,219900,132589,4.6698734971831,2.81570648984998,160
-7.6926,53.28823,2021/02/19 00:00:00+00,Fri 19 Feb 2021,9372,6577,0,229263,139157,9,229272,139166,4.86890057501667,2.95537796775345,161
-7.6926,53.28823,2021/02/20 00:00:00+00,Sat 20 Feb 2021,5875,3566,2,235138,142723,11,235149,142734,4.99370660749936,3.0311492666982,162
-7.6926,53.28823,2021/02/21 00:00:00+00,Sun 21 Feb 2021,1100,1020,4,236238,143743,15,236253,143758,5.01715153856298,3.05289528971373,163
-7.6926,53.28823,2021/02/22 00:00:00+00,Mon 22 Feb 2021,3932,1113,1,240170,144856,16,240186,144872,5.10067410547713,3.07655258428336,164
-7.6926,53.28823,2021/02/23 00:00:00+00,Tue 23 Feb 2021,13342,1058,0,253512,145914,16,253528,145930,5.38400949519708,3.09902064321933,165
-7.6926,53.28823,2021/02/24 00:00:00+00,Wed 24 Feb 2021,16919,2093,2,270431,148007,18,270449,148025,5.74334978371839,3.14351079772864,166
-7.6926,53.28823,2021/02/25 00:00:00+00,Thu 25 Feb 2021,18065,1746,2,288496,149753,20,288516,149773,6.12702693002856,3.18063193857938,167
-7.6926,53.28823,2021/02/26 00:00:00+00,Fri 26 Feb 2021,16064,2757,0,304560,152510,20,304580,152530,6.46816766608472,3.23918055718663,168
-7.6926,53.28823,2021/02/27 00:00:00+00,Sat 27 Feb 2021,8976,702,1,313536,153212,21,313557,153233,6.65880638543084,3.2541097116592,169
-7.6926,53.28823,2021/02/28 00:00:00+00,Sun 28 Feb 2021,2430,48,1,315966,153260,22,315988,153282,6.71043195374213,3.25515029283866,170
-7.6926,53.28823,2021/03/01 00:00:00+00,Mon 01 Mar 2021,5566,782,0,321532,154042,22,321554,154064,6.82863348118788,3.27175711900872,171
-7.6926,53.28823,2021/03/02 00:00:00+00,Tue 02 Mar 2021,12160,1602,0,333692,155644,22,333714,155666,7.08686750449733,3.30577775267169,172
-7.6926,53.28823,2021/03/03 00:00:00+00,Wed 03 Mar 2021,12866,1497,1,346558,157141,23,346581,157164,7.36011562768175,3.33758980587215,173
-7.6926,53.28823,2021/03/04 00:00:00+00,Thu 04 Mar 2021,18708,1679,3,365266,158820,26,365292,158846,7.75746898377904,3.37330934758321,174
-7.6926,53.28823,2021/03/05 00:00:00+00,Fri 05 Mar 2021,18416,2387,6,383682,161207,32,383714,161239,8.1486850345526,3.42412793457165,175
-7.6926,53.28823,2021/03/06 00:00:00+00,Sat 06 Mar 2021,10422,133,4,394104,161340,36,394140,161376,8.37009522591973,3.427037314604,176
-7.6926,53.28823,2021/03/07 00:00:00+00,Sun 07 Mar 2021,1504,8,2,395608,161348,38,395646,161386,8.402077169925,3.42724967811002,177
-7.6926,53.28823,2021/03/08 00:00:00+00,Mon 08 Mar 2021,6638,1490,3,402246,162838,41,402287,162879,8.54310777426694,3.45895554955747,178
-7.6926,53.28823,2021/03/09 00:00:00+00,Tue 09 Mar 2021,13794,3091,3,416040,165929,44,416084,165973,8.83610570351039,3.52466081831729,179
-7.6926,53.28823,2021/03/10 00:00:00+00,Wed 10 Mar 2021,13694,3973,3,429734,169902,47,429781,169949,9.12697999769373,3.60909654830728,180
-7.6926,53.28823,2021/03/11 00:00:00+00,Thu 11 Mar 2021,18440,2093,2,448174,171995,49,448223,172044,9.51862077547932,3.6535867028166,181
-7.6926,53.28823,2021/03/12 00:00:00+00,Fri 12 Mar 2021,17295,1328,3,465469,173323,52,465521,173375,9.88596716817724,3.68185228546667,182
-7.6926,53.28823,2021/03/13 00:00:00+00,Sat 13 Mar 2021,8262,168,0,473731,173491,52,473783,173543,10.0614218968436,3.68541999236766,183
-7.6926,53.28823,2021/03/14 00:00:00+00,Sun 14 Mar 2021,365,16,1,474096,173507,53,474149,173560,10.0691944011636,3.68578101032787,184
-7.6926,53.28823,2021/03/15 00:00:00+00,Mon 15 Mar 2021,2614,984,0,476710,174491,53,476763,174544,10.1247062216349,3.70667757931936,185
-7.6926,53.28823,2021/03/16 00:00:00+00,Tue 16 Mar 2021,8916,3807,2,485626,178298,55,485681,178353,10.3140919962955,3.78756683875897,186
-7.6926,53.28823,2021/03/17 00:00:00+00,Wed 17 Mar 2021,4865,2404,6,490491,180702,61,490552,180763,10.4175342600735,3.83874644370764,187
-7.6926,53.28823,2021/03/18 00:00:00+00,Thu 18 Mar 2021,11686,4674,2,502177,185376,63,502240,185439,10.6657447258992,3.93804761911841,188
-7.6926,53.28823,2021/03/19 00:00:00+00,Fri 19 Mar 2021,10321,6107,2,512498,191483,65,512563,191548,10.8849675731544,4.06778048494056,189
-7.6926,53.28823,2021/03/20 00:00:00+00,Sat 20 Mar 2021,5209,3111,2,517707,194594,67,517774,194661,10.9956301961368,4.1338892443618,190
-7.6926,53.28823,2021/03/21 00:00:00+00,Sun 21 Mar 2021,3613,49,3,521320,194643,70,521390,194713,11.0724208399104,4.13499353459306,191
-7.6926,53.28823,2021/03/22 00:00:00+00,Mon 22 Mar 2021,7370,2392,1,528690,197035,71,528761,197106,11.2289539801912,4.18581212158151,192
-7.6926,53.28823,2021/03/23 00:00:00+00,Tue 23 Mar 2021,12538,7377,3,541228,204412,74,541302,204486,11.4952790530796,4.34253638901766,193
-7.6926,53.28823,2021/03/24 00:00:00+00,Wed 24 Mar 2021,13578,9768,1,554806,214180,75,554881,214255,11.783647457892,4.54999429803986,194
-7.6926,53.28823,2021/03/25 00:00:00+00,Thu 25 Mar 2021,20821,10208,3,575627,224388,78,575705,224466,12.2258732228095,4.76683867402775,195
-7.6926,53.28823,2021/03/26 00:00:00+00,Fri 26 Mar 2021,19666,9483,1,595293,233871,79,595372,233950,12.6435285300814,4.96824422312864,196
-7.6926,53.28823,2021/03/27 00:00:00+00,Sat 27 Mar 2021,11711,5329,0,607004,239200,79,607083,239279,12.8922274319709,5.08141273548193,197
-7.6926,53.28823,2021/03/28 00:00:00+00,Sun 28 Mar 2021,2466,478,0,609470,239678,79,609549,239757,12.9445962725533,5.09156371106926,198
-7.6926,53.28823,2021/03/28 23:00:00+00,Mon 29 Mar 2021,9224,3100,3,618694,242778,82,618776,242860,13.1405440795497,5.15746010698449,199
-7.6926,53.28823,2021/03/29 23:00:00+00,Tue 30 Mar 2021,13290,8652,4,631984,251430,86,632070,251516,13.4228601244408,5.34128195778766,200
-7.6926,53.28823,2021/03/30 23:00:00+00,Wed 31 Mar 2021,15778,10487,3,647762,261917,89,647851,262006,13.7579909732768,5.56405127559325,201
-7.6926,53.28823,2021/03/31 23:00:00+00,Thu 01 Apr 2021,19647,11609,6,667409,273526,95,667504,273621,14.1753489716403,5.81071148782509,202
-7.6926,53.28823,2021/04/01 23:00:00+00,Fri 02 Apr 2021,20099,13708,7,687508,287234,102,687610,287336,14.6023270368262,6.10196803631926,203
-7.6926,53.28823,2021/04/02 23:00:00+00,Sat 03 Apr 2021,7514,4633,5,695022,291867,107,695129,291974,14.7620031569959,6.20046223040718,204
-7.6926,53.28823,2021/04/03 23:00:00+00,Sun 04 Apr 2021,3002,166,1,698024,292033,108,698132,292141,14.825775917851,6.20400870095757,205
-7.6926,53.28823,2021/04/04 23:00:00+00,Mon 05 Apr 2021,3393,593,3,701417,292626,111,701528,292737,14.8978945644924,6.21666556591583,206
-7.6926,53.28823,2021/04/05 23:00:00+00,Tue 06 Apr 2021,11935,8145,6,713352,300771,117,713469,300888,15.1514778270202,6.38976305966544,207
-7.6926,53.28823,2021/04/06 23:00:00+00,Wed 07 Apr 2021,18309,10443,4,731661,311214,121,731782,311335,15.5403791155782,6.61161921439519,208
-7.6926,53.28823,2021/04/07 23:00:00+00,Thu 08 Apr 2021,20134,10550,13,751795,321764,134,751929,321898,15.9682278711387,6.83593878579467,209
-7.6926,53.28823,2021/04/08 23:00:00+00,Fri 09 Apr 2021,20662,9141,15,772457,330905,149,772606,331054,16.4073318925177,7.03037881189839,210
-7.6926,53.28823,2021/04/09 23:00:00+00,Sat 10 Apr 2021,11129,4145,12,783586,335050,161,783747,335211,16.6439260745647,7.11865832134718,211
-7.6926,53.28823,2021/04/10 23:00:00+00,Sun 11 Apr 2021,2829,343,3,786415,335393,164,786579,335557,16.704067419467,7.12600609865517,212
-7.6926,53.28823,2021/04/11 23:00:00+00,Mon 12 Apr 2021,7732,2773,8,794147,338166,172,794319,338338,16.8684367731195,7.18506438967684,213
-7.6926,53.28823,2021/04/12 23:00:00+00,Tue 13 Apr 2021,11460,8575,1,805607,346741,173,805780,346914,17.1118265873588,7.36718733243192,214
-7.6926,53.28823,2021/11/14 00:00:00+00,Sun 14 Nov 2021,1649,1799,0,3624797,3557818,239128,3863925,3796946,82.0556659963767,80.6332764694652,215
-7.6926,53.28823,2021/11/15 00:00:00+00,Mon 15 Nov 2021,1245,563,0,3626042,3558381,239128,3865170,3797509,82.082105252875,80.6452325348536,216
-7.6926,53.28823,2021/11/16 00:00:00+00,Tue 16 Nov 2021,1320,1045,5,3627362,3559426,239133,3866495,3798559,82.1102434174215,80.6675307029848,217
-7.6926,53.28823,2021/11/17 00:00:00+00,Wed 17 Nov 2021,1518,1079,0,3628880,3560505,239133,3868013,3799638,82.142480197634,80.6904447252834,218
-7.6926,53.28823,2021/11/18 00:00:00+00,Thu 18 Nov 2021,1665,2459,5,3630545,3562964,239138,3869683,3802102,82.1779449031378,80.7427710931645,219
-7.6926,53.28823,2021/11/19 00:00:00+00,Fri 19 Nov 2021,1184,1512,0,3631729,3564476,239138,3870867,3803614,82.2030887422495,80.7748804552734,220
-7.6926,53.28823,2021/11/20 00:00:00+00,Sat 20 Nov 2021,1540,2920,10,3633269,3567396,239148,3872417,3806544,82.2360050856812,80.8371029625346,221
-7.6926,53.28823,2021/11/21 00:00:00+00,Sun 21 Nov 2021,1786,2752,0,3635055,3570148,239148,3874203,3809296,82.2739332078548,80.8955453993889,222
-7.6926,53.28823,2021/11/22 00:00:00+00,Mon 22 Nov 2021,712,486,2,3635767,3570634,239150,3874917,3809784,82.289095962184,80.9059087384822,223
-7.6926,53.28823,2021/11/23 00:00:00+00,Tue 23 Nov 2021,2161,1554,6,3637928,3572188,239156,3877084,3811344,82.3351151339366,80.9390374454199,224
-7.6926,53.28823,2021/11/24 00:00:00+00,Wed 24 Nov 2021,1623,3112,2,3639551,3575300,239158,3878709,3814458,82.3696242036634,81.0051674411918,225
-7.6926,53.28823,2021/11/25 00:00:00+00,Thu 25 Nov 2021,1003,1155,1,3640554,3576455,239159,3879713,3815614,82.3909454996669,81.0297166624866,226
-7.6926,53.28823,2021/11/26 00:00:00+00,Fri 26 Nov 2021,1290,1075,12,3641844,3577530,239171,3881015,3816701,82.4185952281496,81.05280057559,227
-7.6926,53.28823,2021/11/27 00:00:00+00,Sat 27 Nov 2021,1225,1546,5,3643069,3579076,239176,3882245,3818252,82.4447159393889,81.0857381553724,228
-7.6926,53.28823,2021/11/28 00:00:00+00,Sun 28 Nov 2021,1969,2250,0,3645038,3581326,239176,3884214,3820502,82.4865303137225,81.1335199442249,229
-7.6926,53.28823,2021/11/29 00:00:00+00,Mon 29 Nov 2021,551,970,1,3645589,3582296,239177,3884766,3821473,82.4982527792543,81.1541404406585,230
-7.6926,53.28823,2021/11/30 00:00:00+00,Tue 30 Nov 2021,1928,1616,5,3647517,3583912,239182,3886699,3823094,82.5393026449662,81.1885645649829,231
-7.6926,53.28823,2021/12/01 00:00:00+00,Wed 01 Dec 2021,1087,1351,1,3648604,3585263,239183,3887787,3824446,82.5624077944202,81.2172761109956,232
-7.6926,53.28823,2021/12/02 00:00:00+00,Thu 02 Dec 2021,1776,1393,0,3650380,3586656,239183,3889563,3825839,82.6001235530878,81.2468583473829,233
-7.6926,53.28823,2021/12/03 00:00:00+00,Fri 03 Dec 2021,1042,1161,3,3651422,3587817,239186,3890608,3827003,82.6223155394659,81.2715774594826,234
-7.6926,53.28823,2021/12/04 00:00:00+00,Sat 04 Dec 2021,1203,1690,0,3652625,3589507,239186,3891811,3828693,82.6478628692391,81.3074668919985,235
-7.6926,53.28823,2021/12/05 00:00:00+00,Sun 05 Dec 2021,1349,1769,0,3653974,3591276,239186,3893160,3830462,82.6765107062,81.3450339962119,236
-7.6926,53.28823,2021/12/06 00:00:00+00,Mon 06 Dec 2021,935,1269,0,3654909,3592545,239186,3894095,3831731,82.696366694012,81.3719829251247,237
-7.6926,53.28823,2021/12/07 00:00:00+00,Tue 07 Dec 2021,482,726,1,3655391,3593271,239187,3894578,3832458,82.7066238513523,81.3874217520117,238
-7.6926,53.28823,2021/12/08 00:00:00+00,Wed 08 Dec 2021,813,1485,0,3656204,3594756,239187,3895391,3833943,82.723889004391,81.4189577326543,239
-7.6926,53.28823,2021/12/09 00:00:00+00,Thu 09 Dec 2021,792,1176,0,3656996,3595932,239187,3896183,3835119,82.7407081940671,81.4439316809612,240
-7.6926,53.28823,2021/12/10 00:00:00+00,Fri 10 Dec 2021,888,1592,1,3657884,3597524,239188,3897072,3836712,82.7595873097515,81.4777611874688,241
-7.6926,53.28823,2021/12/11 00:00:00+00,Sat 11 Dec 2021,640,833,0,3658524,3598357,239188,3897712,3837545,82.7731785741362,81.4954510675195,242
-7.6926,53.28823,2021/12/12 00:00:00+00,Sun 12 Dec 2021,691,1188,0,3659215,3599545,239188,3898403,3838733,82.7878528924016,81.5206798520336,243
-7.6926,53.28823,2021/12/13 00:00:00+00,Mon 13 Dec 2021,720,1043,0,3659935,3600588,239188,3899123,3839776,82.8031430648344,81.5428293657106,244
-7.6926,53.28823,2021/12/14 00:00:00+00,Tue 14 Dec 2021,627,1175,1,3660562,3601763,239189,3899751,3840952,82.8164794930119,81.5678033140175,245
-7.6926,53.28823,2021/12/15 00:00:00+00,Wed 15 Dec 2021,793,1215,1,3661355,3602978,239190,3900545,3842168,82.8333411553891,81.5936267163484,246
-7.6926,53.28823,2021/12/16 00:00:00+00,Thu 16 Dec 2021,1056,1502,7,3662411,3604480,239197,3901608,3843677,82.8559153960781,81.6256723694055,247
-7.6926,53.28823,2021/12/17 00:00:00+00,Fri 17 Dec 2021,1203,2421,1,3663614,3606901,239198,3902812,3846099,82.8814839622018,81.6771068105614,248
-7.6926,53.28823,2021/12/18 00:00:00+00,Sat 18 Dec 2021,1266,1164,0,3664880,3608065,239198,3904078,3847263,82.9083691820628,81.701825922661,249
-7.6926,53.28823,2021/12/19 00:00:00+00,Sun 19 Dec 2021,558,877,0,3665438,3608942,239198,3904636,3848140,82.9202190656983,81.7204502021382,250
-7.6926,53.28823,2021/12/20 00:00:00+00,Mon 20 Dec 2021,534,575,0,3665972,3609517,239198,3905170,3848715,82.9315592769193,81.7326611037338,251
-7.6926,53.28823,2021/12/21 00:00:00+00,Tue 21 Dec 2021,1460,1766,3,3667432,3611283,239201,3906633,3850484,82.9626280578487,81.7702282079472,252
-7.6926,53.28823,2021/12/22 00:00:00+00,Wed 22 Dec 2021,1240,1540,2,3668672,3612823,239203,3907875,3852026,82.9890036052952,81.8029746605741,253
-7.6926,53.28823,2021/12/23 00:00:00+00,Thu 23 Dec 2021,960,1321,0,3669632,3614144,239203,3908835,3853347,83.0093905018723,81.8310278797181,254
-7.6926,53.28823,2021/12/24 00:00:00+00,Fri 24 Dec 2021,100,135,0,3669732,3614279,239203,3908935,3853482,83.0115141369324,81.8338947870493,255
-7.6926,53.28823,2021/12/25 00:00:00+00,Sat 25 Dec 2021,1,0,0,3669733,3614279,239203,3908936,3853482,83.011535373283,81.8338947870493,256
-7.6926,53.28823,2021/12/26 00:00:00+00,Sun 26 Dec 2021,10,6,0,3669743,3614285,239203,3908946,3853488,83.011747736789,81.8340222051529,257
-7.6926,53.28823,2021/12/27 00:00:00+00,Mon 27 Dec 2021,387,581,0,3670130,3614866,239203,3909333,3854069,83.0199662044717,81.8463605248522,258
-7.6926,53.28823,2021/12/28 00:00:00+00,Tue 28 Dec 2021,459,733,0,3670589,3615599,239203,3909792,3854802,83.0297136893976,81.8619267698428,259
-7.6926,53.28823,2021/12/29 00:00:00+00,Wed 29 Dec 2021,1079,1269,0,3671668,3616868,239203,3910871,3856071,83.0526277116962,81.8888756987556,260
-7.6926,53.28823,2021/12/30 00:00:00+00,Thu 30 Dec 2021,1062,1160,1,3672730,3618028,239204,3911934,3857232,83.0752019523851,81.9135311018034,261
-7.6926,53.28823,2021/12/31 00:00:00+00,Fri 31 Dec 2021,721,1662,0,3673451,3619690,239204,3912655,3858894,83.0905133611685,81.9488259165025,262
-7.6926,53.28823,2022/01/01 00:00:00+00,Sat 01 Jan 2022,66,95,0,3673517,3619785,239204,3912721,3858989,83.0919149603082,81.9508433698096,263
-7.6926,53.28823,2022/01/02 00:00:00+00,Sun 02 Jan 2022,271,620,0,3673788,3620405,239204,3912992,3859609,83.0976700113211,81.9640099071823,264
-7.6926,53.28823,2022/01/03 00:00:00+00,Mon 03 Jan 2022,3631,715,0,3677419,3621120,239204,3916623,3860324,83.1747792003537,81.9791938978621,265
-7.6926,53.28823,2022/01/04 00:00:00+00,Tue 04 Jan 2022,1191,751,0,3678610,3621871,239204,3917814,3861075,83.2000716939196,81.9951423971635,266
-7.6926,53.28823,2022/01/05 00:00:00+00,Wed 05 Jan 2022,2142,861,0,3680752,3622732,239204,3919956,3861936,83.2455599569072,82.013426895031,267
-7.6926,53.28823,2022/01/06 00:00:00+00,Thu 06 Jan 2022,2461,1640,0,3683213,3624372,239204,3922417,3863576,83.2978226157365,82.0482545100169,268
-7.6926,53.28823,2022/01/07 00:00:00+00,Fri 07 Jan 2022,4840,743,0,3688053,3625115,239204,3927257,3864319,83.4006065526459,82.0640331185135,269
-7.6926,53.28823,2022/01/08 00:00:00+00,Sat 08 Jan 2022,9791,726,1,3697844,3625841,239205,3937049,3865046,83.6085528977319,82.0794719454005,270
-7.6926,53.28823,2022/01/09 00:00:00+00,Sun 09 Jan 2022,7117,662,0,3704961,3626503,239205,3944166,3865708,83.75969200496,82.0935304094984,271
-7.6926,53.28823,2022/01/10 00:00:00+00,Mon 10 Jan 2022,6652,474,0,3711613,3626977,239205,3950818,3866182,83.9009562091585,82.1035964396833,272
-7.6926,53.28823,2022/01/11 00:00:00+00,Tue 11 Jan 2022,4767,1317,1,3716380,3628294,239206,3955586,3867500,84.0022111288246,82.1315859497756,273
-7.6926,53.28823,2022/01/12 00:00:00+00,Wed 12 Jan 2022,7551,860,1,3723931,3629154,239207,3963138,3868361,84.1625880485641,82.1498704476432,274
-7.6926,53.28823,2022/01/13 00:00:00+00,Thu 13 Jan 2022,7318,764,0,3731249,3629918,239207,3970456,3869125,84.317995662263,82.1660950195024,275
-7.6926,53.28823,2022/01/14 00:00:00+00,Fri 14 Jan 2022,10721,793,0,3741970,3630711,239207,3981177,3869918,84.5456705770575,82.1829354455291,276
-7.6926,53.28823,2022/01/15 00:00:00+00,Sat 15 Jan 2022,8348,634,0,3750318,3631345,239207,3989525,3870552,84.7229516318755,82.1963992918102,277
-7.6926,53.28823,2022/01/16 00:00:00+00,Sun 16 Jan 2022,6967,1208,1,3757285,3632553,239208,3996493,3871761,84.870926522864,82.2220740396869,278
-7.6926,53.28823,2022/01/17 00:00:00+00,Mon 17 Jan 2022,2557,539,0,3759842,3633092,239208,3999050,3872300,84.925227871351,82.2335204326609,279
-7.6926,53.28823,2022/01/18 00:00:00+00,Tue 18 Jan 2022,4058,412,3,3763900,3633504,239211,4003111,3872715,85.0114686911421,82.2423335181604,280
-7.6926,53.28823,2022/01/19 00:00:00+00,Wed 19 Jan 2022,3479,593,0,3767379,3634097,239211,4006590,3873308,85.0853499548834,82.2549266740668,281
-7.6926,53.28823,2022/01/20 00:00:00+00,Thu 20 Jan 2022,3686,907,0,3771065,3635004,239211,4010276,3874215,85.1636271431991,82.274188044062,282
-7.6926,53.28823,2022/01/21 00:00:00+00,Fri 21 Jan 2022,3246,950,0,3774311,3635954,239211,4013522,3875165,85.2325603372502,82.2943625771331,283
-7.6926,53.28823,2022/01/22 00:00:00+00,Sat 22 Jan 2022,4272,629,0,3778583,3636583,239211,4017794,3875794,85.3232820270182,82.3077202416612,284
-7.6926,53.28823,2022/01/23 00:00:00+00,Sun 23 Jan 2022,3092,676,0,3781675,3637259,239211,4020886,3876470,85.3889448230768,82.3220760146675,285
-7.6926,53.28823,2022/01/24 00:00:00+00,Mon 24 Jan 2022,642,454,0,3782317,3637713,239211,4021528,3876924,85.4025785601627,82.3317173178404,286
-7.6926,53.28823,2022/01/25 00:00:00+00,Tue 25 Jan 2022,695,1820,0,3783012,3639533,239211,4022223,3878744,85.4173378238305,82.3703674759344,287
-7.6926,53.28823,2022/01/26 00:00:00+00,Wed 26 Jan 2022,698,875,0,3783710,3640408,239211,4022921,3879619,85.43216079655,82.3889492827104,288
-7.6926,53.28823,2022/01/27 00:00:00+00,Thu 27 Jan 2022,1272,1150,0,3784982,3641558,239211,4024193,3880769,85.4591734345146,82.4133710859017,289
-7.6926,53.28823,2022/01/28 00:00:00+00,Fri 28 Jan 2022,1024,3072,0,3786006,3644630,239211,4025217,3883841,85.4809194575302,82.4786091549483,290
-7.6926,53.28823,2022/01/29 00:00:00+00,Sat 29 Jan 2022,2324,3440,0,3788330,3648070,239211,4027541,3887281,85.5302727363271,82.5516622010161,291
-7.6926,53.28823,2022/01/30 00:00:00+00,Sun 30 Jan 2022,1635,7533,0,3789965,3655603,239211,4029176,3894814,85.5649941695599,82.7116356300942,292
-7.6926,53.28823,2022/01/31 00:00:00+00,Mon 31 Jan 2022,478,1375,1,3790443,3656978,239212,4029655,3896190,85.5751663814979,82.7408568485213,293
-7.6926,53.28823,2022/02/01 00:00:00+00,Tue 01 Feb 2022,747,3401,1,3791190,3660379,239213,4030403,3899592,85.5910511717475,82.8131029132663,294
-7.6926,53.28823,2022/02/02 00:00:00+00,Wed 02 Feb 2022,641,2978,0,3791831,3663357,239213,4031044,3902570,85.6046636724828,82.8763447653564,295
-7.6926,53.28823,2022/02/03 00:00:00+00,Thu 03 Feb 2022,908,2413,1,3792739,3665770,239214,4031953,3904984,85.6239675151792,82.9276093157074,296
-7.6926,53.28823,2022/02/04 00:00:00+00,Fri 04 Feb 2022,1167,6491,0,3793906,3672261,239214,4033120,3911475,85.6487503363307,83.0654544674592,297
-7.6926,53.28823,2022/02/05 00:00:00+00,Sat 05 Feb 2022,1777,5743,0,3795683,3678004,239214,4034897,3917218,85.6864873313489,83.1874148289614,298
-7.6926,53.28823,2022/02/06 00:00:00+00,Sun 06 Feb 2022,1407,7555,0,3797090,3685559,239214,4036304,3924773,85.7163668766446,83.3478554577527,299
-7.6926,53.28823,2022/02/07 00:00:00+00,Mon 07 Feb 2022,432,1338,0,3797522,3686897,239214,4036736,3926111,85.7255409801043,83.376269694857,300
-7.6926,53.28823,2022/02/08 00:00:00+00,Tue 08 Feb 2022,893,1214,0,3798415,3688111,239214,4037629,3927325,85.7445050411911,83.4020506244867,301
-7.6926,53.28823,2022/02/09 00:00:00+00,Wed 09 Feb 2022,1334,1744,0,3799749,3689855,239214,4038963,3929069,85.772834332893,83.4390868199351,302
-7.6926,53.28823,2022/02/10 00:00:00+00,Thu 10 Feb 2022,687,2526,0,3800436,3692381,239214,4039650,3931595,85.7874237057559,83.4927298415535,303
-7.6926,53.28823,2022/02/11 00:00:00+00,Fri 11 Feb 2022,549,4894,0,3800985,3697275,239214,4040199,3936489,85.7990824622359,83.5966605413953,304
-7.6926,53.28823,2022/02/12 00:00:00+00,Sat 12 Feb 2022,1395,5455,0,3802380,3702730,239214,4041594,3941944,85.8287071713245,83.7125048339243,305
-7.6926,53.28823,2022/02/13 00:00:00+00,Sun 13 Feb 2022,1567,4705,0,3803947,3707435,239214,4043161,3946649,85.8619845327164,83.8124218635025,306
-7.6926,53.28823,2022/02/14 00:00:00+00,Mon 14 Feb 2022,170,936,1,3804117,3708371,239215,4043332,3947586,85.8656159486692,83.8323203240157,307
-7.6926,53.28823,2022/02/15 00:00:00+00,Tue 15 Feb 2022,644,792,1,3804761,3709163,239216,4043977,3948379,85.8793133948069,83.8491607500424,308
-7.6926,53.28823,2022/02/16 00:00:00+00,Wed 16 Feb 2022,788,1767,0,3805549,3710930,239216,4044765,3950146,85.8960476390806,83.8866853815546,309
-7.6926,53.28823,2022/02/17 00:00:00+00,Thu 17 Feb 2022,778,1147,2,3806327,3712077,239218,4045545,3951295,85.9126119925494,83.9110859483953,310
-7.6926,53.28823,2022/02/18 00:00:00+00,Fri 18 Feb 2022,790,3244,0,3807117,3715321,239218,4046335,3954539,85.9293887095243,83.9799766697452,311
-7.6926,53.28823,2022/02/19 00:00:00+00,Sat 19 Feb 2022,975,3528,0,3808092,3718849,239218,4047310,3958067,85.9500941513604,84.0548985146659,312
-7.6926,53.28823,2022/02/20 00:00:00+00,Sun 20 Feb 2022,1362,3586,0,3809454,3722435,239218,4048672,3961653,85.9790180608791,84.1310520679215,313
-7.6926,53.28823,2022/02/21 00:00:00+00,Mon 21 Feb 2022,249,980,1,3809703,3723415,239219,4048922,3962634,85.9843271485294,84.1518849278612,314
-7.6926,53.28823,2022/02/22 00:00:00+00,Tue 22 Feb 2022,470,944,0,3810173,3724359,239219,4049392,3963578,85.9943082333119,84.1719320428286,315
-7.6926,53.28823,2022/02/23 00:00:00+00,Wed 23 Feb 2022,821,1230,1,3810994,3725589,239220,4050214,3964809,86.011764513506,84.1980739904186,316
-7.6926,53.28823,2022/02/24 00:00:00+00,Thu 24 Feb 2022,654,1183,0,3811648,3726772,239220,4050868,3965992,86.0256530867991,84.2231965931797,317
-7.6926,53.28823,2022/02/25 00:00:00+00,Fri 25 Feb 2022,683,1175,0,3812331,3727947,239220,4051551,3967167,86.0401575142597,84.248149305136,318
-7.6926,53.28823,2022/02/26 00:00:00+00,Sat 26 Feb 2022,955,2067,0,3813286,3730014,239220,4052506,3969234,86.0604382290837,84.2920448418285,319
-7.6926,53.28823,2022/02/27 00:00:00+00,Sun 27 Feb 2022,667,1779,0,3813953,3731793,239220,4053173,3971013,86.0746028749347,84.3298243095478,320
-7.6926,53.28823,2022/02/28 00:00:00+00,Mon 28 Feb 2022,78,391,0,3814031,3732184,239220,4053251,3971404,86.0762593102816,84.3381277226329,321
-7.6926,53.28823,2021/07/29 23:00:00+00,Fri 30 Jul 2021,21864,22791,2107,3135282,2593232,219274,3354556,2812506,71.2385273270421,59.7273634837129,322
-7.6926,53.28823,2021/07/30 23:00:00+00,Sat 31 Jul 2021,13681,12361,898,3148963,2605593,220172,3369135,2825765,71.5481320824557,60.0089362563329,323
-7.6926,53.28823,2021/07/31 23:00:00+00,Sun 01 Aug 2021,11037,9240,360,3160000,2614833,220532,3380532,2835365,71.7901627702564,60.2128052221036,324
-7.6926,53.28823,2021/08/01 23:00:00+00,Mon 02 Aug 2021,14950,15877,417,3174950,2630710,220949,3395899,2851659,72.1165017699436,60.558830318798,325
-7.6926,53.28823,2021/08/02 23:00:00+00,Tue 03 Aug 2021,17273,25306,1095,3192223,2656016,222044,3414267,2878060,72.5065710577848,61.1194912110178,326
-7.6926,53.28823,2021/08/03 23:00:00+00,Wed 04 Aug 2021,22037,17148,1569,3214260,2673164,223613,3437873,2896777,73.0078763500744,61.5169719852186,327
-7.6926,53.28823,2021/08/04 23:00:00+00,Thu 05 Aug 2021,13459,29905,1415,3227719,2703069,225028,3452747,2928097,73.3237458289153,62.1820944860453,328
-7.6926,53.28823,2021/08/05 23:00:00+00,Fri 06 Aug 2021,12122,24625,937,3239841,2727694,225965,3465806,2953659,73.6010713314151,62.7249380801107,329
-7.6926,53.28823,2021/08/06 23:00:00+00,Sat 07 Aug 2021,6300,8358,573,3246141,2736052,226538,3472679,2962590,73.7470287690965,62.9145999273292,330
-7.6926,53.28823,2021/08/07 23:00:00+00,Sun 08 Aug 2021,8582,11892,150,3254723,2747944,226688,3481411,2974632,73.9324645825454,63.1703280612677,331
-7.6926,53.28823,2021/08/08 23:00:00+00,Mon 09 Aug 2021,5492,22896,593,3260215,2770840,227281,3487496,2998121,74.0616877759531,63.6691487005371,332
-7.6926,53.28823,2021/08/09 23:00:00+00,Tue 10 Aug 2021,9274,25869,700,3269489,2796709,227981,3497470,3024690,74.2734991368485,64.2333772996579,333
-7.6926,53.28823,2021/08/10 23:00:00+00,Wed 11 Aug 2021,6952,31092,648,3276441,2827801,228629,3505070,3056430,74.4348954014169,64.907419067737,334
-7.6926,53.28823,2021/08/11 23:00:00+00,Thu 12 Aug 2021,6705,38173,855,3283146,2865974,229484,3512630,3095458,74.5954422119613,65.7362313589969,335
-7.6926,53.28823,2021/08/12 23:00:00+00,Fri 13 Aug 2021,10857,28122,853,3294003,2894096,230337,3524340,3124433,74.8441198775002,66.3515546176639,336
-7.6926,53.28823,2021/08/13 23:00:00+00,Sat 14 Aug 2021,18081,5767,273,3312084,2899863,230610,3542694,3130473,75.2338918564329,66.4798221752946,337
-7.6926,53.28823,2021/08/14 23:00:00+00,Sun 15 Aug 2021,16972,3673,43,3329056,2903536,230653,3559709,3134189,75.5952283619107,66.5587364541283,338
-7.6926,53.28823,2021/08/15 23:00:00+00,Mon 16 Aug 2021,10143,23036,376,3339199,2926572,231029,3570228,3157601,75.8186135338838,67.0559218944014,339
-7.6926,53.28823,2021/08/16 23:00:00+00,Tue 17 Aug 2021,12845,26773,522,3352044,2953345,231551,3583595,3184896,76.1024798323687,67.6355680840586,340
-7.6926,53.28823,2021/08/17 23:00:00+00,Wed 18 Aug 2021,15184,25671,651,3367228,2979016,232202,3599430,3211218,76.4387574441373,68.1945513045809,341
-7.6926,53.28823,2021/08/18 23:00:00+00,Thu 19 Aug 2021,11331,25601,536,3378559,3004617,232738,3611297,3237355,76.6907692167206,68.749605800242,342
-7.6926,53.28823,2021/08/19 23:00:00+00,Fri 20 Aug 2021,14797,22145,679,3393356,3026762,233417,3626773,3260179,77.0194229786233,69.2343042663616,343
-7.6926,53.28823,2021/08/20 23:00:00+00,Sat 21 Aug 2021,11834,7902,238,3405190,3034664,233655,3638845,3268319,77.2757882030798,69.4071681602546,344
-7.6926,53.28823,2021/08/21 23:00:00+00,Sun 22 Aug 2021,7991,12209,159,3413181,3046873,233814,3646995,3280687,77.4488644604788,69.6698193444891,345
-7.6926,53.28823,2021/08/22 23:00:00+00,Mon 23 Aug 2021,10833,15278,280,3424014,3062151,234094,3658108,3296245,77.6848640247089,70.0002144871411,346
-7.6926,53.28823,2021/08/23 23:00:00+00,Tue 24 Aug 2021,9720,22835,382,3433734,3084986,234476,3668210,3319462,77.8993936384813,70.4932588390469,347
-7.6926,53.28823,2021/08/24 23:00:00+00,Wed 25 Aug 2021,9385,19420,308,3443119,3104406,234784,3677903,3339190,78.1052375848578,70.9122095637056,348
-7.6926,53.28823,2021/08/25 23:00:00+00,Thu 26 Aug 2021,8543,19342,363,3451662,3123748,235147,3686809,3358895,78.2943685233112,71.3306718523003,349
-7.6926,53.28823,2021/08/26 23:00:00+00,Fri 27 Aug 2021,9684,19121,429,3461346,3142869,235576,3696922,3378445,78.5091317369402,71.745842506552,350
-7.6926,53.28823,2021/08/27 23:00:00+00,Sat 28 Aug 2021,9902,7851,151,3471248,3150720,235727,3706975,3386447,78.7226207695332,71.915775784062,351
-7.6926,53.28823,2021/08/28 23:00:00+00,Sun 29 Aug 2021,8786,9157,27,3480034,3159877,235754,3715788,3395631,78.9097767273807,72.1108104279825,352
-7.6926,53.28823,2021/08/29 23:00:00+00,Mon 30 Aug 2021,5037,11045,80,3485071,3170922,235834,3720905,3406756,79.0184431334065,72.3470648284198,353
-7.6926,53.28823,2021/08/30 23:00:00+00,Tue 31 Aug 2021,4038,12795,140,3489109,3183717,235974,3725083,3419691,79.107168606218,72.6217570234451,354
-7.6926,53.28823,2021/08/31 23:00:00+00,Wed 01 Sep 2021,4919,12462,179,3494028,3196179,236153,3730181,3432332,79.2154315215824,72.8902057313937,355
-7.6926,53.28823,2021/09/01 23:00:00+00,Thu 02 Sep 2021,4987,12297,246,3499015,3208476,236399,3735414,3444875,79.326561344278,73.1565732769834,356
-7.6926,53.28823,2021/09/02 23:00:00+00,Fri 03 Sep 2021,4745,15988,163,3503760,3224464,236562,3740322,3461026,79.4307893530282,73.4995615755418,357
-7.6926,53.28823,2021/09/03 23:00:00+00,Sat 04 Sep 2021,4610,10535,131,3508370,3234999,236693,3745063,3471692,79.5314708912281,73.7260684910532,358
-7.6926,53.28823,2021/09/04 23:00:00+00,Sun 05 Sep 2021,5301,11870,1,3513671,3246869,236694,3750365,3483563,79.6440660221151,73.978165209039,359
-7.6926,53.28823,2021/09/05 23:00:00+00,Mon 06 Sep 2021,2133,9634,73,3515804,3256503,236767,3752571,3493270,79.6909134115411,74.1843064643239,360
-7.6926,53.28823,2021/09/06 23:00:00+00,Tue 07 Sep 2021,3019,9943,153,3518823,3266446,236920,3755743,3503366,79.7582751156479,74.3987086599926,361
-7.6926,53.28823,2021/09/07 23:00:00+00,Wed 08 Sep 2021,2584,14747,184,3521407,3281193,237104,3758511,3518297,79.8170573341117,74.7157886108178,362
-7.6926,53.28823,2021/09/08 23:00:00+00,Thu 09 Sep 2021,3095,14750,136,3524502,3295943,237240,3761742,3533183,79.8856719829039,75.0319129258658,363
-7.6926,53.28823,2021/09/09 23:00:00+00,Fri 10 Sep 2021,3360,13898,114,3527862,3309841,237354,3765216,3547195,79.9594470648921,75.3294766704885,364
-7.6926,53.28823,2021/09/10 23:00:00+00,Sat 11 Sep 2021,2544,11285,60,3530406,3321126,237414,3767820,3558540,80.0147465218574,75.570403068058,365
-7.6926,53.28823,2021/09/11 23:00:00+00,Sun 12 Sep 2021,2027,12856,1,3532433,3333982,237415,3769848,3571397,80.0578138408764,75.8434388277364,366
-7.6926,53.28823,2021/09/12 23:00:00+00,Mon 13 Sep 2021,1595,7695,50,3534028,3341677,237465,3771493,3579142,80.0927476376153,76.007914363142,367
-7.6926,53.28823,2021/09/13 23:00:00+00,Tue 14 Sep 2021,1531,10734,81,3535559,3352411,237546,3773105,3589957,80.1269806347842,76.237585494893,368
-7.6926,53.28823,2021/09/14 23:00:00+00,Wed 15 Sep 2021,3262,12366,134,3538821,3364777,237680,3776501,3602457,80.1990992814256,76.5030398774068,369
-7.6926,53.28823,2021/09/15 23:00:00+00,Thu 16 Sep 2021,1893,10564,112,3540714,3375341,237792,3778506,3613133,80.2416781643808,76.7297591564242,370
-7.6926,53.28823,2021/09/16 23:00:00+00,Fri 17 Sep 2021,2550,14576,90,3543264,3389917,237882,3781146,3627799,80.2977421299677,77.04121147434,371
-7.6926,53.28823,2021/09/17 23:00:00+00,Sat 18 Sep 2021,2277,11204,43,3545541,3401121,237925,3783466,3639046,80.3470104633623,77.2800567095506,372
-7.6926,53.28823,2021/09/18 23:00:00+00,Sun 19 Sep 2021,1856,8479,12,3547397,3409600,237937,3785334,3647537,80.3866799662852,77.4603745625046,373
-7.6926,53.28823,2021/09/19 23:00:00+00,Mon 20 Sep 2021,943,5586,32,3548340,3415186,237969,3786309,3653155,80.4073854081212,77.5796803801816,374
-7.6926,53.28823,2021/09/20 23:00:00+00,Tue 21 Sep 2021,1452,6632,90,3549792,3421818,238059,3787851,3659877,80.4401318607482,77.7224311289223,375
-7.6926,53.28823,2021/09/21 23:00:00+00,Wed 22 Sep 2021,1887,8111,96,3551679,3429929,238155,3789834,3668084,80.4822435439901,77.8967178583055,376
-7.6926,53.28823,2021/09/22 23:00:00+00,Thu 23 Sep 2021,1686,8732,87,3553365,3438661,238242,3791607,3676903,80.5198955936059,78.0840012342567,377
-7.6926,53.28823,2021/09/23 23:00:00+00,Fri 24 Sep 2021,1903,7361,79,3555268,3446022,238321,3793589,3684343,80.5619860404973,78.2419996827289,378
-7.6926,53.28823,2021/09/24 23:00:00+00,Sat 25 Sep 2021,2407,6564,51,3557675,3452586,238372,3796047,3690958,80.6141849902748,78.3824781419552,379
-7.6926,53.28823,2021/09/25 23:00:00+00,Sun 26 Sep 2021,1537,7086,0,3559212,3459672,238372,3797584,3698044,80.6468252611487,78.5329589223147,380
-7.6926,53.28823,2021/09/26 23:00:00+00,Mon 27 Sep 2021,1166,3769,45,3560378,3463441,238417,3798795,3701858,80.6725424817267,78.6139543635073,381
-7.6926,53.28823,2021/09/27 23:00:00+00,Tue 28 Sep 2021,1437,5094,91,3561815,3468535,238508,3800323,3707043,80.7049916254451,78.724064841374,382
-7.6926,53.28823,2021/09/28 23:00:00+00,Wed 29 Sep 2021,1641,3581,77,3563456,3472116,238585,3802041,3710701,80.7414756757778,78.8017474118729,383
-7.6926,53.28823,2021/09/29 23:00:00+00,Thu 30 Sep 2021,1279,3928,77,3564735,3476044,238662,3803397,3714706,80.7702721671929,78.8867989960303,384
-7.6926,53.28823,2021/09/30 23:00:00+00,Fri 01 Oct 2021,1836,5137,41,3566571,3481181,238703,3805274,3719884,80.8101327972712,78.9967608194428,385
-7.6926,53.28823,2021/10/01 23:00:00+00,Sat 02 Oct 2021,1704,4063,39,3568275,3485244,238742,3807017,3723986,80.8471477563689,79.0838723296086,386
-7.6926,53.28823,2021/10/02 23:00:00+00,Sun 03 Oct 2021,1194,3002,9,3569469,3488246,238751,3808220,3726997,80.8726950861421,79.1478149812685,387
-7.6926,53.28823,2021/10/03 23:00:00+00,Mon 04 Oct 2021,333,1203,17,3569802,3489449,238768,3808570,3728217,80.8801278088524,79.1737233290018,388
-7.6926,53.28823,2021/10/04 23:00:00+00,Tue 05 Oct 2021,958,2790,69,3570760,3492239,238837,3809597,3731076,80.9019375409198,79.2344380553704,389
-7.6926,53.28823,2021/10/05 23:00:00+00,Wed 06 Oct 2021,971,2526,35,3571731,3494765,238872,3810603,3733637,80.9233013096245,79.2888243492598,390
-7.6926,53.28823,2021/10/06 23:00:00+00,Thu 07 Oct 2021,1197,2665,44,3572928,3497430,238916,3811844,3736346,80.9496556207205,79.3463536230382,391
-7.6926,53.28823,2021/10/07 23:00:00+00,Fri 08 Oct 2021,974,2748,45,3573902,3500178,238961,3812863,3739139,80.971295461983,79.4056667502671,392
-7.6926,53.28823,2021/10/08 23:00:00+00,Sat 09 Oct 2021,729,2347,20,3574631,3502525,238981,3813612,3741506,80.9872014885832,79.4559331921399,393
-7.6926,53.28823,2021/10/09 23:00:00+00,Sun 10 Oct 2021,1500,3902,0,3576131,3506427,238981,3815112,3745408,81.0190560144849,79.5387974321854,394
-7.6926,53.28823,2021/10/10 23:00:00+00,Mon 11 Oct 2021,330,1089,15,3576461,3507516,238996,3815457,3746512,81.0263825554423,79.562242363249,395
-7.6926,53.28823,2021/10/11 23:00:00+00,Tue 12 Oct 2021,561,1580,20,3577022,3509096,239016,3816038,3748112,81.0387208751415,79.5962205242108,396
-7.6926,53.28823,2021/10/12 23:00:00+00,Wed 13 Oct 2021,1029,2014,9,3578051,3511110,239025,3817076,3750135,81.0607642070655,79.6391816614769,397
-7.6926,53.28823,2021/10/13 23:00:00+00,Thu 14 Oct 2021,687,1550,7,3578738,3512660,239032,3817770,3751692,81.0755022343826,79.6722466593628,398
-7.6926,53.28823,2021/10/14 23:00:00+00,Fri 15 Oct 2021,952,2034,7,3579690,3514694,239039,3818729,3753733,81.0958678946091,79.7155900509396,399
-7.6926,53.28823,2021/10/15 23:00:00+00,Sat 16 Oct 2021,1372,2608,12,3581062,3517302,239051,3820113,3756353,81.125259003841,79.7712292895145,400
-7.6926,53.28823,2021/10/16 23:00:00+00,Sun 17 Oct 2021,1698,2882,2,3582760,3520184,239053,3821813,3759237,81.1613607998629,79.8324749246481,401
-7.6926,53.28823,2021/10/17 23:00:00+00,Mon 18 Oct 2021,666,1201,4,3583426,3521385,239057,3822483,3760442,81.1755891547656,79.8580647271224,402
-7.6926,53.28823,2021/10/18 23:00:00+00,Tue 19 Oct 2021,1329,1751,12,3584755,3523136,239069,3823824,3762205,81.2040671009217,79.8955044132322,403
-7.6926,53.28823,2021/10/19 23:00:00+00,Wed 20 Oct 2021,2243,2280,0,3586998,3525416,239069,3826067,3764485,81.25170023532,79.9439232926027,404
-7.6926,53.28823,2021/10/20 23:00:00+00,Thu 21 Oct 2021,1744,1789,10,3588742,3527205,239079,3827821,3766284,81.2889487942743,79.9821274873341,405
-7.6926,53.28823,2021/10/21 23:00:00+00,Fri 22 Oct 2021,1491,1891,1,3590233,3529096,239080,3829313,3768176,81.3206334293712,80.0223066626714,406
-7.6926,53.28823,2021/10/22 23:00:00+00,Sat 23 Oct 2021,2007,1673,0,3592240,3530769,239080,3831320,3769849,81.3632547850276,80.057835077227,407
-7.6926,53.28823,2021/10/23 23:00:00+00,Sun 24 Oct 2021,1943,2177,2,3594183,3532946,239082,3833265,3772028,81.4045594869468,80.1041090851869,408
-7.6926,53.28823,2021/10/24 23:00:00+00,Mon 25 Oct 2021,1216,819,1,3595399,3533765,239083,3834482,3772848,81.4304041256283,80.1215228926798,409
-7.6926,53.28823,2021/10/25 23:00:00+00,Tue 26 Oct 2021,1236,1187,6,3596635,3534952,239089,3835724,3774041,81.4567796730749,80.1468578589469,410
-7.6926,53.28823,2021/10/26 23:00:00+00,Wed 27 Oct 2021,1549,1392,5,3598184,3536344,239094,3837278,3775438,81.489780961909,80.1765250407366,411
-7.6926,53.28823,2021/10/27 23:00:00+00,Thu 28 Oct 2021,2141,1660,2,3600325,3538004,239096,3839421,3777100,81.5352904612472,80.2118198554357,412
-7.6926,53.28823,2021/10/28 23:00:00+00,Fri 29 Oct 2021,2131,1333,0,3602456,3539337,239096,3841552,3778433,81.5805451243781,80.2401279107869,413
-7.6926,53.28823,2021/10/29 23:00:00+00,Sat 30 Oct 2021,2005,1430,0,3604461,3540767,239096,3843557,3779863,81.6231240073333,80.2704958921465,414
-7.6926,53.28823,2021/10/30 23:00:00+00,Sun 31 Oct 2021,1624,1312,0,3606085,3542079,239096,3845181,3781175,81.6576118407095,80.2983579841352,415
-7.6926,53.28823,2021/11/01 00:00:00+00,Mon 01 Nov 2021,258,257,2,3606343,3542336,239098,3845441,3781434,81.6631332918658,80.3038581989409,416
-7.6926,53.28823,2021/11/02 00:00:00+00,Tue 02 Nov 2021,1087,1071,9,3607430,3543407,239107,3846537,3782514,81.6864083321246,80.3267934575901,417
-7.6926,53.28823,2021/11/03 00:00:00+00,Wed 03 Nov 2021,2532,1826,5,3609962,3545233,239112,3849074,3784345,81.7402849535996,80.3656772155407,418
-7.6926,53.28823,2021/11/04 00:00:00+00,Thu 04 Nov 2021,1541,1250,1,3611503,3546483,239113,3850616,3785596,81.7730314062265,80.3922438901427,419
-7.6926,53.28823,2021/11/05 00:00:00+00,Fri 05 Nov 2021,1627,1056,2,3613130,3547539,239115,3852245,3786654,81.8076254213558,80.4147119490786,420
-7.6926,53.28823,2021/11/06 00:00:00+00,Sat 06 Nov 2021,1818,1336,5,3614948,3548875,239120,3854068,3787995,81.8463392885016,80.4431898952347,421
-7.6926,53.28823,2021/11/07 00:00:00+00,Sun 07 Nov 2021,725,765,0,3615673,3549640,239120,3854793,3788760,81.8617356426874,80.4594357034446,422
-7.6926,53.28823,2021/11/08 00:00:00+00,Mon 08 Nov 2021,509,509,1,3616182,3550149,239121,3855303,3789270,81.8725661814939,80.4702662422511,423
-7.6926,53.28823,2021/11/09 00:00:00+00,Tue 09 Nov 2021,1376,1024,1,3617558,3551173,239122,3856680,3790295,81.9018086362716,80.4920335016173,424
-7.6926,53.28823,2021/11/10 00:00:00+00,Wed 10 Nov 2021,1625,1314,0,3619183,3552487,239122,3858305,3791609,81.9363177059984,80.5199380663071,425
-7.6926,53.28823,2021/11/11 00:00:00+00,Thu 11 Nov 2021,1399,1082,1,3620582,3553569,239123,3859705,3792692,81.96604859684,80.5429370340081,426
-7.6926,53.28823,2021/11/12 00:00:00+00,Fri 12 Nov 2021,1154,1097,5,3621736,3554666,239128,3860864,3793794,81.9906615271867,80.5663394923705,427
-7.6926,53.28823,2021/11/13 00:00:00+00,Sat 13 Nov 2021,1412,1353,0,3623148,3556019,239128,3862276,3795147,82.0206472542354,80.5950722747338,428
