X,Y,VaccinationDate,VaccineText,Dose1,Dose2,SingleDose,Dose1Cum,Dose2Cum,SingleDoseCum,PartiallyVacc,FullyVacc,PartialPercent,FullyPercent,ObjectId
-7.6926,53.28823,2021/08/10 23:00:00+00,Wed 11 Aug 2021,6968,31143,652,3281107,2831810,229138,3510245,3060948,74.5447935157777,65.0033648997528,1
-7.6926,53.28823,2021/08/11 23:00:00+00,Thu 12 Aug 2021,6722,38209,857,3287829,2870019,229995,3517824,3100014,74.7057438169834,65.8329841723355,2
-7.6926,53.28823,2021/08/12 23:00:00+00,Fri 13 Aug 2021,10875,28160,860,3298704,2898179,230855,3529559,3129034,74.9549523912874,66.4492630667796,3
-7.6926,53.28823,2021/08/13 23:00:00+00,Sat 14 Aug 2021,18094,5796,277,3316798,2903975,231132,3547930,3135107,75.3450853881803,66.5782314239801,4
-7.6926,53.28823,2021/08/14 23:00:00+00,Sun 15 Aug 2021,16976,3690,46,3333774,2907665,231178,3564952,3138843,75.7065705481123,66.6575704298259,5
-7.6926,53.28823,2021/08/15 23:00:00+00,Mon 16 Aug 2021,10149,23066,379,3343923,2930731,231557,3575480,3162288,75.9301468472408,67.1554566696688,6
-7.6926,53.28823,2021/08/16 23:00:00+00,Tue 17 Aug 2021,12853,26805,523,3356776,2957536,232080,3588856,3189616,76.2142042728812,67.7358036588958,7
-7.6926,53.28823,2021/08/17 23:00:00+00,Wed 18 Aug 2021,15188,25711,654,3371964,2983247,232734,3604698,3215981,76.5506305391039,68.2957000424939,8
-7.6926,53.28823,2021/08/18 23:00:00+00,Thu 19 Aug 2021,11337,25627,537,3383301,3008874,233271,3616572,3242145,76.8027909661414,68.8513279196213,9
-7.6926,53.28823,2021/08/19 23:00:00+00,Fri 20 Aug 2021,14813,22175,683,3398114,3031049,233954,3632068,3265003,77.1318694550561,69.3367484216613,10
-7.6926,53.28823,2021/08/20 23:00:00+00,Sat 21 Aug 2021,11847,7923,240,3409961,3038972,234194,3644155,3273166,77.3885532247717,69.5101007516182,11
-7.6926,53.28823,2021/08/21 23:00:00+00,Sun 22 Aug 2021,7993,12216,160,3417954,3051188,234354,3652308,3285542,77.5616931912225,69.7729218266574,12
-7.6926,53.28823,2021/08/22 23:00:00+00,Mon 23 Aug 2021,10839,15312,284,3428793,3066500,234638,3663431,3301138,77.7979051189586,70.1041239506323,13
-7.6926,53.28823,2021/08/23 23:00:00+00,Tue 24 Aug 2021,9724,22865,382,3438517,3089365,235020,3673537,3324385,78.0125196781334,70.5978053930562,14
-7.6926,53.28823,2021/08/24 23:00:00+00,Wed 25 Aug 2021,9394,19454,310,3447911,3108819,235330,3683241,3344149,78.2185972243665,71.0175206263364,15
-7.6926,53.28823,2021/08/25 23:00:00+00,Thu 26 Aug 2021,8555,19369,363,3456466,3128188,235693,3692159,3363881,78.4079829990272,71.4365562963974,16
-7.6926,53.28823,2021/08/26 23:00:00+00,Fri 27 Aug 2021,9695,19144,430,3466161,3147332,236123,3702284,3383455,78.6230010488634,71.8522366230635,17
-7.6926,53.28823,2021/08/27 23:00:00+00,Sat 28 Aug 2021,9906,7866,152,3476067,3155198,236275,3712342,3391473,78.8365962632093,72.0225096821831,18
-7.6926,53.28823,2021/08/28 23:00:00+00,Sun 29 Aug 2021,8789,9164,28,3484856,3164362,236303,3721159,3400665,79.0238371664592,72.2177142169085,19
-7.6926,53.28823,2021/08/29 23:00:00+00,Mon 30 Aug 2021,5038,11062,80,3489894,3175424,236383,3726277,3411807,79.1325248088357,72.454329635306,20
-7.6926,53.28823,2021/08/30 23:00:00+00,Tue 31 Aug 2021,4045,12814,140,3493939,3188238,236523,3730462,3424761,79.2213989361013,72.7294253209927,21
-7.6926,53.28823,2021/08/31 23:00:00+00,Wed 01 Sep 2021,4922,12485,179,3498861,3200723,236702,3735563,3437425,79.3297255605175,72.9983624650052,22
-7.6926,53.28823,2021/09/01 23:00:00+00,Thu 02 Sep 2021,4993,12313,246,3503854,3213036,236948,3740802,3449984,79.4409828013167,73.2650697922044,23
-7.6926,53.28823,2021/09/02 23:00:00+00,Fri 03 Sep 2021,4749,16012,163,3508603,3229048,237111,3745714,3466159,79.5452957554694,73.6085677631773,24
-7.6926,53.28823,2021/09/03 23:00:00+00,Sat 04 Sep 2021,4617,10544,132,3513220,3239592,237243,3750463,3476835,79.646147184474,73.8352870421947,25
-7.6926,53.28823,2021/09/04 23:00:00+00,Sun 05 Sep 2021,5303,11877,1,3518523,3251469,237244,3755767,3488713,79.7587847880623,74.0875324146347,26
-7.6926,53.28823,2021/09/05 23:00:00+00,Mon 06 Sep 2021,2135,9641,74,3520658,3261110,237318,3757976,3498428,79.8056958865401,74.2938435607244,27
-7.6926,53.28823,2021/09/06 23:00:00+00,Tue 07 Sep 2021,3019,9965,153,3523677,3271075,237471,3761148,3508546,79.8730575906468,74.5087129561064,28
-7.6926,53.28823,2021/09/07 23:00:00+00,Wed 08 Sep 2021,2587,14767,185,3526264,3285842,237656,3763920,3523498,79.9319247545131,74.8262388702941,29
-7.6926,53.28823,2021/09/08 23:00:00+00,Thu 09 Sep 2021,3104,14760,137,3529368,3300602,237793,3767161,3538395,80.0007517668113,75.1425967851988,30
-7.6926,53.28823,2021/09/09 23:00:00+00,Fri 10 Sep 2021,3362,13916,115,3532730,3314518,237908,3770638,3552426,80.0745905578513,75.4405640204829,31
-7.6926,53.28823,2021/09/10 23:00:00+00,Sat 11 Sep 2021,2547,11298,62,3535277,3325816,237970,3773247,3563786,80.1299961965696,75.6818089633115,32
-7.6926,53.28823,2021/09/11 23:00:00+00,Sun 12 Sep 2021,2030,12864,1,3537307,3338680,237971,3775278,3576651,80.1731272246405,75.9550146137947,33
-7.6926,53.28823,2021/09/12 23:00:00+00,Mon 13 Sep 2021,1597,7704,50,3538904,3346384,238021,3776925,3584405,80.2081034940805,76.1196812763556,34
-7.6926,53.28823,2021/09/13 23:00:00+00,Tue 14 Sep 2021,1535,10750,81,3540439,3357134,238102,3778541,3595236,80.2424214366519,76.3496921897162,35
-7.6926,53.28823,2021/09/14 23:00:00+00,Wed 15 Sep 2021,3266,12372,136,3543705,3369506,238238,3781943,3607744,80.3146675013968,76.6153164630348,36
-7.6926,53.28823,2021/09/15 23:00:00+00,Thu 16 Sep 2021,1894,10570,113,3545599,3380076,238351,3783950,3618427,80.3572888570532,76.8421843965065,37
-7.6926,53.28823,2021/09/16 23:00:00+00,Fri 17 Sep 2021,2554,14586,92,3548153,3394662,238443,3786596,3633105,80.4134802407438,77.1538915506295,38
-7.6926,53.28823,2021/09/17 23:00:00+00,Sat 18 Sep 2021,2277,11210,43,3550430,3405872,238486,3788916,3644358,80.4627485741383,77.3928642039437,39
-7.6926,53.28823,2021/09/18 23:00:00+00,Sun 19 Sep 2021,1856,8483,13,3552286,3414355,238499,3790785,3652854,80.5024393134118,77.5732882386507,40
-7.6926,53.28823,2021/09/19 23:00:00+00,Mon 20 Sep 2021,945,5594,33,3553231,3419949,238532,3791763,3658481,80.5232084642997,77.6927851834831,41
-7.6926,53.28823,2021/09/20 23:00:00+00,Tue 21 Sep 2021,1458,6645,90,3554689,3426594,238622,3793311,3665216,80.5560823350302,77.8358120047816,42
-7.6926,53.28823,2021/09/21 23:00:00+00,Wed 22 Sep 2021,1889,8119,96,3556578,3434713,238718,3795296,3673431,80.5982364909734,78.0102686249697,43
-7.6926,53.28823,2021/09/22 23:00:00+00,Thu 23 Sep 2021,1689,8740,88,3558267,3443453,238806,3797073,3682259,80.6359734859916,78.1977431280762,44
-7.6926,53.28823,2021/09/23 23:00:00+00,Fri 24 Sep 2021,1904,7366,79,3560171,3450819,238885,3799056,3689704,80.6780851692335,78.3558477583015,45
-7.6926,53.28823,2021/09/24 23:00:00+00,Sat 25 Sep 2021,2410,6571,51,3562581,3457390,238936,3801517,3696326,80.7303478280629,78.496474871982,46
-7.6926,53.28823,2021/09/25 23:00:00+00,Sun 26 Sep 2021,1537,7089,0,3564118,3464479,238936,3803054,3703415,80.7629880989368,78.6470193613932,47
-7.6926,53.28823,2021/09/26 23:00:00+00,Mon 27 Sep 2021,1168,3773,45,3565286,3468252,238981,3804267,3707233,80.7887477922159,78.7280997479882,48
-7.6926,53.28823,2021/09/27 23:00:00+00,Tue 28 Sep 2021,1440,5103,91,3566726,3473355,239072,3805798,3712427,80.8212606449862,78.8384013530104,49
-7.6926,53.28823,2021/09/28 23:00:00+00,Wed 29 Sep 2021,1643,3593,77,3568369,3476948,239149,3807518,3716097,80.8577871680201,78.9163387597164,50
-7.6926,53.28823,2021/09/29 23:00:00+00,Thu 30 Sep 2021,1279,3933,77,3569648,3480881,239226,3808874,3720107,80.8865836594352,79.0014965256269,51
-7.6926,53.28823,2021/09/30 23:00:00+00,Fri 01 Oct 2021,1834,5144,41,3571482,3486025,239267,3810749,3725292,80.9264018168123,79.1116070034936,52
-7.6926,53.28823,2021/10/01 23:00:00+00,Sat 02 Oct 2021,1705,4070,40,3573187,3490095,239307,3812494,3729402,80.9634592486112,79.1988884044641,53
-7.6926,53.28823,2021/10/02 23:00:00+00,Sun 03 Oct 2021,1194,3005,9,3574381,3493100,239316,3813697,3732416,80.9890065783843,79.2628947651759,54
-7.6926,53.28823,2021/10/03 23:00:00+00,Mon 04 Oct 2021,334,1212,17,3574715,3494312,239333,3814048,3733645,80.9964605374453,79.2889942400646,55
-7.6926,53.28823,2021/10/04 23:00:00+00,Tue 05 Oct 2021,958,2803,69,3575673,3497115,239402,3815075,3736517,81.0182702695127,79.349985038991,56
-7.6926,53.28823,2021/10/05 23:00:00+00,Wed 06 Oct 2021,970,2539,35,3576643,3499654,239437,3816080,3739091,81.0396128018668,79.4046474054382,57
-7.6926,53.28823,2021/10/06 23:00:00+00,Thu 07 Oct 2021,1201,2669,44,3577844,3502323,239481,3817325,3741804,81.0660520583651,79.462261624619,58
-7.6926,53.28823,2021/10/07 23:00:00+00,Fri 08 Oct 2021,974,2762,45,3578818,3505085,239526,3818344,3744611,81.0876918996277,79.5218720607564,59
-7.6926,53.28823,2021/10/08 23:00:00+00,Sat 09 Oct 2021,728,2356,23,3579546,3507441,239549,3819095,3746990,81.1036403989291,79.5723933388364,60
-7.6926,53.28823,2021/10/09 23:00:00+00,Sun 10 Oct 2021,1499,3904,1,3581045,3511345,239550,3820595,3750895,81.1354949248308,79.6553212879337,61
-7.6926,53.28823,2021/10/10 23:00:00+00,Mon 11 Oct 2021,330,1098,15,3581375,3512443,239565,3820940,3752008,81.1428214657881,79.6789573461527,62
-7.6926,53.28823,2021/10/11 23:00:00+00,Tue 12 Oct 2021,562,1586,20,3581937,3514029,239585,3821522,3753614,81.155181021838,79.7130629252181,63
-7.6926,53.28823,2021/10/12 23:00:00+00,Wed 13 Oct 2021,1019,2029,9,3582956,3516058,239594,3822550,3755652,81.1770119902559,79.7563426077432,64
-7.6926,53.28823,2021/10/13 23:00:00+00,Thu 14 Oct 2021,689,1561,7,3583645,3517619,239601,3823246,3757220,81.1917924902743,79.7896412054857,65
-7.6926,53.28823,2021/10/14 23:00:00+00,Fri 15 Oct 2021,953,2044,7,3584598,3519663,239608,3824206,3759271,81.2121793868513,79.8331969605686,66
-7.6926,53.28823,2021/10/15 23:00:00+00,Sat 16 Oct 2021,1373,2615,13,3585971,3522278,239621,3825592,3761899,81.2416129687845,79.8890060899483,67
-7.6926,53.28823,2021/10/16 23:00:00+00,Sun 17 Oct 2021,1697,2882,2,3587668,3525160,239623,3827291,3764783,81.2776935284558,79.9502517250819,68
-7.6926,53.28823,2021/10/17 23:00:00+00,Mon 18 Oct 2021,667,1213,4,3588335,3526373,239627,3827962,3766000,81.2919431197091,79.9760963637634,69
-7.6926,53.28823,2021/10/18 23:00:00+00,Tue 19 Oct 2021,1330,1768,12,3589665,3528141,239639,3829304,3767780,81.3204423022158,80.0138970678334,70
-7.6926,53.28823,2021/10/19 23:00:00+00,Wed 20 Oct 2021,2243,2287,0,3591908,3530428,239639,3831547,3770067,81.3680754366141,80.0624646016581,71
-7.6926,53.28823,2021/10/20 23:00:00+00,Thu 21 Oct 2021,1750,1799,10,3593658,3532227,239649,3833307,3771876,81.405451413672,80.1008811598955,72
-7.6926,53.28823,2021/10/21 23:00:00+00,Fri 22 Oct 2021,1491,1899,2,3595149,3534126,239651,3834800,3773777,81.4371572851195,80.1412514623882,73
-7.6926,53.28823,2021/10/22 23:00:00+00,Sat 23 Oct 2021,2008,1674,1,3597157,3535800,239652,3836809,3775452,81.4798211134771,80.1768223496451,74
-7.6926,53.28823,2021/10/23 23:00:00+00,Sun 24 Oct 2021,1943,2178,2,3599100,3537978,239654,3838754,3777632,81.5211258153962,80.2231175939555,75
-7.6926,53.28823,2021/10/24 23:00:00+00,Mon 25 Oct 2021,1215,823,2,3600315,3538801,239656,3839971,3778457,81.5469704540778,80.2406375832014,76
-7.6926,53.28823,2021/10/25 23:00:00+00,Tue 26 Oct 2021,1235,1191,6,3601550,3539992,239662,3841212,3779654,81.5733247651738,80.2660574948709,77
-7.6926,53.28823,2021/10/26 23:00:00+00,Wed 27 Oct 2021,1550,1398,5,3603100,3541390,239667,3842767,3781057,81.6063472903585,80.2958520947642,78
-7.6926,53.28823,2021/10/27 23:00:00+00,Thu 28 Oct 2021,2145,1665,3,3605245,3543055,239670,3844915,3782725,81.6519629714496,80.3312743275669,79
-7.6926,53.28823,2021/10/28 23:00:00+00,Fri 29 Oct 2021,2131,1340,0,3607376,3544395,239670,3847046,3784065,81.6972176345806,80.3597310373724,80
-7.6926,53.28823,2021/10/29 23:00:00+00,Sat 30 Oct 2021,2008,1431,0,3609384,3545826,239670,3849054,3785496,81.7398602265876,80.3901202550826,81
-7.6926,53.28823,2021/10/30 23:00:00+00,Sun 31 Oct 2021,1624,1314,0,3611008,3547140,239670,3850678,3786810,81.7743480599638,80.4180248197724,82
-7.6926,53.28823,2021/11/01 00:00:00+00,Mon 01 Nov 2021,260,259,1,3611268,3547399,239671,3850939,3787070,81.7798907474707,80.4235462709287,83
-7.6926,53.28823,2021/11/02 00:00:00+00,Tue 02 Nov 2021,1087,1073,9,3612355,3548472,239680,3852035,3788152,81.8031657877295,80.4465240022791,84
-7.6926,53.28823,2021/11/03 00:00:00+00,Wed 03 Nov 2021,2533,1836,5,3614888,3550308,239685,3854573,3789993,81.8570636455551,80.4856201237357,85
-7.6926,53.28823,2021/11/04 00:00:00+00,Thu 04 Nov 2021,1542,1250,1,3616430,3551558,239686,3856116,3791244,81.8898313345326,80.5121867983377,86
-7.6926,53.28823,2021/11/05 00:00:00+00,Fri 05 Nov 2021,1627,1060,2,3618057,3552618,239688,3857745,3792306,81.9244253496618,80.5347398026761,87
-7.6926,53.28823,2021/11/06 00:00:00+00,Sat 06 Nov 2021,1818,1337,5,3619875,3553955,239693,3859568,3793648,81.9631392168076,80.5632389851828,88
-7.6926,53.28823,2021/11/07 00:00:00+00,Sun 07 Nov 2021,725,765,0,3620600,3554720,239693,3860293,3794413,81.9785355709934,80.5794847933926,89
-7.6926,53.28823,2021/11/08 00:00:00+00,Mon 08 Nov 2021,514,513,2,3621114,3555233,239695,3860809,3794928,81.9894935279036,80.5904215139522,90
-7.6926,53.28823,2021/11/09 00:00:00+00,Tue 09 Nov 2021,1374,1037,1,3622488,3556270,239696,3862184,3795966,82.0186935099801,80.6124648458761,91
-7.6926,53.28823,2021/11/10 00:00:00+00,Wed 10 Nov 2021,1624,1323,0,3624112,3557593,239696,3863808,3797289,82.0531813433563,80.6405605377214,92
-7.6926,53.28823,2021/11/11 00:00:00+00,Thu 11 Nov 2021,1397,1085,1,3625509,3558678,239697,3865206,3798375,82.0828697614967,80.6636232144742,93
-7.6926,53.28823,2021/11/12 00:00:00+00,Fri 12 Nov 2021,1152,1117,5,3626661,3559795,239702,3866363,3799497,82.1074402191421,80.6874503998486,94
-7.6926,53.28823,2021/11/13 00:00:00+00,Sat 13 Nov 2021,1411,1358,0,3628072,3561153,239702,3867774,3800855,82.1374047098403,80.7162893639649,95
-7.6926,53.28823,2021/11/14 00:00:00+00,Sun 14 Nov 2021,1648,1800,0,3629720,3562953,239702,3869422,3802655,82.1724022156309,80.7545147950469,96
-7.6926,53.28823,2021/11/15 00:00:00+00,Mon 15 Nov 2021,1245,568,0,3630965,3563521,239702,3870667,3803223,82.1988414721293,80.7665770421883,97
-7.6926,53.28823,2021/11/16 00:00:00+00,Tue 16 Nov 2021,1319,1049,5,3632284,3564570,239707,3871991,3804277,82.2269584003252,80.7889601557219,98
-7.6926,53.28823,2021/11/17 00:00:00+00,Wed 17 Nov 2021,1518,1088,0,3633802,3565658,239707,3873509,3805365,82.2591951805376,80.8120653051759,99
-7.6926,53.28823,2021/11/18 00:00:00+00,Thu 18 Nov 2021,1665,2473,5,3635467,3568131,239712,3875179,3807843,82.2946598860415,80.8646889819654,100
-7.6926,53.28823,2021/11/19 00:00:00+00,Fri 19 Nov 2021,1183,1525,0,3636650,3569656,239712,3876362,3809368,82.3197824888026,80.8970744166321,101
-7.6926,53.28823,2021/11/20 00:00:00+00,Sat 20 Nov 2021,1540,2922,11,3638190,3572578,239723,3877913,3812301,82.3527200685849,80.9593606329452,102
-7.6926,53.28823,2021/11/21 00:00:00+00,Sun 21 Nov 2021,1788,2752,0,3639978,3575330,239723,3879701,3815053,82.3906906634597,81.0178030697994,103
-7.6926,53.28823,2021/11/22 00:00:00+00,Mon 22 Nov 2021,710,490,2,3640688,3575820,239725,3880413,3815545,82.4058109450877,81.0282513542952,104
-7.6926,53.28823,2021/11/23 00:00:00+00,Tue 23 Nov 2021,2162,1556,6,3642850,3577376,239731,3882581,3817107,82.4518513531909,81.0614225339341,105
-7.6926,53.28823,2021/11/24 00:00:00+00,Wed 24 Nov 2021,1626,3119,2,3644476,3580495,239733,3884209,3820228,82.4864241319695,81.1277011841601,106
-7.6926,53.28823,2021/11/25 00:00:00+00,Thu 25 Nov 2021,1001,1160,1,3645477,3581655,239734,3885211,3821389,82.5077029552718,81.152356587208,107
-7.6926,53.28823,2021/11/26 00:00:00+00,Fri 26 Nov 2021,1290,1076,12,3646767,3582731,239746,3886513,3822477,82.5353526837544,81.175461736662,108
-7.6926,53.28823,2021/11/27 00:00:00+00,Sat 27 Nov 2021,1226,1551,5,3647993,3584282,239751,3887744,3824033,82.5614946313444,81.2085054981974,109
-7.6926,53.28823,2021/11/28 00:00:00+00,Sun 28 Nov 2021,1966,2251,0,3649959,3586533,239751,3889710,3826284,82.6032452966262,81.2563085234004,110
-7.6926,53.28823,2021/11/29 00:00:00+00,Mon 29 Nov 2021,553,976,1,3650512,3587509,239752,3890264,3827261,82.6150102348592,81.2770564379377,111
-7.6926,53.28823,2021/11/30 00:00:00+00,Tue 30 Nov 2021,1927,1620,6,3652439,3589129,239758,3892197,3828887,82.6560601005711,81.3115867440151,112
-7.6926,53.28823,2021/12/01 00:00:00+00,Wed 01 Dec 2021,1081,1352,1,3653520,3590481,239759,3893279,3830240,82.6790378319215,81.3403195263784,113
-7.6926,53.28823,2021/04/19 23:00:00+00,Tue 20 Apr 2021,15063,7296,1,920940,388913,200,921140,389113,19.5616519927023,8.26334009144797,114
-7.6926,53.28823,2020/12/28 00:00:00+00,Mon 28 Dec 2020,195,20,0,195,20,0,195,20,0.00414108836721558,0.00042472701202211,115
-7.6926,53.28823,2021/12/02 00:00:00+00,Thu 02 Dec 2021,1775,1398,0,3655295,3591879,239759,3895054,3831638,82.7167323542385,81.3700079445188,116
-7.6926,53.28823,2020/12/29 00:00:00+00,Tue 29 Dec 2020,74,2,0,269,22,0,269,22,0.00571257831169739,0.000467199713224322,117
-7.6926,53.28823,2021/12/03 00:00:00+00,Fri 03 Dec 2021,1044,1165,3,3656339,3593044,239762,3896101,3832806,82.7389668133178,81.3948120020209,118
-7.6926,53.28823,2020/12/30 00:00:00+00,Wed 30 Dec 2020,1056,1,0,1325,23,0,1325,23,0.0281381645464648,0.000488436063825427,119
-7.6926,53.28823,2021/04/20 23:00:00+00,Wed 21 Apr 2021,26690,9864,3,947630,398777,203,947833,398980,20.1285138992977,8.47287916282908,120
-7.6926,53.28823,2021/12/04 00:00:00+00,Sat 04 Dec 2021,1201,1695,0,3657540,3594739,239762,3897302,3834501,82.7644716703898,81.4308076162897,121
-7.6926,53.28823,2020/12/31 00:00:00+00,Thu 31 Dec 2020,1031,1,0,2356,24,0,2356,24,0.0500328420162046,0.000509672414426533,122
-7.6926,53.28823,2021/04/21 23:00:00+00,Thu 22 Apr 2021,31608,12175,1,979238,410952,204,979442,411156,20.799773705448,8.73145296774814,123
-7.6926,53.28823,2021/12/05 00:00:00+00,Sun 05 Dec 2021,1348,1770,0,3658888,3596509,239762,3898650,3836271,82.793098271,81.4683959568537,124
-7.6926,53.28823,2021/01/01 00:00:00+00,Fri 01 Jan 2021,806,0,0,3162,24,0,3162,24,0.0671493406006957,0.000509672414426533,125
-7.6926,53.28823,2021/04/22 23:00:00+00,Fri 23 Apr 2021,33572,12359,1,1012810,423311,205,1013015,423516,21.5127417041789,8.99393426117781,126
-7.6926,53.28823,2021/12/06 00:00:00+00,Mon 06 Dec 2021,936,1276,0,3659824,3597785,239762,3899586,3837547,82.8129754951627,81.4954935402207,127
-7.6926,53.28823,2021/01/02 00:00:00+00,Sat 02 Jan 2021,1014,0,0,4176,24,0,4176,24,0.0886830001102167,0.000509672414426533,128
-7.6926,53.28823,2021/04/23 23:00:00+00,Sat 24 Apr 2021,23686,6979,2,1036496,430290,207,1036703,430497,22.0157883772179,9.14218522472412,129
-7.6926,53.28823,2021/12/07 00:00:00+00,Tue 07 Dec 2021,485,730,1,3660309,3598515,239763,3900072,3838278,82.8232963615548,81.5110173125101,130
-7.6926,53.28823,2021/01/03 00:00:00+00,Sun 03 Jan 2021,19,2,0,4195,26,0,4195,26,0.0890864907716377,0.000552145115628744,131
-7.6926,53.28823,2021/04/24 23:00:00+00,Sun 25 Apr 2021,9729,295,2,1046225,430585,209,1046434,430794,22.2224393049173,9.14849242085265,132
-7.6926,53.28823,2021/12/08 00:00:00+00,Wed 08 Dec 2021,812,1488,0,3661121,3600003,239763,3900884,3839766,82.8405402782429,81.5426170022045,133
-7.6926,53.28823,2021/01/04 00:00:00+00,Mon 04 Jan 2021,1187,3,0,5382,29,0,5382,29,0.11429403893515,0.00061585416743206,134
-7.6926,53.28823,2021/04/25 23:00:00+00,Mon 26 Apr 2021,15550,3037,3,1061775,433622,212,1061987,433834,22.5527282658162,9.21305092668001,135
-7.6926,53.28823,2021/12/09 00:00:00+00,Thu 09 Dec 2021,796,1185,0,3661917,3601188,239763,3901680,3840951,82.8574444133214,81.5677820776668,136
-7.6926,53.28823,2021/01/05 00:00:00+00,Tue 05 Jan 2021,3522,9,0,8904,38,0,8904,38,0.189088465752244,0.00080698132284201,137
-7.6926,53.28823,2021/04/26 23:00:00+00,Tue 27 Apr 2021,25893,7799,8,1087668,441421,220,1087888,441641,23.1027709827355,9.37884311582284,138
-7.6926,53.28823,2021/12/10 00:00:00+00,Fri 10 Dec 2021,893,1591,1,3662810,3602779,239764,3902574,3842543,82.8764297107588,81.6015903478238,139
-7.6926,53.28823,2021/01/06 00:00:00+00,Wed 06 Jan 2021,6769,8,0,15673,46,0,15673,46,0.332837322971127,0.000976872127650854,140
-7.6926,53.28823,2021/04/27 23:00:00+00,Wed 28 Apr 2021,26011,8584,5,1113679,450005,225,1113904,450230,23.6552558799738,9.56124213113574,141
-7.6926,53.28823,2021/12/11 00:00:00+00,Sat 11 Dec 2021,636,835,0,3663446,3603614,239764,3903210,3843378,82.8899360297411,81.6193227005757,142
-7.6926,53.28823,2021/01/07 00:00:00+00,Thu 07 Jan 2021,11716,8,0,27389,54,0,27389,54,0.581642406613679,0.0011467629324597,143
-7.6926,53.28823,2021/04/28 23:00:00+00,Thu 29 Apr 2021,31667,11329,4,1145346,461334,229,1145575,461563,24.3278323398615,9.80191369249807,144
-7.6926,53.28823,2021/12/12 00:00:00+00,Sun 12 Dec 2021,691,1188,0,3664137,3604802,239764,3903901,3844566,82.9046103480064,81.6445514850898,145
-7.6926,53.28823,2021/12/13 00:00:00+00,Mon 13 Dec 2021,722,1045,0,3664859,3605847,239764,3904623,3845611,82.9199429931405,81.666743471468,146
-7.6926,53.28823,2021/12/14 00:00:00+00,Tue 14 Dec 2021,631,1180,1,3665490,3607027,239765,3905255,3846792,82.9333643667203,81.6918236015279,147
-7.6926,53.28823,2021/12/15 00:00:00+00,Wed 15 Dec 2021,796,1228,1,3666286,3608255,239766,3906052,3848021,82.9502897381494,81.7179230764167,148
-7.6926,53.28823,2021/12/16 00:00:00+00,Thu 16 Dec 2021,1065,1516,7,3667351,3609771,239773,3907124,3849544,82.9730551059938,81.7502660383822,149
-7.6926,53.28823,2021/12/17 00:00:00+00,Fri 17 Dec 2021,1212,2434,1,3668563,3612205,239774,3908337,3851979,82.998814799273,81.8019765520959,150
-7.6926,53.28823,2021/12/18 00:00:00+00,Sat 18 Dec 2021,1266,1168,0,3669829,3613373,239774,3909603,3853147,83.025700019134,81.8267806095979,151
-7.6926,53.28823,2021/12/19 00:00:00+00,Sun 19 Dec 2021,558,877,0,3670387,3614250,239774,3910161,3854024,83.0375499027694,81.8454048890751,152
-7.6926,53.28823,2021/12/20 00:00:00+00,Mon 20 Dec 2021,541,589,0,3670928,3614839,239774,3910702,3854613,83.0490387684446,81.8579130995792,153
-7.6926,53.28823,2021/12/21 00:00:00+00,Tue 21 Dec 2021,1467,1774,3,3672395,3616613,239777,3912172,3856390,83.0802562038282,81.8956500945973,154
-7.6926,53.28823,2021/12/22 00:00:00+00,Wed 22 Dec 2021,1238,1547,2,3673633,3618160,239779,3913412,3857939,83.1065892785736,81.9285452016784,155
-7.6926,53.28823,2021/12/23 00:00:00+00,Thu 23 Dec 2021,963,1340,0,3674596,3619500,239779,3914375,3859279,83.1270398842024,81.9570019114839,156
-7.6926,53.28823,2021/12/24 00:00:00+00,Fri 24 Dec 2021,102,137,0,3674698,3619637,239779,3914477,3859416,83.1292059919637,81.9599112915163,157
-7.6926,53.28823,2021/12/25 00:00:00+00,Sat 25 Dec 2021,1,0,0,3674699,3619637,239779,3914478,3859416,83.1292272283143,81.9599112915163,158
-7.6926,53.28823,2021/12/26 00:00:00+00,Sun 26 Dec 2021,10,6,0,3674709,3619643,239779,3914488,3859422,83.1294395918204,81.9600387096199,159
-7.6926,53.28823,2021/12/27 00:00:00+00,Mon 27 Dec 2021,388,581,0,3675097,3620224,239779,3914876,3860003,83.1376792958536,81.9723770293191,160
-7.6926,53.28823,2021/12/28 00:00:00+00,Tue 28 Dec 2021,468,736,0,3675565,3620960,239779,3915344,3860739,83.1476179079349,81.9880069833615,161
-7.6926,53.28823,2021/12/29 00:00:00+00,Wed 29 Dec 2021,1087,1277,0,3676652,3622237,239779,3916431,3862016,83.1707018210383,82.0151258030791,162
-7.6926,53.28823,2021/12/30 00:00:00+00,Thu 30 Dec 2021,1071,1170,1,3677723,3623407,239780,3917503,3863187,83.1934671888827,82.039993569633,163
-7.6926,53.28823,2021/12/31 00:00:00+00,Fri 31 Dec 2021,721,1666,0,3678444,3625073,239780,3918224,3864853,83.2087785976661,82.0753733297345,164
-7.6926,53.28823,2022/01/01 00:00:00+00,Sat 01 Jan 2022,66,95,0,3678510,3625168,239780,3918290,3864948,83.2101801968058,82.0773907830416,165
-7.6926,53.28823,2022/01/02 00:00:00+00,Sun 02 Jan 2022,270,622,0,3678780,3625790,239780,3918560,3865570,83.215914011468,82.0905997931155,166
-7.6926,53.28823,2022/01/03 00:00:00+00,Mon 03 Jan 2022,3631,714,0,3682411,3626504,239780,3922191,3866284,83.2930232005007,82.1057625474447,167
-7.6926,53.28823,2022/01/04 00:00:00+00,Tue 04 Jan 2022,1194,758,0,3683605,3627262,239780,3923385,3867042,83.3183794031184,82.1218597012003,168
-7.6926,53.28823,2022/01/05 00:00:00+00,Wed 05 Jan 2022,2142,879,0,3685747,3628141,239780,3925527,3867921,83.3638676661059,82.1405264533787,169
-7.6926,53.28823,2022/01/06 00:00:00+00,Thu 06 Jan 2022,2463,1660,1,3688210,3629801,239781,3927991,3869582,83.4161940339871,82.1758000317271,170
-7.6926,53.28823,2022/01/07 00:00:00+00,Fri 07 Jan 2022,4849,760,0,3693059,3630561,239781,3932840,3870342,83.5191690980518,82.1919396581839,171
-7.6926,53.28823,2022/01/08 00:00:00+00,Sat 08 Jan 2022,9789,730,1,3702848,3631291,239782,3942630,3871073,83.7270729704367,82.2074634304734,172
-7.6926,53.28823,2022/01/09 00:00:00+00,Sun 09 Jan 2022,7115,664,0,3709963,3631955,239782,3949745,3871737,83.8781696049635,82.2215643672725,173
-7.6926,53.28823,2022/01/10 00:00:00+00,Mon 10 Jan 2022,6654,487,0,3716617,3632442,239782,3956399,3872224,84.0194762818633,82.2319064700152,174
-7.6926,53.28823,2022/01/11 00:00:00+00,Tue 11 Jan 2022,4769,1338,1,3721386,3633780,239783,3961169,3873563,84.1207736742306,82.2603419434701,175
-7.6926,53.28823,2022/01/12 00:00:00+00,Wed 12 Jan 2022,7555,885,1,3728941,3634665,239784,3968725,3874449,84.2812355393725,82.2791573501027,176
-7.6926,53.28823,2022/01/13 00:00:00+00,Thu 13 Jan 2022,7322,788,0,3736263,3635453,239784,3976047,3875237,84.4367280984738,82.2958915943764,177
-7.6926,53.28823,2022/01/14 00:00:00+00,Fri 14 Jan 2022,10728,813,0,3746991,3636266,239784,3986775,3876050,84.6645516677225,82.3131567474151,178
-7.6926,53.28823,2022/01/15 00:00:00+00,Sat 15 Jan 2022,8353,636,0,3755344,3636902,239784,3995128,3876686,84.8419389042935,82.3266630663974,179
-7.6926,53.28823,2022/01/16 00:00:00+00,Sun 16 Jan 2022,6966,1212,1,3762310,3638114,239785,4002095,3877899,84.9898925589314,82.3524227596765,180
-7.6926,53.28823,2022/01/17 00:00:00+00,Mon 17 Jan 2022,2561,543,0,3764871,3638657,239785,4004656,3878442,85.0442788528208,82.3639540980529,181
-7.6926,53.28823,2022/01/18 00:00:00+00,Tue 18 Jan 2022,4059,427,3,3768930,3639084,239788,4008718,3878872,85.1305409089625,82.3730857288114,182
-7.6926,53.28823,2022/01/19 00:00:00+00,Wed 19 Jan 2022,3480,607,0,3772410,3639691,239788,4012198,3879479,85.2044434090544,82.3859761936262,183
-7.6926,53.28823,2022/01/20 00:00:00+00,Thu 20 Jan 2022,3688,919,0,3776098,3640610,239788,4015886,3880398,85.2827630700713,82.4054923998287,184
-7.6926,53.28823,2022/01/21 00:00:00+00,Fri 21 Jan 2022,3251,960,0,3779349,3641570,239788,4019137,3881358,85.3518024458754,82.4258792964057,185
-7.6926,53.28823,2022/01/22 00:00:00+00,Sat 22 Jan 2022,4272,634,0,3783621,3642204,239788,4023409,3881992,85.4425241356434,82.4393431426868,186
-7.6926,53.28823,2022/01/23 00:00:00+00,Sun 23 Jan 2022,3092,677,0,3786713,3642881,239788,4026501,3882669,85.508186931702,82.4537201520438,187
-7.6926,53.28823,2022/01/24 00:00:00+00,Mon 24 Jan 2022,645,454,0,3787358,3643335,239788,4027146,3883123,85.5218843778397,82.4633614552167,188
-7.6926,53.28823,2022/01/25 00:00:00+00,Tue 25 Jan 2022,697,1823,0,3788055,3645158,239788,4027843,3884946,85.5366861142087,82.5020753223625,189
-7.6926,53.28823,2022/01/26 00:00:00+00,Wed 26 Jan 2022,699,876,0,3788754,3646034,239788,4028542,3885822,85.5515303232788,82.5206783654891,190
-7.6926,53.28823,2022/01/27 00:00:00+00,Thu 27 Jan 2022,1271,1150,0,3790025,3647184,239788,4029813,3886972,85.5785217248928,82.5451001686803,191
-7.6926,53.28823,2022/01/28 00:00:00+00,Fri 28 Jan 2022,1026,3076,0,3791051,3650260,239788,4030839,3890048,85.6003102206096,82.6104231831293,192
-7.6926,53.28823,2022/01/29 00:00:00+00,Sat 29 Jan 2022,2325,3441,0,3793376,3653701,239788,4033164,3893489,85.6496847357571,82.6834974655477,193
-7.6926,53.28823,2022/01/30 00:00:00+00,Sun 30 Jan 2022,1634,7535,0,3795010,3661236,239788,4034798,3901024,85.6843849326394,82.8435133673271,194
-7.6926,53.28823,2022/01/31 00:00:00+00,Mon 31 Jan 2022,479,1377,0,3795489,3662613,239788,4035277,3902401,85.6945571445773,82.8727558221048,195
-7.6926,53.28823,2022/02/01 00:00:00+00,Tue 01 Feb 2022,749,3406,1,3796238,3666019,239789,4036027,3905808,85.7104844075281,82.9451080686028,196
-7.6926,53.28823,2022/02/02 00:00:00+00,Wed 02 Feb 2022,643,2983,0,3796881,3669002,239789,4036670,3908791,85.7241393809646,83.0084561024458,197
-7.6926,53.28823,2022/02/03 00:00:00+00,Thu 03 Feb 2022,909,2419,1,3797790,3671421,239790,4037580,3911211,85.7434644600116,83.0598480709005,198
-7.6926,53.28823,2022/02/04 00:00:00+00,Fri 04 Feb 2022,1169,6500,0,3798959,3677921,239790,4038749,3917711,85.7682897538643,83.1978843498077,199
-7.6926,53.28823,2022/02/05 00:00:00+00,Sat 05 Feb 2022,1777,5744,0,3800736,3683665,239790,4040526,3923455,85.8060267488825,83.3198659476605,200
-7.6926,53.28823,2022/02/06 00:00:00+00,Sun 06 Feb 2022,1408,7555,0,3802144,3691220,239790,4041934,3931010,85.8359275305288,83.4803065764518,201
-7.6926,53.28823,2022/02/07 00:00:00+00,Mon 07 Feb 2022,433,1343,0,3802577,3692563,239790,4042367,3932353,85.8451228703391,83.5088269953091,202
-7.6926,53.28823,2022/02/08 00:00:00+00,Tue 08 Feb 2022,898,1219,0,3803475,3693782,239790,4043265,3933572,85.8641931131789,83.5347141066919,203
-7.6926,53.28823,2022/02/09 00:00:00+00,Wed 09 Feb 2022,1332,1758,0,3804807,3695540,239790,4044597,3935330,85.8924799321796,83.5720476110486,204
-7.6926,53.28823,2022/02/10 00:00:00+00,Thu 10 Feb 2022,687,2535,0,3805494,3698075,239790,4045284,3937865,85.9070693050426,83.6258817598224,205
-7.6926,53.28823,2022/02/11 00:00:00+00,Fri 11 Feb 2022,555,4905,0,3806049,3702980,239790,4045839,3942770,85.9188554796262,83.7300460595208,206
-7.6926,53.28823,2022/02/12 00:00:00+00,Sat 12 Feb 2022,1396,5458,0,3807445,3708438,239790,4047235,3948228,85.9485014250653,83.8459540611017,207
-7.6926,53.28823,2022/02/13 00:00:00+00,Sun 13 Feb 2022,1567,4706,0,3809012,3713144,239790,4048802,3952934,85.9817787864572,83.9458923270305,208
-7.6926,53.28823,2022/02/14 00:00:00+00,Mon 14 Feb 2022,173,945,1,3809185,3714089,239791,4048976,3953880,85.9854739114618,83.9659819146991,209
-7.6926,53.28823,2022/02/15 00:00:00+00,Tue 15 Feb 2022,645,801,1,3809830,3714890,239792,4049622,3954682,85.9991925939501,83.9830134678812,210
-7.6926,53.28823,2022/02/16 00:00:00+00,Wed 16 Feb 2022,791,1776,0,3810621,3716666,239792,4050413,3956458,86.0159905472756,84.0207292265488,211
-7.6926,53.28823,2022/02/17 00:00:00+00,Thu 17 Feb 2022,789,1180,2,3811410,3717846,239794,4051204,3957640,86.0327885006011,84.0458305929593,212
-7.6926,53.28823,2022/02/18 00:00:00+00,Fri 18 Feb 2022,793,3272,0,3812203,3721118,239794,4051997,3960912,86.0496289266278,84.1153159321261,213
-7.6926,53.28823,2022/02/19 00:00:00+00,Sat 19 Feb 2022,976,3545,0,3813179,3724663,239794,4052973,3964457,86.0703556048145,84.190598795007,214
-7.6926,53.28823,2022/02/20 00:00:00+00,Sun 20 Feb 2022,1366,3587,0,3814545,3728250,239794,4054339,3968044,86.0993644597356,84.2667735846132,215
-7.6926,53.28823,2022/02/21 00:00:00+00,Mon 21 Feb 2022,250,989,1,3814795,3729239,239795,4054590,3969034,86.1046947837364,84.2877975717083,216
-7.6926,53.28823,2022/02/22 00:00:00+00,Tue 22 Feb 2022,473,961,0,3815268,3730200,239795,4055063,3969995,86.1147395775708,84.3082057046359,217
-7.6926,53.28823,2022/02/23 00:00:00+00,Wed 23 Feb 2022,823,1260,1,3816091,3731460,239796,4055887,3971256,86.1322383304661,84.3349847427439,218
-7.6926,53.28823,2022/02/24 00:00:00+00,Thu 24 Feb 2022,658,1215,0,3816749,3732675,239796,4056545,3972471,86.1462118491616,84.3607869087243,219
-7.6926,53.28823,2022/02/25 00:00:00+00,Fri 25 Feb 2022,688,1212,0,3817437,3733887,239796,4057233,3973683,86.1608224583752,84.3865253656528,220
-7.6926,53.28823,2022/02/26 00:00:00+00,Sat 26 Feb 2022,956,2084,0,3818393,3735971,239796,4058189,3975767,86.1811244095498,84.4307819203055,221
-7.6926,53.28823,2022/02/27 00:00:00+00,Sun 27 Feb 2022,670,1780,0,3819063,3737751,239796,4058859,3977547,86.1953527644526,84.4685826243755,222
-7.6926,53.28823,2022/02/28 00:00:00+00,Mon 28 Feb 2022,82,422,0,3819145,3738173,239796,4058941,3977969,86.1970941452018,84.4775443643291,223
-7.6926,53.28823,2022/03/01 00:00:00+00,Tue 01 Mar 2022,122,931,0,3819267,3739104,239796,4059063,3978900,86.1996849799752,84.4973154067388,224
-7.6926,53.28823,2022/03/02 00:00:00+00,Wed 02 Mar 2022,200,984,2,3819467,3740088,239798,4059265,3979886,86.2039747227966,84.5182544484314,225
-7.6926,53.28823,2022/03/03 00:00:00+00,Thu 03 Mar 2022,266,1263,0,3819733,3741351,239798,4059531,3981149,86.2096235920565,84.5450759592406,226
-7.6926,53.28823,2022/03/04 00:00:00+00,Fri 04 Mar 2022,726,1483,2,3820459,3742834,239800,4060259,3982634,86.2250836552941,84.5766119398833,227
-7.6926,53.28823,2022/03/05 00:00:00+00,Sat 05 Mar 2022,961,3330,0,3821420,3746164,239800,4061220,3985964,86.2454917882218,84.647328987385,228
-7.6926,53.28823,2022/03/06 00:00:00+00,Sun 06 Mar 2022,455,1915,0,3821875,3748079,239800,4061675,3987879,86.2551543277453,84.6879965987861,229
-7.6926,53.28823,2022/03/07 00:00:00+00,Mon 07 Mar 2022,112,107,0,3821987,3748186,239800,4061787,3987986,86.2575327990126,84.6902688883004,230
-7.6926,53.28823,2022/03/08 00:00:00+00,Tue 08 Mar 2022,117,478,0,3822104,3748664,239800,4061904,3988464,86.2600174520329,84.7004198638877,231
-7.6926,53.28823,2022/03/09 00:00:00+00,Wed 09 Mar 2022,114,316,0,3822218,3748980,239800,4062018,3988780,86.2624383960015,84.7071305506777,232
-7.6926,53.28823,2022/03/10 00:00:00+00,Thu 10 Mar 2022,252,495,0,3822470,3749475,239800,4062270,3989275,86.2677899563529,84.7176425442252,233
-7.6926,53.28823,2022/03/11 00:00:00+00,Fri 11 Mar 2022,492,2151,0,3822962,3751626,239800,4062762,3991426,86.2782382408487,84.7633219343682,234
-7.6926,53.28823,2022/03/12 00:00:00+00,Sat 12 Mar 2022,474,2376,2,3823436,3754002,239802,4063238,3993804,86.2883467437348,84.8138219760976,235
-7.6926,53.28823,2022/03/13 00:00:00+00,Sun 13 Mar 2022,363,1077,0,3823799,3755079,239802,4063601,3994881,86.296055539003,84.836693525695,236
-7.6926,53.28823,2022/03/14 00:00:00+00,Mon 14 Mar 2022,99,107,0,3823898,3755186,239802,4063700,3994988,86.2981579377125,84.8389658152093,237
-7.6926,53.28823,2022/03/15 00:00:00+00,Tue 15 Mar 2022,214,740,0,3824112,3755926,239802,4063914,3995728,86.3027025167411,84.8546807146542,238
-7.6926,53.28823,2022/03/16 00:00:00+00,Wed 16 Mar 2022,183,770,1,3824295,3756696,239803,4064098,3996499,86.3066100052518,84.8710539409676,239
-7.6926,53.28823,2022/03/17 00:00:00+00,Thu 17 Mar 2022,1,0,0,3824296,3756696,239803,4064099,3996499,86.3066312416023,84.8710539409676,240
-7.6926,53.28823,2022/03/18 00:00:00+00,Fri 18 Mar 2022,2,6,0,3824298,3756702,239803,4064101,3996505,86.3066737143036,84.8711813590712,241
-7.6926,53.28823,2022/03/19 00:00:00+00,Sat 19 Mar 2022,741,2771,0,3825039,3759473,239803,4064842,3999276,86.322409850099,84.9300272865869,242
-7.6926,53.28823,2022/03/20 00:00:00+00,Sun 20 Mar 2022,387,1390,0,3825426,3760863,239803,4065229,4000666,86.3306283177816,84.9595458139224,243
-7.6926,53.28823,2022/03/21 00:00:00+00,Mon 21 Mar 2022,49,90,0,3825475,3760953,239803,4065278,4000756,86.3316688989611,84.9614570854765,244
-7.6926,53.28823,2021/04/29 23:00:00+00,Fri 30 Apr 2021,36103,13511,8,1181449,474845,237,1181686,475082,25.094698196418,10.0890079162744,245
-7.6926,53.28823,2021/04/30 23:00:00+00,Sat 01 May 2021,16533,6678,17,1197982,481523,254,1198236,481777,25.4461597988663,10.2311852835488,246
-7.6926,53.28823,2021/05/01 23:00:00+00,Sun 02 May 2021,12418,900,13,1210400,482423,267,1210667,482690,25.7101488731886,10.2505740716476,247
-7.6926,53.28823,2021/05/02 23:00:00+00,Mon 03 May 2021,14236,910,17,1224636,483333,284,1224920,483617,26.0128305783062,10.2702601686548,248
-7.6926,53.28823,2021/05/03 23:00:00+00,Tue 04 May 2021,26620,6766,9,1251256,490099,293,1251549,490392,26.578333358463,10.4141364439773,249
-7.6926,53.28823,2021/05/04 23:00:00+00,Wed 05 May 2021,32068,13436,68,1283324,503535,361,1283685,503896,27.2607847213801,10.7009121224947,250
-7.6926,53.28823,2021/05/05 23:00:00+00,Thu 06 May 2021,37248,14367,132,1320572,517902,493,1321065,518395,28.0545995068495,11.0088179698601,251
-7.6926,53.28823,2021/05/06 23:00:00+00,Fri 07 May 2021,40569,15059,93,1361141,532961,586,1361727,533547,28.9181119949916,11.330591154168,252
-7.6926,53.28823,2021/05/07 23:00:00+00,Sat 08 May 2021,25580,7029,10,1386721,539990,596,1387317,540586,29.4615502068739,11.4800738260492,253
-7.6926,53.28823,2021/05/08 23:00:00+00,Sun 09 May 2021,19639,914,2,1406360,540904,598,1406958,541502,29.8786533690302,11.4995263231998,254
-7.6926,53.28823,2021/05/09 23:00:00+00,Mon 10 May 2021,28792,4625,171,1435152,545529,769,1435921,546298,30.49372179149,11.6013758606827,255
-7.6926,53.28823,2021/05/10 23:00:00+00,Tue 11 May 2021,33901,14804,150,1469053,560333,919,1469972,561252,31.2168407658083,11.9189442475717,256
-7.6926,53.28823,2021/05/11 23:00:00+00,Wed 12 May 2021,31256,20923,167,1500309,581256,1086,1501395,582342,31.8841506107468,12.366818881749,257
-7.6926,53.28823,2021/05/12 23:00:00+00,Thu 13 May 2021,35957,25474,150,1536266,606730,1236,1537502,607966,32.6509315219009,12.9109791295517,258
-7.6926,53.28823,2021/05/13 23:00:00+00,Fri 14 May 2021,38171,27959,234,1574437,634689,1470,1575907,636159,33.4665135667364,13.5096955620487,259
-7.6926,53.28823,2021/05/14 23:00:00+00,Sat 15 May 2021,28818,12430,19,1603255,647119,1489,1604744,648608,34.0789062090205,13.7740668906818,260
-7.6926,53.28823,2021/05/15 23:00:00+00,Sun 16 May 2021,23140,1156,9,1626395,648275,1498,1627893,649773,34.5705064890855,13.7988072391321,261
-7.6926,53.28823,2021/05/16 23:00:00+00,Mon 17 May 2021,35355,3930,112,1661750,652205,1610,1663360,653815,35.3236961358549,13.8846445682618,262
-7.6926,53.28823,2021/05/17 23:00:00+00,Tue 18 May 2021,39004,12476,122,1700754,664681,1732,1702486,666413,36.1545895894737,14.1521801131345,263
-7.6926,53.28823,2021/05/18 23:00:00+00,Wed 19 May 2021,36980,17582,203,1737734,682263,1935,1739669,684198,36.9442208138746,14.5298686085752,264
-7.6926,53.28823,2021/05/19 23:00:00+00,Thu 20 May 2021,39046,19657,131,1776780,701920,2066,1778846,703986,37.7761973213742,14.9500935142699,265
-7.6926,53.28823,2021/05/20 23:00:00+00,Fri 21 May 2021,25786,23233,14930,1802566,725153,16996,1819562,742149,38.6408565724488,15.7605363622599,266
-7.6926,53.28823,2021/05/21 23:00:00+00,Sat 22 May 2021,16549,10242,13519,1819115,735395,30515,1849630,765910,39.2793911623228,16.2651332888927,267
-7.6926,53.28823,2021/05/22 23:00:00+00,Sun 23 May 2021,8188,5514,10202,1827303,740909,40717,1868020,781626,39.6699276498771,16.5988837749397,268
-7.6926,53.28823,2021/05/23 23:00:00+00,Mon 24 May 2021,22494,8197,8446,1849797,749106,49163,1898960,798269,40.3269803374753,16.9523203579939,269
-7.6926,53.28823,2021/05/24 23:00:00+00,Tue 25 May 2021,30270,16499,3220,1880067,765605,52383,1932450,817988,41.0381857191064,17.3710799554971,270
-7.6926,53.28823,2021/05/25 23:00:00+00,Wed 26 May 2021,19917,25418,3048,1899984,791023,55431,1955415,846454,41.5258785106608,17.9755939117082,271
-7.6926,53.28823,2021/05/26 23:00:00+00,Thu 27 May 2021,16961,35997,550,1916945,827020,55981,1972926,883001,41.8977482460367,18.7517188171268,272
-7.6926,53.28823,2021/05/27 23:00:00+00,Fri 28 May 2021,26970,31804,1553,1943915,858824,57534,2001449,916358,42.503472674232,19.4600997641279,273
-7.6926,53.28823,2021/05/28 23:00:00+00,Sat 29 May 2021,24417,7373,531,1968332,866197,58065,2026397,924262,43.0332771490284,19.627951879279,274
-7.6926,53.28823,2021/05/29 23:00:00+00,Sun 30 May 2021,24196,1662,207,1992528,867859,58272,2050800,926131,43.5515078127472,19.6676426185525,275
-7.6926,53.28823,2021/05/30 23:00:00+00,Mon 31 May 2021,22515,7310,3436,2015043,875169,61708,2076751,936877,44.1026123471965,19.8958484421119,276
-7.6926,53.28823,2021/05/31 23:00:00+00,Tue 01 Jun 2021,27457,11490,3643,2042500,886659,65351,2107851,952010,44.7630628508909,20.2172181357585,277
-7.6926,53.28823,2021/06/01 23:00:00+00,Wed 02 Jun 2021,18619,20874,3996,2061119,907533,69347,2130466,976880,45.2433229197349,20.745366175208,278
-7.6926,53.28823,2021/06/02 23:00:00+00,Thu 03 Jun 2021,16615,30690,1970,2077734,938223,71317,2149051,1009540,45.6380004956564,21.4389453858401,279
-7.6926,53.28823,2021/06/03 23:00:00+00,Fri 04 Jun 2021,28957,23330,148,2106691,961553,71465,2178156,1033018,46.2560844799016,21.9375324252528,280
-7.6926,53.28823,2021/06/04 23:00:00+00,Sat 05 Jun 2021,20898,11469,32,2127589,973022,71497,2199086,1044519,46.7005612979827,22.1817716935161,281
-7.6926,53.28823,2021/06/05 23:00:00+00,Sun 06 Jun 2021,19891,3884,37,2147480,976906,71534,2219014,1048440,47.1237592927616,22.2650394242231,282
-7.6926,53.28823,2021/06/06 23:00:00+00,Mon 07 Jun 2021,19743,4552,36,2167223,981458,71570,2238793,1053028,47.5437930713008,22.3624718007809,283
-7.6926,53.28823,2021/06/07 23:00:00+00,Tue 08 Jun 2021,26367,18325,39,2193590,999783,71609,2265199,1071392,48.1045601452736,22.7524561432196,284
-7.6926,53.28823,2021/06/08 23:00:00+00,Wed 09 Jun 2021,32717,20076,168,2226307,1019859,71777,2298084,1091636,48.802917534791,23.1823648247884,285
-7.6926,53.28823,2021/06/09 23:00:00+00,Thu 10 Jun 2021,27613,27456,266,2253920,1047315,72043,2325963,1119358,49.3949657531992,23.7710789361523,286
-7.6926,53.28823,2021/06/10 23:00:00+00,Fri 11 Jun 2021,26376,32866,36,2280296,1080181,72079,2352375,1152260,49.9558602452756,24.4697973436298,287
-7.6926,53.28823,2021/06/11 23:00:00+00,Sat 12 Jun 2021,12153,19694,101,2292449,1099875,72180,2364629,1172055,50.2160904855416,24.8901709037787,288
-7.6926,53.28823,2021/06/12 23:00:00+00,Sun 13 Jun 2021,8513,18153,829,2300962,1118028,73009,2373971,1191037,50.4144804728571,25.2932793108889,289
-7.6926,53.28823,2021/06/13 23:00:00+00,Mon 14 Jun 2021,15966,31271,43,2316928,1149299,73052,2389980,1222351,50.7544532096302,25.9582743936119,290
-7.6926,53.28823,2021/06/14 23:00:00+00,Tue 15 Jun 2021,14637,41528,200,2331565,1190827,73252,2404817,1264079,51.0695369434988,26.8444248314949,291
-7.6926,53.28823,2021/06/15 23:00:00+00,Wed 16 Jun 2021,13388,48356,209,2344953,1239183,73461,2418414,1312644,51.358287602622,27.8757681984376,292
-7.6926,53.28823,2021/06/16 23:00:00+00,Thu 17 Jun 2021,21523,42635,532,2366476,1281818,73993,2440469,1355811,51.8266553151294,28.7924777448355,293
-7.6926,53.28823,2021/06/17 23:00:00+00,Fri 18 Jun 2021,11964,50015,545,2378440,1331833,74538,2452978,1406371,52.0923008247986,29.8661876312274,294
-7.6926,53.28823,2021/06/18 23:00:00+00,Sat 19 Jun 2021,6263,32758,430,2384703,1364591,74968,2459671,1439559,52.2344357193718,30.5709796349769,295
-7.6926,53.28823,2021/06/19 23:00:00+00,Sun 20 Jun 2021,8474,26115,172,2393177,1390706,75140,2468317,1465846,52.418045206669,31.1292195832281,296
-7.6926,53.28823,2021/06/20 23:00:00+00,Mon 21 Jun 2021,15412,32287,561,2408589,1422993,75701,2484290,1498694,52.7572534348204,31.8267912277732,297
-7.6926,53.28823,2021/06/21 23:00:00+00,Tue 22 Jun 2021,15081,43498,713,2423670,1466491,76414,2500084,1542905,53.0926603562143,32.7656715241987,298
-7.6926,53.28823,2021/06/22 23:00:00+00,Wed 23 Jun 2021,20026,39342,876,2443696,1505833,77290,2520986,1583123,53.5365425564786,33.619755072674,299
-7.6926,53.28823,2021/01/08 00:00:00+00,Fri 08 Jan 2021,12674,5,0,40063,59,0,40063,59,0.850791914132091,0.00125294468546523,300
-7.6926,53.28823,2021/06/23 23:00:00+00,Thu 24 Jun 2021,18966,44217,1028,2462662,1550050,78318,2540980,1628368,53.9611421503971,34.580593755621,301
-7.6926,53.28823,2021/06/24 23:00:00+00,Fri 25 Jun 2021,15146,50089,826,2477808,1600139,79144,2556952,1679283,54.300329142198,35.6618425464763,302
-7.6926,53.28823,2021/06/25 23:00:00+00,Sat 26 Jun 2021,8998,30509,490,2486806,1630648,79634,2566440,1710282,54.5018196367013,36.32014817876,303
-7.6926,53.28823,2021/06/26 23:00:00+00,Sun 27 Jun 2021,8691,30438,51,2495497,1661086,79685,2575182,1740771,54.6874678136561,36.9676232722371,304
-7.6926,53.28823,2021/06/27 23:00:00+00,Mon 28 Jun 2021,24168,24592,511,2519665,1685678,80196,2599861,1765874,55.2115597101408,37.5007193813766,305
-7.6926,53.28823,2021/06/28 23:00:00+00,Tue 29 Jun 2021,28092,30960,802,2547757,1716638,80998,2628755,1797636,55.8251628244091,38.1752283491689,306
-7.6926,53.28823,2021/06/29 23:00:00+00,Wed 30 Jun 2021,22491,36813,568,2570248,1753451,81566,2651814,1835017,56.31485183292,38.9690643709889,307
-7.6926,53.28823,2021/06/30 23:00:00+00,Thu 01 Jul 2021,14899,48265,628,2585147,1801716,82194,2667341,1883910,56.6445886487034,40.0073732609287,308
-7.6926,53.28823,2021/07/01 23:00:00+00,Fri 02 Jul 2021,13589,47196,811,2598736,1848912,83005,2681741,1931917,56.9503920973593,41.026866744236,309
-7.6926,53.28823,2021/07/02 23:00:00+00,Sat 03 Jul 2021,9257,30423,497,2607993,1879335,83502,2691495,1962837,57.1575314611225,41.6834947048222,310
-7.6926,53.28823,2021/07/03 23:00:00+00,Sun 04 Jul 2021,6399,27744,226,2614392,1907079,83728,2698120,1990807,57.2982222838548,42.2774754311351,311
-7.6926,53.28823,2021/07/04 23:00:00+00,Mon 05 Jul 2021,15509,33374,5328,2629901,1940453,89056,2718957,2029509,57.7407241213301,43.0993646720991,312
-7.6926,53.28823,2021/07/05 23:00:00+00,Tue 06 Jul 2021,12329,48288,5477,2642230,1988741,94533,2736763,2083274,58.1188585801333,44.2411370621675,313
-7.6926,53.28823,2021/07/06 23:00:00+00,Wed 07 Jul 2021,19630,43694,5043,2661860,2032435,99576,2761436,2132011,58.6428230585144,45.2761330814136,314
-7.6926,53.28823,2021/07/07 23:00:00+00,Thu 08 Jul 2021,17692,45526,5984,2679552,2077961,105560,2785112,2183521,59.1456148953462,46.3700175008765,315
-7.6926,53.28823,2021/07/08 23:00:00+00,Fri 09 Jul 2021,13464,45040,6517,2693016,2123001,112077,2805093,2235078,59.5699384167069,47.4649000288177,316
-7.6926,53.28823,2021/07/09 23:00:00+00,Sat 10 Jul 2021,8571,23803,4354,2701587,2146804,116431,2818018,2263235,59.8444182482262,48.0628519526931,317
-7.6926,53.28823,2021/07/10 23:00:00+00,Sun 11 Jul 2021,15190,16075,2148,2716777,2162879,118579,2835356,2281458,60.2126140949481,48.449841969697,318
-7.6926,53.28823,2021/07/11 23:00:00+00,Mon 12 Jul 2021,17051,31674,6078,2733828,2194553,124657,2858485,2319210,60.7037896480011,49.2515566775899,319
-7.6926,53.28823,2021/07/12 23:00:00+00,Tue 13 Jul 2021,20038,36487,8476,2753866,2231040,133133,2886999,2364173,61.309322949041,50.2064067096674,320
-7.6926,53.28823,2021/07/13 23:00:00+00,Wed 14 Jul 2021,20732,35622,9320,2774598,2266662,142453,2917051,2409115,61.9475177573055,51.1608107783823,321
-7.6926,53.28823,2021/07/14 23:00:00+00,Thu 15 Jul 2021,23558,28766,9561,2798156,2295428,152014,2950170,2447442,62.6508444528635,51.9747363878709,322
-7.6926,53.28823,2021/07/15 23:00:00+00,Fri 16 Jul 2021,23485,27343,9155,2821641,2322771,161169,2982810,2483940,63.3439989364836,52.7498207121101,323
-7.6926,53.28823,2021/07/16 23:00:00+00,Sat 17 Jul 2021,11452,19372,4669,2833093,2342143,165838,2998931,2507981,63.686350144524,53.2603638169112,324
-7.6926,53.28823,2021/07/17 23:00:00+00,Sun 18 Jul 2021,16818,15760,1922,2849911,2357903,167760,3017671,2525663,64.0843193547887,53.63586496824,325
-7.6926,53.28823,2021/07/18 23:00:00+00,Mon 19 Jul 2021,24822,18335,6232,2874733,2376238,173992,3048725,2550230,64.7437929863554,54.1575783934573,326
-7.6926,53.28823,2021/07/19 23:00:00+00,Tue 20 Jul 2021,30512,18087,7687,2905245,2394325,181679,3086924,2576004,65.5550003429671,54.7049240938502,327
-7.6926,53.28823,2021/07/20 23:00:00+00,Wed 21 Jul 2021,30283,19753,6875,2935528,2414078,188554,3124082,2602632,66.3441006586029,55.2704056376565,328
-7.6926,53.28823,2021/07/21 23:00:00+00,Thu 22 Jul 2021,33471,15846,6922,2968999,2429924,195476,3164475,2625400,67.2019005684334,55.7539148681424,329
-7.6926,53.28823,2021/07/22 23:00:00+00,Fri 23 Jul 2021,27032,20737,5601,2996031,2450661,201077,3197108,2651738,67.8949063975993,56.3132378702744,330
-7.6926,53.28823,2021/07/23 23:00:00+00,Sat 24 Jul 2021,15395,14735,2260,3011426,2465396,203337,3214763,2668733,68.2698341674618,56.6741496487401,331
-7.6926,53.28823,2021/07/24 23:00:00+00,Sun 25 Jul 2021,14678,13592,1031,3026104,2478988,204368,3230472,2683356,68.6034359990546,56.9846888035801,332
-7.6926,53.28823,2021/07/25 23:00:00+00,Mon 26 Jul 2021,23775,18189,3404,3049879,2497177,207772,3257651,2704949,69.180618772042,57.4432453221098,333
-7.6926,53.28823,2021/07/26 23:00:00+00,Tue 27 Jul 2021,25429,23786,3656,3075308,2520963,211428,3286736,2732391,69.7982780292752,58.0260132553053,334
-7.6926,53.28823,2021/07/27 23:00:00+00,Wed 28 Jul 2021,23380,25189,3249,3098688,2546152,214677,3313365,2760829,70.363780809432,58.6299325936996,335
-7.6926,53.28823,2021/07/28 23:00:00+00,Thu 29 Jul 2021,19204,27780,2950,3117892,2573932,217627,3335519,2791559,70.8342509206489,59.2825256476715,336
-7.6926,53.28823,2021/07/29 23:00:00+00,Fri 30 Jul 2021,21885,22845,2109,3139777,2596777,219736,3359513,2816513,71.3437959169718,59.8124575405715,337
-7.6926,53.28823,2021/07/30 23:00:00+00,Sat 31 Jul 2021,13696,12400,900,3153473,2609177,220636,3374109,2829813,71.6537616903455,60.0949010035662,338
-7.6926,53.28823,2021/07/31 23:00:00+00,Sun 01 Aug 2021,11056,9258,364,3164529,2618435,221000,3385529,2839435,71.8962808142102,60.2992371690501,339
-7.6926,53.28823,2021/08/01 23:00:00+00,Mon 02 Aug 2021,14961,15917,420,3179490,2634352,221420,3400910,2855772,72.2229171228058,60.6461754288203,340
-7.6926,53.28823,2021/08/02 23:00:00+00,Tue 03 Aug 2021,17287,25355,1103,3196777,2659707,222523,3419300,2882230,72.6134536103601,61.2080467930244,341
-7.6926,53.28823,2021/08/03 23:00:00+00,Wed 04 Aug 2021,22054,17199,1570,3218831,2676906,224093,3442924,2900999,73.1151411569606,61.6066318574565,342
-7.6926,53.28823,2021/08/04 23:00:00+00,Thu 05 Aug 2021,13474,29948,1417,3232305,2706854,225510,3457815,2932364,73.4313716537617,62.2727099940602,343
-7.6926,53.28823,2021/08/05 23:00:00+00,Fri 06 Aug 2021,12140,24665,941,3244445,2731519,226451,3470896,2957970,73.7091643559747,62.8164879875521,344
-7.6926,53.28823,2021/08/06 23:00:00+00,Sat 07 Aug 2021,6308,8386,578,3250753,2739905,227029,3477782,2966934,73.855397866214,63.0068506343404,345
-7.6926,53.28823,2021/08/07 23:00:00+00,Sun 08 Aug 2021,8591,11915,153,3259344,2751820,227182,3486526,2979002,74.04108851587,63.2631309133945,346
-7.6926,53.28823,2021/08/08 23:00:00+00,Mon 09 Aug 2021,5503,22936,597,3264847,2774756,227779,3492626,3002535,74.1706302545368,63.7628859520904,347
-7.6926,53.28823,2021/08/09 23:00:00+00,Tue 10 Aug 2021,9292,25911,707,3274139,2800667,228486,3502625,3029153,74.3829725241972,64.3281551323906,348
-7.6926,53.28823,2021/01/09 00:00:00+00,Sat 09 Jan 2021,8073,6,0,48136,65,0,48136,65,1.02223297253482,0.00138036278907186,349
-7.6926,53.28823,2021/01/10 00:00:00+00,Sun 10 Jan 2021,4776,3,1,52912,68,1,52913,69,1.1236790193563,0.00146530819147628,350
-7.6926,53.28823,2021/01/11 00:00:00+00,Mon 11 Jan 2021,8337,7,0,61249,75,1,61250,76,1.30072647431771,0.00161396264568402,351
-7.6926,53.28823,2021/01/12 00:00:00+00,Tue 12 Jan 2021,8876,9,0,70125,84,1,70126,85,1.48922032225313,0.00180508980109397,352
-7.6926,53.28823,2021/01/13 00:00:00+00,Wed 13 Jan 2021,9874,5,0,79999,89,1,80000,90,1.69890804808844,0.0019112715540995,353
-7.6926,53.28823,2021/01/14 00:00:00+00,Thu 14 Jan 2021,8071,4,0,88070,93,1,88071,94,1.87030663378996,0.00199621695650392,354
-7.6926,53.28823,2021/01/15 00:00:00+00,Fri 15 Jan 2021,7680,2,0,95750,95,1,95751,96,2.03340180640645,0.00203868965770613,355
-7.6926,53.28823,2021/01/16 00:00:00+00,Sat 16 Jan 2021,5221,3,0,100971,98,1,100972,99,2.14427679289483,0.00210239870950945,356
-7.6926,53.28823,2021/01/17 00:00:00+00,Sun 17 Jan 2021,1108,4,0,102079,102,1,102080,103,2.16780666936085,0.00218734411191387,357
-7.6926,53.28823,2021/01/18 00:00:00+00,Mon 18 Jan 2021,8703,7,0,110782,109,1,110783,110,2.35262662864227,0.00233599856612161,358
-7.6926,53.28823,2021/01/19 00:00:00+00,Tue 19 Jan 2021,8370,18,0,119152,127,1,119153,128,2.53037488317353,0.00271825287694151,359
-7.6926,53.28823,2021/01/20 00:00:00+00,Wed 20 Jan 2021,8441,961,0,127593,1088,1,127594,1089,2.70963091859746,0.0231263858046039,360
-7.6926,53.28823,2021/01/21 00:00:00+00,Thu 21 Jan 2021,8985,962,0,136578,2050,1,136579,2051,2.90043952874839,0.0435557550828674,361
-7.6926,53.28823,2021/01/22 00:00:00+00,Fri 22 Jan 2021,6767,967,0,143345,3017,1,143346,3018,3.04414591326607,0.0640913061141365,362
-7.6926,53.28823,2021/01/23 00:00:00+00,Sat 23 Jan 2021,4177,459,0,147522,3476,1,147523,3477,3.13285014972689,0.0738387910400439,363
-7.6926,53.28823,2021/01/24 00:00:00+00,Sun 24 Jan 2021,1181,397,0,148703,3873,1,148704,3874,3.1579302797868,0.0822696222286828,364
-7.6926,53.28823,2021/01/25 00:00:00+00,Mon 25 Jan 2021,1347,1286,0,150050,5159,1,150051,5160,3.18653564404649,0.109579569101704,365
-7.6926,53.28823,2021/01/26 00:00:00+00,Tue 26 Jan 2021,998,3496,0,151048,8655,1,151049,8656,3.20772952194639,0.183821850803169,366
-7.6926,53.28823,2021/01/27 00:00:00+00,Wed 27 Jan 2021,2161,6698,0,153209,15353,1,153210,15354,3.25362127559538,0.326062927129374,367
-7.6926,53.28823,2021/01/28 00:00:00+00,Thu 28 Jan 2021,984,11537,0,154193,26890,1,154194,26891,3.27451784458686,0.571066704014329,368
-7.6926,53.28823,2021/01/29 00:00:00+00,Fri 29 Jan 2021,1565,11525,0,155758,38415,1,155759,38416,3.30775273327759,0.81581564469207,369
-7.6926,53.28823,2021/01/30 00:00:00+00,Sat 30 Jan 2021,622,7793,0,156380,46208,1,156381,46209,3.32096174335148,0.981310524926485,370
-7.6926,53.28823,2021/01/31 00:00:00+00,Sun 31 Jan 2021,216,4086,0,156596,50294,1,156597,50295,3.32554879508132,1.0680822534826,371
-7.6926,53.28823,2021/02/01 00:00:00+00,Mon 01 Feb 2021,1008,8336,0,157604,58630,1,157605,58631,3.34695503648724,1.24510847209342,372
-7.6926,53.28823,2021/02/02 00:00:00+00,Tue 02 Feb 2021,823,5107,0,158427,63737,1,158428,63738,3.36443255303195,1.35356251461326,373
-7.6926,53.28823,2021/02/03 00:00:00+00,Wed 03 Feb 2021,1390,6861,0,159817,70598,1,159818,70599,3.39395108036748,1.49926511608745,374
-7.6926,53.28823,2021/02/04 00:00:00+00,Thu 04 Feb 2021,1413,10541,1,161230,81139,2,161232,81141,3.42397928011745,1.7231387241243,375
-7.6926,53.28823,2021/02/05 00:00:00+00,Fri 05 Feb 2021,3377,8611,0,164607,89750,2,164609,89752,3.49569443609738,1.90600493915042,376
-7.6926,53.28823,2021/02/06 00:00:00+00,Sat 06 Feb 2021,890,3866,0,165497,93616,2,165499,93618,3.51459478813236,1.9881046705743,377
-7.6926,53.28823,2021/02/07 00:00:00+00,Sun 07 Feb 2021,320,1298,1,165817,94914,3,165820,94917,3.52141165667532,2.01569069000513,378
-7.6926,53.28823,2021/02/08 00:00:00+00,Mon 08 Feb 2021,1158,878,0,166975,95792,3,166978,95795,3.5460033506714,2.0343362058329,379
-7.6926,53.28823,2021/02/09 00:00:00+00,Tue 09 Feb 2021,4242,537,2,171217,96329,5,171222,96334,3.63613042262249,2.0457825988069,380
-7.6926,53.28823,2021/02/10 00:00:00+00,Wed 10 Feb 2021,8813,579,0,180030,96908,5,180035,96913,3.82328638047003,2.05807844580494,381
-7.6926,53.28823,2021/02/11 00:00:00+00,Thu 11 Feb 2021,6173,442,0,186203,97350,5,186208,97355,3.95437837273066,2.06746491277063,382
-7.6926,53.28823,2021/02/12 00:00:00+00,Fri 12 Feb 2021,4384,522,0,190587,97872,5,190592,97877,4.0474785337659,2.07855028778441,383
-7.6926,53.28823,2021/02/13 00:00:00+00,Sat 13 Feb 2021,1203,1913,0,191790,99785,5,191795,99790,4.07302586353903,2.11917542648432,384
-7.6926,53.28823,2021/02/14 00:00:00+00,Sun 14 Feb 2021,2691,25,0,194481,99810,5,194486,99815,4.13017288300661,2.11970633524935,385
-7.6926,53.28823,2021/02/15 00:00:00+00,Mon 15 Feb 2021,1955,7883,0,196436,107693,5,196441,107698,4.17168994843177,2.28711248703786,386
-7.6926,53.28823,2021/02/16 00:00:00+00,Tue 16 Feb 2021,5633,8158,0,202069,115851,5,202074,115856,4.2913143113678,2.46035863524168,387
-7.6926,53.28823,2021/02/17 00:00:00+00,Wed 17 Feb 2021,9729,8462,0,211798,124313,5,211803,124318,4.49792276636595,2.64006063402824,388
-7.6926,53.28823,2021/02/18 00:00:00+00,Thu 18 Feb 2021,8452,8348,0,220250,132661,5,220255,132666,4.6774124016465,2.81734168884627,389
-7.6926,53.28823,2021/02/19 00:00:00+00,Fri 19 Feb 2021,9384,6581,0,229634,139242,5,229639,139247,4.87669431568727,2.95709811215214,390
-7.6926,53.28823,2021/02/20 00:00:00+00,Sat 20 Feb 2021,5883,3567,2,235517,142809,7,235524,142816,5.00167023897478,3.03289064744749,391
-7.6926,53.28823,2021/02/21 00:00:00+00,Sun 21 Feb 2021,1105,1021,4,236622,143830,11,236633,143841,5.0252213517914,3.05465790681362,392
-7.6926,53.28823,2021/02/22 00:00:00+00,Mon 22 Feb 2021,3936,1118,1,240558,144948,12,240570,144960,5.10882886410795,3.07842138313626,393
-7.6926,53.28823,2021/02/23 00:00:00+00,Tue 23 Feb 2021,13352,1061,0,253910,146009,12,253922,146021,5.39237661733392,3.10095315112403,394
-7.6926,53.28823,2021/02/24 00:00:00+00,Wed 24 Feb 2021,16926,2101,3,270836,148110,15,270851,148125,5.75188679666003,3.14563443278876,395
-7.6926,53.28823,2021/02/25 00:00:00+00,Thu 25 Feb 2021,18077,1748,2,288913,149858,17,288930,149875,6.13581877917742,3.18279804634069,396
-7.6926,53.28823,2021/02/26 00:00:00+00,Fri 26 Feb 2021,16083,2764,0,304996,152622,17,305013,152639,6.477363005895,3.24149531940215,397
-7.6926,53.28823,2021/02/27 00:00:00+00,Sat 27 Feb 2021,8985,702,1,313981,153324,18,313999,153342,6.66819285239653,3.25642447387472,398
-7.6926,53.28823,2021/02/28 00:00:00+00,Sun 28 Feb 2021,2440,51,1,316421,153375,19,316440,153394,6.72003078421383,3.25752876410598,399
-7.6926,53.28823,2021/03/01 00:00:00+00,Mon 01 Mar 2021,5580,784,0,322001,154159,19,322020,154178,6.838529620568,3.27417806297725,400
-7.6926,53.28823,2021/03/02 00:00:00+00,Tue 02 Mar 2021,12169,1604,0,334170,155763,19,334189,155782,7.09695477103285,3.30824116934142,401
-7.6926,53.28823,2021/03/03 00:00:00+00,Wed 03 Mar 2021,12883,1501,1,347053,157264,20,347073,157284,7.3705639121775,3.34013816794428,402
-7.6926,53.28823,2021/03/04 00:00:00+00,Thu 04 Mar 2021,18722,1686,3,365775,158950,23,365798,158973,7.7682145771832,3.37600636410955,403
-7.6926,53.28823,2021/03/05 00:00:00+00,Fri 05 Mar 2021,18431,2391,6,384206,161341,29,384235,161370,8.15974917321578,3.4269098965004,404
-7.6926,53.28823,2021/03/06 00:00:00+00,Sat 06 Mar 2021,10445,135,4,394651,161476,33,394684,161509,8.38164780064673,3.42986174923395,405
-7.6926,53.28823,2021/03/07 00:00:00+00,Sun 07 Mar 2021,1513,10,2,396164,161486,35,396199,161521,8.41382087180741,3.43011658544116,406
-7.6926,53.28823,2021/03/08 00:00:00+00,Mon 08 Mar 2021,6655,1493,4,402819,162979,39,402858,163018,8.55523373046017,3.46190740229102,407
-7.6926,53.28823,2021/03/09 00:00:00+00,Tue 09 Mar 2021,13810,3100,3,416629,166079,42,416671,166121,8.84857144131324,3.52780379820625,408
-7.6926,53.28823,2021/03/10 00:00:00+00,Wed 10 Mar 2021,13716,3979,3,430345,170058,45,430390,170103,9.13991293520981,3.61236694629985,409
-7.6926,53.28823,2021/03/11 00:00:00+00,Thu 11 Mar 2021,18460,2096,3,448805,172154,48,448853,172202,9.53199967635802,3.65694204621157,410
-7.6926,53.28823,2021/03/12 00:00:00+00,Fri 12 Mar 2021,17312,1332,3,466117,173486,51,466168,173537,9.89970708701616,3.68529257426405,411
-7.6926,53.28823,2021/03/13 00:00:00+00,Sat 13 Mar 2021,8289,172,0,474406,173658,51,474457,173709,10.0757351971487,3.68894522656744,412
-7.6926,53.28823,2021/03/14 00:00:00+00,Sun 14 Mar 2021,374,17,1,474780,173675,52,474832,173727,10.0836988286241,3.68932748087826,413
-7.6926,53.28823,2021/03/15 00:00:00+00,Mon 15 Mar 2021,2639,987,0,477419,174662,52,477471,174714,10.1397415578605,3.71028775892155,414
-7.6926,53.28823,2021/03/16 00:00:00+00,Tue 16 Mar 2021,8925,3813,2,486344,178475,54,486398,178529,10.3293184596765,3.79130443646477,415
-7.6926,53.28823,2021/03/17 00:00:00+00,Wed 17 Mar 2021,4878,2415,6,491222,180890,60,491282,180950,10.4330367960123,3.84271764127004,416
-7.6926,53.28823,2021/03/18 00:00:00+00,Thu 18 Mar 2021,11705,4677,3,502927,185567,63,502990,185630,10.6816719888501,3.94210376208322,417
-7.6926,53.28823,2021/03/19 00:00:00+00,Fri 19 Mar 2021,10347,6120,2,513274,191687,65,513339,191752,10.9014469812209,4.07211270046319,418
-7.6926,53.28823,2021/03/20 00:00:00+00,Sat 20 Mar 2021,5224,3116,2,518498,194803,67,518565,194870,11.0124281494623,4.13832764163743,419
-7.6926,53.28823,2021/03/21 00:00:00+00,Sun 21 Mar 2021,3626,53,3,522124,194856,70,522194,194926,11.0894948657937,4.13951687727109,420
-7.6926,53.28823,2021/03/22 00:00:00+00,Mon 22 Mar 2021,7389,2397,1,529513,197253,71,529584,197324,11.2464314967359,4.19044164601255,421
-7.6926,53.28823,2021/03/23 00:00:00+00,Tue 23 Mar 2021,12557,7382,3,542070,204635,74,542144,204709,11.5131600602858,4.34727209520171,422
-7.6926,53.28823,2021/03/24 00:00:00+00,Wed 24 Mar 2021,13603,9779,1,555673,214414,75,555748,214489,11.8020593738632,4.55496360408052,423
-7.6926,53.28823,2021/03/25 00:00:00+00,Thu 25 Mar 2021,20847,10218,3,576520,224632,78,576598,224710,12.2448372838962,4.77202034357442,424
-7.6926,53.28823,2021/03/26 00:00:00+00,Fri 26 Mar 2021,19688,9493,1,596208,234125,79,596287,234204,12.6629597908814,4.97363825618132,425
-7.6926,53.28823,2021/03/27 00:00:00+00,Sat 27 Mar 2021,11723,5339,2,607931,239464,81,608012,239545,12.9119560016794,5.08706160474182,426
-7.6926,53.28823,2021/03/28 00:00:00+00,Sun 28 Mar 2021,2478,480,0,610409,239944,81,610490,240025,12.9645796784689,5.09725505303035,427
-7.6926,53.28823,2021/03/28 23:00:00+00,Mon 29 Mar 2021,9243,3111,3,619652,243055,84,619736,243139,13.1609309761267,5.1633850488022,428
-7.6926,53.28823,2021/03/29 23:00:00+00,Tue 30 Mar 2021,13312,8658,4,632964,251713,88,633052,251801,13.4437142207311,5.34733431770897,429
-7.6926,53.28823,2021/03/30 23:00:00+00,Wed 31 Mar 2021,15804,10502,3,648768,262215,91,648859,262306,13.7793972146827,5.57042218077359,430
-7.6926,53.28823,2021/03/31 23:00:00+00,Thu 01 Apr 2021,19666,11620,7,668434,273835,98,668532,273933,14.1971799400583,5.81733722921264,431
-7.6926,53.28823,2021/04/01 23:00:00+00,Fri 02 Apr 2021,20113,13717,7,688547,287552,105,688652,287657,14.6244553141525,6.10878490486221,432
-7.6926,53.28823,2021/04/02 23:00:00+00,Sat 03 Apr 2021,7531,4647,5,696078,292199,110,696188,292309,14.7844924522825,6.20757640785855,433
-7.6926,53.28823,2021/04/03 23:00:00+00,Sun 04 Apr 2021,3016,167,3,699094,292366,113,699207,292479,14.8486049947472,6.21118658746074,434
-7.6926,53.28823,2021/04/04 23:00:00+00,Mon 05 Apr 2021,3414,600,4,702508,292966,117,702625,293083,14.9211908411018,6.22401334322381,435
-7.6926,53.28823,2021/04/05 23:00:00+00,Tue 06 Apr 2021,11963,8157,10,714471,301123,127,714598,301250,15.1754536668488,6.39745061858304,436
-7.6926,53.28823,2021/04/06 23:00:00+00,Wed 07 Apr 2021,18328,10456,7,732799,311579,134,732933,311713,15.5648221551201,6.61964655492241,437
-7.6926,53.28823,2021/04/07 23:00:00+00,Thu 08 Apr 2021,20160,10564,14,752959,322143,148,753107,322291,15.9932442921468,6.8442846715809,438
-7.6926,53.28823,2021/04/08 23:00:00+00,Fri 09 Apr 2021,20675,9153,16,773634,331296,164,773798,331460,16.4326456224343,7.03900077024244,439
-7.6926,53.28823,2021/04/09 23:00:00+00,Sat 10 Apr 2021,11144,4155,12,784778,335451,176,784954,335627,16.6695583497402,7.12749264319724,440
-7.6926,53.28823,2021/04/10 23:00:00+00,Sun 11 Apr 2021,2846,352,6,787624,335803,182,787806,335985,16.7301244216545,7.13509525671244,441
-7.6926,53.28823,2021/04/11 23:00:00+00,Mon 12 Apr 2021,7751,2777,10,795375,338580,192,795567,338772,16.8949397386697,7.19428096583772,442
-7.6926,53.28823,2021/04/12 23:00:00+00,Tue 13 Apr 2021,11481,8586,1,806856,347166,193,807049,347359,17.1387755162716,7.37663750844941,443
-7.6926,53.28823,2021/04/13 23:00:00+00,Wed 14 Apr 2021,20328,6586,2,827184,353752,195,827379,353947,17.5705105239921,7.5165425862095,444
-7.6926,53.28823,2021/04/14 23:00:00+00,Thu 15 Apr 2021,27108,10783,1,854292,364535,196,854488,364731,18.1462067524375,7.74555539109182,445
-7.6926,53.28823,2021/04/15 23:00:00+00,Fri 16 Apr 2021,27962,9825,1,882254,374360,197,882451,374557,18.7400388242962,7.95422377209828,446
-7.6926,53.28823,2021/04/16 23:00:00+00,Sat 17 Apr 2021,15838,4542,2,898092,378902,199,898291,379101,19.0764226178177,8.0507217492297,447
-7.6926,53.28823,2021/04/17 23:00:00+00,Sun 18 Apr 2021,1059,473,0,899151,379375,199,899350,379574,19.0989119131043,8.06076654306403,448
-7.6926,53.28823,2021/04/18 23:00:00+00,Mon 19 Apr 2021,6726,2242,0,905877,381617,199,906076,381816,19.2417476072473,8.10837844111171,449
