X,Y,VaccinationDate,VaccineText,Dose1,Dose2,SingleDose,Dose1Cum,Dose2Cum,SingleDoseCum,PartiallyVacc,FullyVacc,PartialPercent,FullyPercent,ObjectId
-7.6926,53.28823,2021/07/23 23:00:00+00,Sat 24 Jul 2021,15443,14813,2275,3018933,2469545,204065,3222998,2673610,67.1665153352524,55.7173994726289,1
-7.6926,53.28823,2020/12/28 00:00:00+00,Mon 28 Dec 2020,233,15,1,233,15,1,234,16,0.00487650460485829,0.000333436212298003,2
-7.6926,53.28823,2021/07/24 23:00:00+00,Sun 25 Jul 2021,14727,13648,1046,3033660,2483193,205111,3238771,2688304,67.4952209212884,56.0236189540981,3
-7.6926,53.28823,2020/12/29 00:00:00+00,Tue 29 Dec 2020,78,3,0,311,18,1,312,19,0.00650200613981105,0.000395955502103878,4
-7.6926,53.28823,2021/07/25 23:00:00+00,Mon 26 Jul 2021,23841,18308,3422,3057501,2501501,208533,3266034,2710034,68.063375387281,56.4764670099254,5
-7.6926,53.28823,2020/12/30 00:00:00+00,Wed 30 Dec 2020,1060,1,0,1371,19,1,1372,20,0.0285921552045537,0.000416795265372503,6
-7.6926,53.28823,2021/07/26 23:00:00+00,Tue 27 Jul 2021,25513,23914,3674,3083014,2525415,212207,3295221,2737622,68.6716255578023,57.0513943989802,7
-7.6926,53.28823,2020/12/31 00:00:00+00,Thu 31 Dec 2020,1035,1,0,2406,20,1,2407,21,0.0501613101875808,0.000437635028641129,8
-7.6926,53.28823,2021/07/27 23:00:00+00,Wed 28 Jul 2021,23443,25292,3264,3106457,2550707,215471,3321928,2766178,69.2281931154175,57.646494678879,9
-7.6926,53.28823,2021/01/01 00:00:00+00,Fri 01 Jan 2021,816,0,0,3222,20,1,3223,21,0.0671665570147789,0.000437635028641129,10
-7.6926,53.28823,2021/04/10 23:00:00+00,Sun 11 Apr 2021,2864,366,8,789410,336200,228,789638,336428,16.4558689879106,7.01107987693703,11
-7.6926,53.28823,2021/07/28 23:00:00+00,Thu 29 Jul 2021,19278,27869,2963,3125735,2578576,218434,3344169,2797010,69.691690290275,58.2890262599773,12
-7.6926,53.28823,2021/04/11 23:00:00+00,Mon 12 Apr 2021,7780,2798,13,797190,338998,241,797431,339239,16.618273263063,7.06966045148514,13
-7.6926,53.28823,2021/01/02 00:00:00+00,Sat 02 Jan 2021,1017,0,0,4239,20,1,4240,21,0.0883605962589707,0.000437635028641129,14
-7.6926,53.28823,2021/07/29 23:00:00+00,Fri 30 Jul 2021,21957,22946,2120,3147692,2601522,220554,3368246,2822076,70.1934492704937,58.8113957660686,15
-7.6926,53.28823,2021/04/12 23:00:00+00,Tue 13 Apr 2021,11521,8589,1,808711,347587,242,808953,347829,16.8583890154441,7.24867401796263,16
-7.6926,53.28823,2021/01/03 00:00:00+00,Sun 03 Jan 2021,20,2,1,4259,22,2,4261,24,0.0887982312876119,0.000500154318447004,17
-7.6926,53.28823,2021/07/30 23:00:00+00,Sat 31 Jul 2021,13749,12490,907,3161441,2614012,221461,3382902,2835473,70.4988768409586,59.0905860745784,18
-7.6926,53.28823,2021/04/13 23:00:00+00,Wed 14 Apr 2021,20344,6589,2,829055,354176,244,829299,354420,17.2823948389076,7.38602889766613,19
-7.6926,53.28823,2021/01/04 00:00:00+00,Mon 04 Jan 2021,1192,3,0,5451,25,2,5453,27,0.113639229103813,0.00056267360825288,20
-7.6926,53.28823,2021/07/31 23:00:00+00,Sun 01 Aug 2021,11131,9339,369,3172572,2623351,221830,3394402,2845181,70.7385341185478,59.2928984963902,21
-7.6926,53.28823,2021/04/14 23:00:00+00,Thu 15 Apr 2021,27104,10815,1,856159,364991,245,856404,365236,17.8472566223037,7.61143177717958,22
-7.6926,53.28823,2021/01/05 00:00:00+00,Tue 05 Jan 2021,3535,13,0,8986,38,2,8988,40,0.187307792258403,0.000833590530745007,23
-7.6926,53.28823,2021/08/01 23:00:00+00,Mon 02 Aug 2021,15025,16032,430,3187597,2639383,222260,3409857,2861643,71.0606126598644,59.6359626793183,24
-7.6926,53.28823,2021/04/15 23:00:00+00,Fri 16 Apr 2021,27962,9837,1,884121,374828,246,884367,375074,18.4299989225842,7.81645336821632,25
-7.6926,53.28823,2021/01/06 00:00:00+00,Wed 06 Jan 2021,6778,13,0,15764,51,2,15766,53,0.328559707693145,0.00110450745323713,26
-7.6926,53.28823,2021/08/02 23:00:00+00,Tue 03 Aug 2021,17348,25455,1111,3204945,2664838,223371,3428316,2888209,71.44529385004,60.1895918303127,27
-7.6926,53.28823,2021/04/16 23:00:00+00,Sat 17 Apr 2021,15851,4558,3,899972,379386,249,900221,379635,18.760392529445,7.91150352848452,28
-7.6926,53.28823,2021/11/05 00:00:00+00,Fri 05 Nov 2021,1627,1097,4,3627667,3561932,240773,3868440,3802705,80.6173738188804,79.2474719804173,29
-7.6926,53.28823,2021/01/07 00:00:00+00,Thu 07 Jan 2021,11729,9,0,27493,60,2,27495,62,0.572989291070849,0.00129206532265476,30
-7.6926,53.28823,2021/08/03 23:00:00+00,Wed 04 Aug 2021,22119,17311,1576,3227064,2682149,224947,3452011,2907096,71.9390920406901,60.5831924391672,31
-7.6926,53.28823,2021/04/17 23:00:00+00,Sun 18 Apr 2021,1073,484,0,901045,379870,249,901294,380119,18.7827535954323,7.92158997390653,32
-7.6926,53.28823,2021/11/06 00:00:00+00,Sat 06 Nov 2021,1817,1356,6,3629484,3563288,240779,3870263,3804067,80.6553647073191,79.2758557379891,33
-7.6926,53.28823,2021/01/08 00:00:00+00,Fri 08 Jan 2021,12682,5,0,40175,65,2,40177,67,0.837279168843553,0.00139626413899789,34
-7.6926,53.28823,2021/08/04 23:00:00+00,Thu 05 Aug 2021,13536,30053,1421,3240600,2712202,226368,3466968,2938570,72.2507923798989,61.2391031482839,35
-7.6926,53.28823,2021/04/18 23:00:00+00,Mon 19 Apr 2021,6748,2260,0,907793,382130,249,908042,382379,18.9233803179689,7.96868783889362,36
-7.6926,53.28823,2021/11/07 00:00:00+00,Sun 07 Nov 2021,696,774,0,3630180,3564062,240779,3870959,3804841,80.669869182554,79.2919857147591,37
-7.6926,53.28823,2021/08/05 23:00:00+00,Fri 06 Aug 2021,12213,24756,948,3252813,2736958,227316,3480129,2964274,72.5250645042773,61.7747684233406,38
-7.6926,53.28823,2021/01/09 00:00:00+00,Sat 09 Jan 2021,8073,7,0,48248,72,2,48250,74,1.00551857771116,0.00154214248187826,39
-7.6926,53.28823,2021/04/19 23:00:00+00,Tue 20 Apr 2021,15089,7323,1,922882,389453,250,923132,389703,19.2378523456925,8.12131826507304,40
-7.6926,53.28823,2021/11/08 00:00:00+00,Mon 08 Nov 2021,515,532,3,3630695,3564594,240782,3871477,3805376,80.6806641799272,79.3031349881078,41
-7.6926,53.28823,2021/08/06 23:00:00+00,Sat 07 Aug 2021,6337,8465,583,3259150,2745423,227899,3487049,2973322,72.6692756660961,61.9633266013951,42
-7.6926,53.28823,2021/04/20 23:00:00+00,Wed 21 Apr 2021,26729,9890,4,949611,399343,254,949865,399597,19.7949617371527,8.32750688285281,43
-7.6926,53.28823,2021/01/10 00:00:00+00,Sun 10 Jan 2021,4782,4,1,53030,76,3,53033,79,1.105195165425,0.00164634129822139,44
-7.6926,53.28823,2021/11/09 00:00:00+00,Tue 09 Nov 2021,1367,1064,3,3632062,3565658,240785,3872847,3806443,80.7092146556052,79.3253710155154,45
-7.6926,53.28823,2021/08/07 23:00:00+00,Sun 08 Aug 2021,8628,11980,153,3267778,2757403,228052,3495830,2985455,72.8522696273579,62.2161754491334,46
-7.6926,53.28823,2021/04/21 23:00:00+00,Thu 22 Apr 2021,31622,12185,1,981233,411528,255,981488,411783,20.4539775709964,8.58146023804428,47
-7.6926,53.28823,2021/01/11 00:00:00+00,Mon 11 Jan 2021,8342,7,0,61372,83,3,61375,86,1.27904047061187,0.00179221964110177,48
-7.6926,53.28823,2021/11/10 00:00:00+00,Wed 10 Nov 2021,1596,1361,2,3633658,3567019,240787,3874445,3807806,80.7425165973085,79.3537756128506,49
-7.6926,53.28823,2021/08/08 23:00:00+00,Mon 09 Aug 2021,5551,23041,600,3273329,2780444,228652,3501981,3009096,72.9804550112233,62.7088482925669,50
-7.6926,53.28823,2021/04/22 23:00:00+00,Fri 23 Apr 2021,33614,12356,3,1014847,423884,258,1015105,424142,21.1545478927978,8.83901887228122,51
-7.6926,53.28823,2021/01/12 00:00:00+00,Tue 12 Jan 2021,8887,11,0,70259,94,3,70262,97,1.46424344678014,0.00202145703705664,52
-7.6926,53.28823,2021/01/13 00:00:00+00,Wed 13 Jan 2021,9890,4,0,80149,98,3,80152,101,1.67034870550684,0.00210481609013114,53
-7.6926,53.28823,2021/01/14 00:00:00+00,Thu 14 Jan 2021,8086,5,0,88235,103,3,88238,106,1.83885903129695,0.00220901490647427,54
-7.6926,53.28823,2021/01/15 00:00:00+00,Fri 15 Jan 2021,7696,2,0,95931,105,3,95934,108,1.99924184941229,0.00225069443301152,55
-7.6926,53.28823,2021/01/16 00:00:00+00,Sat 16 Jan 2021,5241,2,0,101172,107,3,101175,110,2.10846304870315,0.00229237395954877,56
-7.6926,53.28823,2021/01/17 00:00:00+00,Sun 17 Jan 2021,1114,4,0,102286,111,3,102289,114,2.1316785449844,0.00237573301262327,57
-7.6926,53.28823,2021/01/18 00:00:00+00,Mon 18 Jan 2021,8717,8,1,111003,119,4,111007,123,2.31335960116027,0.0025632908820409,58
-7.6926,53.28823,2021/01/19 00:00:00+00,Tue 19 Jan 2021,8385,20,0,119388,139,4,119392,143,2.4881010161677,0.0029800861474134,59
-7.6926,53.28823,2021/01/20 00:00:00+00,Wed 20 Jan 2021,8449,962,0,127837,1101,4,127841,1105,2.66417617602431,0.0230279384118308,60
-7.6926,53.28823,2021/01/21 00:00:00+00,Thu 21 Jan 2021,9005,964,0,136842,2065,4,136846,2069,2.85183824425828,0.0431174702027855,61
-7.6926,53.28823,2021/01/22 00:00:00+00,Fri 22 Jan 2021,6786,967,0,143628,3032,4,143632,3036,2.99325687779917,0.063269521283546,62
-7.6926,53.28823,2021/01/23 00:00:00+00,Sat 23 Jan 2021,4192,460,0,147820,3492,4,147824,3496,3.08061716542125,0.0728558123871136,63
-7.6926,53.28823,2021/01/24 00:00:00+00,Sun 24 Jan 2021,1185,398,0,149005,3890,4,149009,3894,3.10531228489457,0.0811500381680264,64
-7.6926,53.28823,2021/01/25 00:00:00+00,Mon 25 Jan 2021,1365,1290,0,150370,5180,4,150374,5184,3.13375856175624,0.108033332784553,65
-7.6926,53.28823,2021/01/26 00:00:00+00,Tue 26 Jan 2021,1003,3502,0,151373,8682,4,151377,8686,3.15466084431467,0.181014183751278,66
-7.6926,53.28823,2021/01/27 00:00:00+00,Wed 27 Jan 2021,2181,6700,0,153554,15382,4,153558,15386,3.20011236800354,0.320640597651067,67
-7.6926,53.28823,2021/01/28 00:00:00+00,Thu 28 Jan 2021,1015,11542,0,154569,26924,4,154573,26928,3.2212647277212,0.561173145297539,68
-7.6926,53.28823,2021/01/29 00:00:00+00,Fri 29 Jan 2021,1580,11526,0,156149,38450,4,156153,38454,3.25419155368563,0.801372256731713,69
-7.6926,53.28823,2021/01/30 00:00:00+00,Sat 30 Jan 2021,648,7793,0,156797,46243,4,156801,46247,3.2676957202837,0.963776531884108,70
-7.6926,53.28823,2021/01/31 00:00:00+00,Sun 31 Jan 2021,232,4086,0,157029,50329,4,157033,50333,3.27253054536202,1.04892780459971,71
-7.6926,53.28823,2021/02/01 00:00:00+00,Mon 01 Feb 2021,1028,8332,1,158057,58661,5,158062,58666,3.29397466176543,1.22258555191716,72
-7.6926,53.28823,2021/02/02 00:00:00+00,Tue 02 Feb 2021,836,5108,0,158893,63769,5,158898,63774,3.311396703858,1.3290350626933,73
-7.6926,53.28823,2021/02/03 00:00:00+00,Wed 03 Feb 2021,1405,6868,0,160298,70637,5,160303,70642,3.34067657125042,1.47216255682222,74
-7.6926,53.28823,2021/02/04 00:00:00+00,Thu 04 Feb 2021,1441,10541,1,161739,81178,6,161745,81184,3.37072750988378,1.69185534120007,75
-7.6926,53.28823,2021/02/05 00:00:00+00,Fri 05 Feb 2021,3396,8615,0,165135,89793,6,165141,89799,3.44149934594403,1.87138990175927,76
-7.6926,53.28823,2021/02/06 00:00:00+00,Sat 06 Feb 2021,902,3870,0,166037,93663,6,166043,93669,3.46029681241233,1.95203978560885,77
-7.6926,53.28823,2021/02/07 00:00:00+00,Sun 07 Feb 2021,333,1301,2,166370,94964,8,166378,94972,3.46727813310732,1.97919399714787,78
-7.6926,53.28823,2021/02/08 00:00:00+00,Mon 08 Feb 2021,1189,879,0,167559,95843,8,167567,95851,3.49205661163371,1.99751214906099,79
-7.6926,53.28823,2021/02/09 00:00:00+00,Tue 09 Feb 2021,4265,546,3,171824,96389,11,171835,96400,3.58100072126421,2.00895317909547,80
-7.6926,53.28823,2021/02/10 00:00:00+00,Wed 10 Feb 2021,8828,579,0,180652,96968,11,180663,96979,3.76497415139963,2.021019402028,81
-7.6926,53.28823,2021/02/11 00:00:00+00,Thu 11 Feb 2021,6190,446,0,186842,97414,11,186853,97425,3.89397228603242,2.03031393644581,82
-7.6926,53.28823,2021/02/12 00:00:00+00,Fri 12 Feb 2021,4398,525,0,191240,97939,11,191251,97950,3.98562556488783,2.04125481216184,83
-7.6926,53.28823,2021/02/13 00:00:00+00,Sat 13 Feb 2021,1212,1915,0,192452,99854,11,192463,99865,4.01088335796941,2.08116295882125,84
-7.6926,53.28823,2021/02/14 00:00:00+00,Sun 14 Feb 2021,2702,27,0,195154,99881,11,195165,99892,4.06719239832123,2.08172563242951,85
-7.6926,53.28823,2021/02/15 00:00:00+00,Mon 15 Feb 2021,1964,7892,0,197118,107773,11,197129,107784,4.10812169338081,2.2461930441455,86
-7.6926,53.28823,2021/02/16 00:00:00+00,Tue 16 Feb 2021,5656,8164,0,202774,115937,11,202785,115948,4.22599139442816,2.41632887147055,87
-7.6926,53.28823,2021/02/17 00:00:00+00,Wed 17 Feb 2021,9748,8464,0,212522,124401,11,212533,124412,4.42913740677071,2.59271662777619,88
-7.6926,53.28823,2021/02/18 00:00:00+00,Thu 18 Feb 2021,8468,8354,1,220990,132755,12,221002,132767,4.6056293618927,2.76683284988556,89
-7.6926,53.28823,2021/02/19 00:00:00+00,Fri 19 Feb 2021,9395,6582,0,230385,139337,12,230397,139349,4.80141893780143,2.90400017171965,90
-7.6926,53.28823,2021/02/20 00:00:00+00,Sat 20 Feb 2021,5893,3573,2,236278,142910,14,236292,142924,4.92426934226998,2.97850232540498,91
-7.6926,53.28823,2021/02/21 00:00:00+00,Sun 21 Feb 2021,1112,1024,6,237390,143934,20,237410,143954,4.9475681976043,2.99996728157167,92
-7.6926,53.28823,2021/02/22 00:00:00+00,Mon 22 Feb 2021,3946,1123,1,241336,145057,21,241357,145078,5.02982274322557,3.0233911754856,93
-7.6926,53.28823,2021/02/23 00:00:00+00,Tue 23 Feb 2021,13362,1070,1,254698,146127,22,254720,146149,5.3083044997842,3.0457105619463,94
-7.6926,53.28823,2021/02/24 00:00:00+00,Wed 24 Feb 2021,16943,2106,5,271641,148233,27,271668,148260,5.66149680766086,3.08970330220637,95
-7.6926,53.28823,2021/02/25 00:00:00+00,Thu 25 Feb 2021,18097,1758,2,289738,149991,29,289767,150020,6.03867568305971,3.12638128555915,96
-7.6926,53.28823,2021/02/26 00:00:00+00,Fri 26 Feb 2021,16080,2770,0,305818,152761,29,305847,152790,6.3737790764192,3.18410742981324,97
-7.6926,53.28823,2021/02/27 00:00:00+00,Sat 27 Feb 2021,8998,705,1,314816,153466,30,314846,153496,6.56131610607356,3.19882030268089,98
-7.6926,53.28823,2021/02/28 00:00:00+00,Sun 28 Feb 2021,2446,58,2,317262,153524,32,317294,153556,6.61233184655516,3.20007068847701,99
-7.6926,53.28823,2021/03/01 00:00:00+00,Mon 01 Mar 2021,5606,796,0,322868,154320,32,322900,154352,6.72915955943907,3.21665914003883,100
-7.6926,53.28823,2021/03/02 00:00:00+00,Tue 02 Mar 2021,12186,1612,0,335054,155932,32,335086,155964,6.98311291463054,3.25025283842786,101
-7.6926,53.28823,2021/03/03 00:00:00+00,Wed 03 Mar 2021,12905,1504,1,347959,157436,33,347992,157469,7.25207089937541,3.28161668214714,102
-7.6926,53.28823,2021/03/04 00:00:00+00,Thu 04 Mar 2021,18726,1692,5,366685,159128,38,366723,159166,7.64242050516003,3.31698176041399,103
-7.6926,53.28823,2021/03/05 00:00:00+00,Fri 05 Mar 2021,18452,2400,6,385137,161528,44,385181,161572,8.02708085557231,3.36712223083831,104
-7.6926,53.28823,2021/03/06 00:00:00+00,Sat 06 Mar 2021,10405,142,4,395542,161670,48,395590,161718,8.24400195143543,3.37016483627553,105
-7.6926,53.28823,2021/03/07 00:00:00+00,Sun 07 Mar 2021,1523,12,3,397065,161682,51,397116,161733,8.27580343018335,3.37047743272456,106
-7.6926,53.28823,2021/03/08 00:00:00+00,Mon 08 Mar 2021,6670,1500,5,403735,163182,56,403791,163238,8.41490885000143,3.40184127644384,107
-7.6926,53.28823,2021/03/09 00:00:00+00,Tue 09 Mar 2021,13840,3106,6,417575,166288,62,417637,166350,8.70345621221881,3.4666946197358,108
-7.6926,53.28823,2021/03/10 00:00:00+00,Wed 10 Mar 2021,13742,3990,3,431317,170278,65,431382,170343,8.98989875834606,3.54990779446742,109
-7.6926,53.28823,2021/03/11 00:00:00+00,Thu 11 Mar 2021,18492,2102,3,449809,172380,68,449877,172448,9.37533017999929,3.59377549614787,110
-7.6926,53.28823,2021/03/12 00:00:00+00,Fri 12 Mar 2021,17337,1341,4,467146,173721,72,467218,173793,9.73671251484052,3.62180497774417,111
-7.6926,53.28823,2021/03/13 00:00:00+00,Sat 13 Mar 2021,8315,176,0,475461,173897,72,475533,173969,9.90999514641913,3.62547277607945,112
-7.6926,53.28823,2021/03/14 00:00:00+00,Sun 14 Mar 2021,384,20,2,475845,173917,74,475919,173991,9.91803929504082,3.62593125087136,113
-7.6926,53.28823,2021/03/15 00:00:00+00,Mon 15 Mar 2021,2661,993,0,478506,174910,74,478580,174984,9.97349390509864,3.64662513579711,114
-7.6926,53.28823,2021/03/16 00:00:00+00,Tue 16 Mar 2021,8950,3823,2,487456,178733,76,487532,178809,10.1600514658794,3.7263372302996,115
-7.6926,53.28823,2021/03/17 00:00:00+00,Wed 17 Mar 2021,4884,2416,7,492340,181149,83,492423,181232,10.2619787480262,3.77683197669948,116
-7.6926,53.28823,2021/03/18 00:00:00+00,Thu 18 Mar 2021,11725,4683,5,504065,185832,88,504153,185920,10.5064291711672,3.87452878690279,117
-7.6926,53.28823,2021/03/19 00:00:00+00,Fri 19 Mar 2021,10380,6135,2,514445,191967,90,514535,192057,10.7227875934221,4.00242241408234,118
-7.6926,53.28823,2021/03/20 00:00:00+00,Sat 20 Mar 2021,5249,3120,4,519694,195087,94,519788,195181,10.8322588698721,4.06752583453353,119
-7.6926,53.28823,2021/03/21 00:00:00+00,Sun 21 Mar 2021,3643,54,3,523337,195141,97,523434,195238,10.9082406467495,4.06871370103984,120
-7.6926,53.28823,2021/03/22 00:00:00+00,Mon 22 Mar 2021,7418,2410,1,530755,197551,98,530853,197649,11.0628508504395,4.1189583702805,121
-7.6926,53.28823,2021/03/23 00:00:00+00,Tue 23 Mar 2021,12572,7394,4,543327,204945,102,543429,205047,11.3249317133057,4.27313093894179,122
-7.6926,53.28823,2021/03/24 00:00:00+00,Wed 24 Mar 2021,13632,9782,2,556959,214727,104,557063,214831,11.6090610457101,4.47702718276201,123
-7.6926,53.28823,2021/03/25 00:00:00+00,Thu 25 Mar 2021,20877,10226,3,577836,224953,107,577943,225060,12.044195302759,4.69019712123678,124
-7.6926,53.28823,2021/03/26 00:00:00+00,Fri 26 Mar 2021,19705,9499,1,597541,234452,108,597649,234560,12.4548636777306,4.88817487228872,125
-7.6926,53.28823,2021/03/27 00:00:00+00,Sat 27 Mar 2021,11763,5358,3,609304,239810,111,609415,239921,12.7000643323492,4.99989684317182,126
-7.6926,53.28823,2021/03/28 00:00:00+00,Sun 28 Mar 2021,2492,484,0,611796,240294,111,611907,240405,12.7519970224146,5.00998328859384,127
-7.6926,53.28823,2021/03/28 23:00:00+00,Mon 29 Mar 2021,9282,3123,3,621078,243417,114,621192,243531,12.9454942243638,5.07512838857156,128
-7.6926,53.28823,2021/03/29 23:00:00+00,Tue 30 Mar 2021,13336,8670,4,634414,252087,118,634532,252205,13.2234966663673,5.25589249516361,129
-7.6926,53.28823,2021/03/30 23:00:00+00,Wed 31 Mar 2021,15840,10503,4,650254,262590,122,650376,262712,13.5536818755954,5.47485588782706,130
-7.6926,53.28823,2021/03/31 23:00:00+00,Thu 01 Apr 2021,19696,11574,9,669950,274164,131,670081,274295,13.9643294108036,5.71624286576754,131
-7.6926,53.28823,2021/04/01 23:00:00+00,Fri 02 Apr 2021,20150,13723,9,690100,287887,140,690240,288027,14.3844381985358,6.0024144949723,132
-7.6926,53.28823,2021/04/02 23:00:00+00,Sat 03 Apr 2021,7548,4635,6,697648,292522,146,697794,292668,14.541861770267,6.09913183630199,133
-7.6926,53.28823,2021/04/03 23:00:00+00,Sun 04 Apr 2021,3041,170,3,700689,292692,149,700838,292841,14.6052980096567,6.10273711534746,134
-7.6926,53.28823,2021/04/04 23:00:00+00,Mon 05 Apr 2021,3438,608,4,704127,293300,153,704280,293453,14.6770284748273,6.11549105046786,135
-7.6926,53.28823,2021/04/05 23:00:00+00,Tue 06 Apr 2021,11999,8154,11,716126,301454,164,716290,301618,14.9273140316835,6.28564771755619,136
-7.6926,53.28823,2021/04/06 23:00:00+00,Wed 07 Apr 2021,18372,10473,12,734498,311927,176,734674,312103,15.3104322396139,6.50415263542772,137
-7.6926,53.28823,2021/04/07 23:00:00+00,Thu 08 Apr 2021,20189,10567,16,754687,322494,192,754879,322686,15.7314996564565,6.72469985009958,138
-7.6926,53.28823,2021/04/08 23:00:00+00,Fri 09 Apr 2021,20678,9160,16,775365,331654,208,775573,331862,16.1627577175374,6.91592551785249,139
-7.6926,53.28823,2021/04/09 23:00:00+00,Sat 10 Apr 2021,11181,4180,12,786546,335834,220,786766,336054,16.3960171878032,7.00328580547456,140
-7.6926,53.28823,2022/02/17 00:00:00+00,Thu 17 Feb 2022,790,1192,2,3820137,3729164,240920,4061057,3970084,84.6314665003931,82.7356107165565,141
-7.6926,53.28823,2021/08/09 23:00:00+00,Tue 10 Aug 2021,9359,26015,716,3282688,2806459,229368,3512056,3035827,73.1904156261546,63.2659160045006,142
-7.6926,53.28823,2022/02/18 00:00:00+00,Fri 18 Feb 2022,791,3293,0,3820928,3732457,240920,4061848,3973377,84.6479507531386,82.8042360570001,143
-7.6926,53.28823,2021/08/10 23:00:00+00,Wed 11 Aug 2021,7018,31249,666,3289706,2837708,230034,3519740,3067742,73.3505483671108,63.9310170492187,144
-7.6926,53.28823,2022/02/19 00:00:00+00,Sat 19 Feb 2022,980,3555,0,3821908,3736012,240920,4062828,3976932,84.6683737211419,82.87832141542,145
-7.6926,53.28823,2021/08/11 23:00:00+00,Thu 12 Aug 2021,6782,38301,864,3296488,2876009,230898,3527386,3106907,73.5098891970627,64.7472063776344,146
-7.6926,53.28823,2022/02/20 00:00:00+00,Sun 20 Feb 2022,1366,3588,0,3823274,3739600,240920,4064194,3980520,84.6968408377668,82.9530944860279,147
-7.6926,53.28823,2022/02/21 00:00:00+00,Mon 21 Feb 2022,252,994,1,3823526,3740594,240921,4064447,3981515,84.7021132978738,82.9738300504802,148
-7.6926,53.28823,2022/02/22 00:00:00+00,Tue 22 Feb 2022,475,981,0,3824001,3741575,240921,4064922,3982496,84.7120121854264,82.9942738582467,149
-7.6926,53.28823,2022/02/23 00:00:00+00,Wed 23 Feb 2022,832,1272,1,3824833,3742847,240922,4065755,3983769,84.7293717082291,83.0208028768876,150
-7.6926,53.28823,2022/02/24 00:00:00+00,Thu 24 Feb 2022,655,1232,0,3825488,3744079,240922,4066410,3985001,84.7430217531701,83.0464774652346,151
-7.6926,53.28823,2022/02/25 00:00:00+00,Fri 25 Feb 2022,691,1227,0,3826179,3745306,240922,4067101,3986228,84.7574220295887,83.0720478547652,152
-7.6926,53.28823,2022/02/26 00:00:00+00,Sat 26 Feb 2022,959,2092,0,3827138,3747398,240922,4068060,3988320,84.7774073625633,83.1156446395232,153
-7.6926,53.28823,2022/02/27 00:00:00+00,Sun 27 Feb 2022,671,1783,0,3827809,3749181,240922,4068731,3990103,84.7913908437166,83.1528019374311,154
-7.6926,53.28823,2022/02/28 00:00:00+00,Mon 28 Feb 2022,82,430,0,3827891,3749611,240922,4068813,3990533,84.7930997043046,83.1617630356366,155
-7.6926,53.28823,2022/03/01 00:00:00+00,Tue 01 Mar 2022,130,937,0,3828021,3750548,240922,4068943,3991470,84.7958088735295,83.1812898938193,156
-7.6926,53.28823,2022/03/02 00:00:00+00,Wed 02 Mar 2022,205,997,2,3828226,3751545,240924,4069150,3992469,84.8001227045261,83.2021088173247,157
-7.6926,53.28823,2022/03/03 00:00:00+00,Thu 03 Mar 2022,279,1275,0,3828505,3752820,240924,4069429,3993744,84.8059369984781,83.2286795154922,158
-7.6926,53.28823,2022/03/04 00:00:00+00,Fri 04 Mar 2022,735,1507,1,3829240,3754327,240925,4070165,3995252,84.8212750642438,83.2601058785013,159
-7.6926,53.28823,2022/03/05 00:00:00+00,Sat 05 Mar 2022,962,3341,0,3830202,3757668,240925,4071127,3998593,84.8413229165082,83.3297315275817,160
-7.6926,53.28823,2022/03/06 00:00:00+00,Sun 06 Mar 2022,455,1915,0,3830657,3759583,240925,4071582,4000508,84.8508050087954,83.3696396742412,161
-7.6926,53.28823,2022/03/07 00:00:00+00,Mon 07 Mar 2022,114,124,1,3830771,3759707,240926,4071697,4000633,84.8532015815713,83.3722446446497,162
-7.6926,53.28823,2022/03/08 00:00:00+00,Tue 08 Mar 2022,120,493,0,3830891,3760200,240926,4071817,4001126,84.8557023531636,83.3825186479412,163
-7.6926,53.28823,2022/03/09 00:00:00+00,Wed 09 Mar 2022,130,345,1,3831021,3760545,240927,4071948,4001472,84.8584323621517,83.3897292060321,164
-7.6926,53.28823,2022/03/10 00:00:00+00,Thu 10 Mar 2022,258,509,0,3831279,3761054,240927,4072206,4001981,84.863809021075,83.4003366455358,165
-7.6926,53.28823,2022/03/11 00:00:00+00,Fri 11 Mar 2022,492,2182,0,3831771,3763236,240927,4072698,4004163,84.8740621846032,83.445809008988,166
-7.6926,53.28823,2022/03/12 00:00:00+00,Sat 12 Mar 2022,473,2391,2,3832244,3765627,240929,4073173,4006556,84.8839610721558,83.4956785624898,167
-7.6926,53.28823,2022/03/13 00:00:00+00,Sun 13 Mar 2022,358,1082,0,3832602,3766709,240929,4073531,4007638,84.891421707406,83.5182271863465,168
-7.6926,53.28823,2022/03/14 00:00:00+00,Mon 14 Mar 2022,109,121,0,3832711,3766830,240929,4073640,4007759,84.8936932416023,83.520748797702,169
-7.6926,53.28823,2022/03/15 00:00:00+00,Tue 15 Mar 2022,220,756,1,3832931,3767586,240930,4073861,4008516,84.8982988292846,83.5365244984963,170
-7.6926,53.28823,2022/03/16 00:00:00+00,Wed 16 Mar 2022,196,797,0,3833127,3768383,240930,4074057,4009313,84.9023834228853,83.5531337898214,171
-7.6926,53.28823,2022/03/18 00:00:00+00,Fri 18 Mar 2022,2,6,0,3833129,3768389,240930,4074059,4009319,84.9024251024118,83.553258828401,172
-7.6926,53.28823,2022/03/19 00:00:00+00,Sat 19 Mar 2022,743,2778,0,3833872,3771167,240930,4074802,4012097,84.9179090465204,83.6111516907613,173
-7.6926,53.28823,2022/03/20 00:00:00+00,Sun 20 Mar 2022,395,1402,0,3834267,3772569,240930,4075197,4013499,84.9261407530115,83.6403690388639,174
-7.6926,53.28823,2022/03/21 00:00:00+00,Mon 21 Mar 2022,56,112,0,3834323,3772681,240930,4075253,4013611,84.9273077797545,83.64270309235,175
-7.6926,53.28823,2022/03/22 00:00:00+00,Tue 22 Mar 2022,140,574,0,3834463,3773255,240930,4075393,4014185,84.9302253466121,83.6546651164661,176
-7.6926,53.28823,2022/03/23 00:00:00+00,Wed 23 Mar 2022,102,221,0,3834565,3773476,240930,4075495,4014406,84.9323510024656,83.6592707041485,177
-7.6926,53.28823,2022/03/24 00:00:00+00,Thu 24 Mar 2022,148,244,0,3834713,3773720,240930,4075643,4014650,84.9354352874293,83.6643556063861,178
-7.6926,53.28823,2022/03/25 00:00:00+00,Fri 25 Mar 2022,435,1625,0,3835148,3775345,240930,4076078,4016275,84.9445005844512,83.6982202216976,179
-7.6926,53.28823,2022/03/26 00:00:00+00,Sat 26 Mar 2022,874,1848,1,3836022,3777193,240931,4076953,4018124,84.9627353773112,83.7367529439813,180
-7.6926,53.28823,2022/03/27 00:00:00+00,Sun 27 Mar 2022,380,803,0,3836402,3777996,240931,4077333,4018927,84.9706544873533,83.753487273886,181
-7.6926,53.28823,2022/03/27 23:00:00+00,Mon 28 Mar 2022,44,53,1,3836446,3778049,240932,4077378,4018981,84.9715922767004,83.7546126211025,182
-7.6926,53.28823,2022/03/28 23:00:00+00,Tue 29 Mar 2022,138,194,3,3836584,3778243,240935,4077519,4019178,84.9745306833212,83.7587180544664,183
-7.6926,53.28823,2022/03/29 23:00:00+00,Wed 30 Mar 2022,109,135,0,3836693,3778378,240935,4077628,4019313,84.9768022175175,83.7615314225076,184
-7.6926,53.28823,2022/03/30 23:00:00+00,Thu 31 Mar 2022,227,358,0,3836920,3778736,240935,4077855,4019671,84.9815328437795,83.7689920577578,185
-7.6926,53.28823,2022/03/31 23:00:00+00,Fri 01 Apr 2022,304,904,0,3837224,3779640,240935,4078159,4020575,84.9878681318132,83.7878312037527,186
-7.6926,53.28823,2022/04/01 23:00:00+00,Sat 02 Apr 2022,729,1539,0,3837953,3781179,240935,4078888,4022114,85.003060319236,83.8199035994231,187
-7.6926,53.28823,2022/04/02 23:00:00+00,Sun 03 Apr 2022,538,815,0,3838491,3781994,240935,4079426,4022929,85.0142721118745,83.836888006487,188
-7.6926,53.28823,2022/04/03 23:00:00+00,Mon 04 Apr 2022,50,52,0,3838541,3782046,240935,4079476,4022981,85.015314100038,83.837971674177,189
-7.6926,53.28823,2022/04/04 23:00:00+00,Tue 05 Apr 2022,129,169,0,3838670,3782215,240935,4079605,4023150,85.0180024294996,83.8414935941694,190
-7.6926,53.28823,2022/04/05 23:00:00+00,Wed 06 Apr 2022,158,210,0,3838828,3782425,240935,4079763,4023360,85.021295112096,83.8458699444558,191
-7.6926,53.28823,2022/04/06 23:00:00+00,Thu 07 Apr 2022,117,178,0,3838945,3782603,240935,4079880,4023538,85.0237333643985,83.8495794223176,192
-7.6926,53.28823,2022/04/07 23:00:00+00,Fri 08 Apr 2022,257,421,2,3839202,3783024,240937,4080139,4023961,85.029130863085,83.8583946421802,193
-7.6926,53.28823,2022/04/08 23:00:00+00,Sat 09 Apr 2022,558,1018,0,3839760,3784042,240937,4080697,4024979,85.0407594509889,83.8796095211877,194
-7.6926,53.28823,2022/04/09 23:00:00+00,Sun 10 Apr 2022,412,719,0,3840172,3784761,240937,4081109,4025698,85.0493454334556,83.8945933109778,195
-7.6926,53.28823,2022/04/10 23:00:00+00,Mon 11 Apr 2022,70,93,1,3840242,3784854,240938,4081180,4025792,85.0508250566477,83.8965522487251,196
-7.6926,53.28823,2022/04/11 23:00:00+00,Tue 12 Apr 2022,197,177,0,3840439,3785031,240938,4081377,4025969,85.0549304900116,83.9002408868236,197
-7.6926,53.28823,2022/04/12 23:00:00+00,Wed 13 Apr 2022,143,233,0,3840582,3785264,240938,4081520,4026202,85.057910576159,83.9050965516652,198
-7.6926,53.28823,2022/04/13 23:00:00+00,Thu 14 Apr 2022,357,431,0,3840939,3785695,240938,4081877,4026633,85.0653503716459,83.914078489634,199
-7.6926,53.28823,2022/04/14 23:00:00+00,Fri 15 Apr 2022,445,991,0,3841384,3786686,240938,4082322,4027624,85.0746240663005,83.9347306950332,200
-7.6926,53.28823,2022/04/15 23:00:00+00,Sat 16 Apr 2022,42,88,0,3841426,3786774,240938,4082364,4027712,85.0754993363577,83.9365645942008,201
-7.6926,53.28823,2022/04/16 23:00:00+00,Sun 17 Apr 2022,1,0,0,3841427,3786774,240938,4082365,4027712,85.075520176121,83.9365645942008,202
-7.6926,53.28823,2022/04/17 23:00:00+00,Mon 18 Apr 2022,36,62,1,3841463,3786836,240939,4082402,4027775,85.076291247362,83.9378774992868,203
-7.6926,53.28823,2022/04/18 23:00:00+00,Tue 19 Apr 2022,218,269,1,3841681,3787105,240940,4082621,4028045,85.0808551555178,83.9435042353693,204
-7.6926,53.28823,2022/04/19 23:00:00+00,Wed 20 Apr 2022,250,606,0,3841931,3787711,240940,4082871,4028651,85.0860650963349,83.9561331319101,205
-7.6926,53.28823,2022/04/20 23:00:00+00,Thu 21 Apr 2022,169,236,0,3842100,3787947,240940,4083040,4028887,85.0895870163273,83.9610513160415,206
-7.6926,53.28823,2022/04/21 23:00:00+00,Fri 22 Apr 2022,192,254,0,3842292,3788201,240940,4083232,4029141,85.0935882508749,83.9663446159117,207
-7.6926,53.28823,2022/04/22 23:00:00+00,Sat 23 Apr 2022,320,1010,0,3842612,3789211,240940,4083552,4030151,85.1002569751209,83.987392776813,208
-7.6926,53.28823,2022/04/23 23:00:00+00,Sun 24 Apr 2022,181,252,0,3842793,3789463,240940,4083733,4030403,85.1040289722725,83.9926443971567,209
-7.6926,53.28823,2022/04/24 23:00:00+00,Mon 25 Apr 2022,41,58,1,3842834,3789521,240941,4083775,4030462,85.1049042423298,83.9938739431896,210
-7.6926,53.28823,2022/04/25 23:00:00+00,Tue 26 Apr 2022,145,238,0,3842979,3789759,240941,4083920,4030700,85.1079260080037,83.9988338068475,211
-7.6926,53.28823,2022/04/26 23:00:00+00,Wed 27 Apr 2022,120,208,0,3843099,3789967,240941,4084040,4030908,85.110426779596,84.0031684776074,212
-7.6926,53.28823,2022/04/27 23:00:00+00,Thu 28 Apr 2022,99,130,0,3843198,3790097,240941,4084139,4031038,85.1124899161595,84.0058776468323,213
-7.6926,53.28823,2022/04/28 23:00:00+00,Fri 29 Apr 2022,168,222,0,3843366,3790319,240941,4084307,4031260,85.1159909963887,84.0105040742779,214
-7.6926,53.28823,2022/04/29 23:00:00+00,Sat 30 Apr 2022,281,723,0,3843647,3791042,240941,4084588,4031983,85.1218469698672,84.0255712231211,215
-7.6926,53.28823,2022/04/30 23:00:00+00,Sun 01 May 2022,187,746,0,3843834,3791788,240941,4084775,4032729,85.1257440055984,84.0411176865195,216
-7.6926,53.28823,2022/05/01 23:00:00+00,Mon 02 May 2022,13,26,0,3843847,3791814,240941,4084788,4032755,85.1260149225209,84.0416595203645,217
-7.6926,53.28823,2022/05/02 23:00:00+00,Tue 03 May 2022,95,118,0,3843942,3791932,240941,4084883,4032873,85.1279947000314,84.0441186124302,218
-7.6926,53.28823,2022/05/03 23:00:00+00,Wed 04 May 2022,113,128,0,3844055,3792060,240941,4084996,4033001,85.1303495932808,84.0467861021286,219
-7.6926,53.28823,2022/05/04 23:00:00+00,Thu 05 May 2022,110,164,0,3844165,3792224,240941,4085106,4033165,85.1326419672403,84.0502038233046,220
-7.6926,53.28823,2022/05/05 23:00:00+00,Fri 06 May 2022,137,257,0,3844302,3792481,240941,4085243,4033422,85.1354970148081,84.0555596424647,221
-7.6926,53.28823,2022/05/06 23:00:00+00,Sat 07 May 2022,441,1087,0,3844743,3793568,240941,4085684,4034509,85.1446873504096,84.0782124651377,222
-7.6926,53.28823,2022/05/07 23:00:00+00,Sun 08 May 2022,274,437,0,3845017,3794005,240941,4085958,4034946,85.1503974455452,84.0873194416861,223
-7.6926,53.28823,2022/05/08 23:00:00+00,Mon 09 May 2022,23,32,0,3845040,3794037,240941,4085981,4034978,85.1508767601004,84.0879863141107,224
-7.6926,53.28823,2022/05/09 23:00:00+00,Tue 10 May 2022,80,98,1,3845120,3794135,240942,4086062,4035077,85.1525647809251,84.0900494506743,225
-7.6926,53.28823,2022/05/10 23:00:00+00,Wed 11 May 2022,111,132,0,3845231,3794267,240942,4086173,4035209,85.1548779946479,84.0928002994257,226
-7.6926,53.28823,2022/05/11 23:00:00+00,Thu 12 May 2022,207,398,0,3845438,3794665,240942,4086380,4035607,85.1591918256445,84.1010945252066,227
-7.6926,53.28823,2022/05/12 23:00:00+00,Fri 13 May 2022,174,326,0,3845612,3794991,240942,4086554,4035933,85.1628179444533,84.1078882880322,228
-7.6926,53.28823,2022/05/13 23:00:00+00,Sat 14 May 2022,333,633,0,3845945,3795624,240942,4086887,4036566,85.1697575856217,84.1210798581812,229
-7.6926,53.28823,2022/05/14 23:00:00+00,Sun 15 May 2022,168,254,0,3846113,3795878,240942,4087055,4036820,85.1732586658509,84.1263731580515,230
-7.6926,53.28823,2022/05/15 23:00:00+00,Mon 16 May 2022,31,42,0,3846144,3795920,240942,4087086,4036862,85.1739046985122,84.1272484281088,231
-7.6926,53.28823,2022/05/16 23:00:00+00,Tue 17 May 2022,94,99,0,3846238,3796019,240942,4087180,4036961,85.1758636362594,84.1293115646723,232
-7.6926,53.28823,2022/05/17 23:00:00+00,Wed 18 May 2022,92,122,0,3846330,3796141,240942,4087272,4037083,85.1777808944802,84.1318540157911,233
-7.6926,53.28823,2022/05/18 23:00:00+00,Thu 19 May 2022,73,105,0,3846403,3796246,240942,4087345,4037188,85.1793021971988,84.1340421909343,234
-7.6926,53.28823,2022/05/19 23:00:00+00,Fri 20 May 2022,125,209,0,3846528,3796455,240942,4087470,4037397,85.1819071676073,84.1383977014575,235
-7.6926,53.28823,2022/05/20 23:00:00+00,Sat 21 May 2022,393,761,0,3846921,3797216,240942,4087863,4038158,85.1900971945719,84.1542567613049,236
-7.6926,53.28823,2022/05/21 23:00:00+00,Sun 22 May 2022,234,409,0,3847155,3797625,240942,4088097,4038567,85.1949736991768,84.1627802244818,237
-7.6926,53.28823,2022/05/22 23:00:00+00,Mon 23 May 2022,27,36,0,3847182,3797661,240942,4088124,4038603,85.195536372785,84.1635304559594,238
-7.6926,53.28823,2022/05/23 23:00:00+00,Tue 24 May 2022,62,83,0,3847244,3797744,240942,4088186,4038686,85.1968284381077,84.1652601563107,239
-7.6926,53.28823,2022/05/24 23:00:00+00,Wed 25 May 2022,83,134,1,3847327,3797878,240943,4088270,4038821,85.1985789782222,84.168073524352,240
-7.6926,53.28823,2022/05/25 23:00:00+00,Thu 26 May 2022,98,155,0,3847425,3798033,240943,4088368,4038976,85.2006212750226,84.1713036876586,241
-7.6926,53.28823,2022/05/26 23:00:00+00,Fri 27 May 2022,95,151,0,3847520,3798184,240943,4088463,4039127,85.2026010525331,84.1744504919122,242
-7.6926,53.28823,2022/05/27 23:00:00+00,Sat 28 May 2022,334,578,0,3847854,3798762,240943,4088797,4039705,85.2095615334648,84.1864958750815,243
-7.6926,53.28823,2022/05/28 23:00:00+00,Sun 29 May 2022,182,349,0,3848036,3799111,240943,4088979,4040054,85.2133543703797,84.1937689524622,244
-7.6926,53.28823,2022/05/29 23:00:00+00,Mon 30 May 2022,9,23,0,3848045,3799134,240943,4088988,4040077,85.2135419282491,84.1942482670174,245
-7.6926,53.28823,2022/05/30 23:00:00+00,Tue 31 May 2022,64,79,1,3848109,3799213,240944,4089053,4040157,85.2148965128616,84.1959154480789,246
-7.6926,53.28823,2022/05/31 23:00:00+00,Wed 01 Jun 2022,67,100,0,3848176,3799313,240944,4089120,4040257,85.2162927770006,84.1979994244057,247
-7.6926,53.28823,2021/04/23 23:00:00+00,Sat 24 Apr 2021,23704,6996,2,1038551,430880,260,1038811,431140,21.6485753208438,8.98485553563506,248
-7.6926,53.28823,2021/04/24 23:00:00+00,Sun 25 Apr 2021,9751,305,2,1048302,431185,262,1048564,431447,21.8518255320027,8.99125334295853,249
-7.6926,53.28823,2021/08/12 23:00:00+00,Fri 13 Aug 2021,10933,28254,873,3307421,2904263,231771,3539192,3136034,73.7559234422121,65.3542061623597,250
-7.6926,53.28823,2021/04/25 23:00:00+00,Mon 26 Apr 2021,15596,3056,3,1063898,434241,265,1064163,434506,22.17690499923,9.05500217879725,251
-7.6926,53.28823,2021/04/26 23:00:00+00,Tue 27 Apr 2021,25919,7821,9,1089817,442062,274,1090091,442336,22.7172383812589,9.21817752519059,252
-7.6926,53.28823,2021/08/13 23:00:00+00,Sat 14 Aug 2021,18140,5850,281,3325561,2910113,232052,3557613,3142165,74.1398127213834,65.4819747509596,253
-7.6926,53.28823,2021/04/27 23:00:00+00,Wed 28 Apr 2021,26043,8614,5,1115860,450676,279,1116139,450955,23.26007253488,9.39779544480287,254
-7.6926,53.28823,2021/08/14 23:00:00+00,Sun 15 Aug 2021,17001,3735,51,3342562,2913848,232103,3574665,3145951,74.49517236464,65.5608740946946,255
-7.6926,53.28823,2021/04/28 23:00:00+00,Thu 29 Apr 2021,31690,11322,6,1147550,461998,285,1147835,462283,23.9206096714424,9.63386828310985,256
-7.6926,53.28823,2021/08/15 23:00:00+00,Mon 16 Aug 2021,10195,23157,384,3352757,2937005,232487,3585244,3169492,74.7156362202588,66.0514629618013,257
-7.6926,53.28823,2021/04/29 23:00:00+00,Fri 30 Apr 2021,36099,13538,8,1183649,475536,293,1183942,475829,24.6730710037826,9.91616371634665,258
-7.6926,53.28823,2021/08/16 23:00:00+00,Tue 17 Aug 2021,12874,26868,528,3365631,2963873,233015,3598646,3196888,74.9949307275849,66.6223891163086,259
-7.6926,53.28823,2021/04/30 23:00:00+00,Sat 01 May 2021,16592,6693,18,1200241,482229,311,1200552,482540,25.0192194716745,10.0560193676424,260
-7.6926,53.28823,2021/08/17 23:00:00+00,Wed 18 Aug 2021,15238,25771,658,3380869,2989644,233673,3614542,3223317,75.326199604503,67.1731632197351,261
-7.6926,53.28823,2021/05/01 23:00:00+00,Sun 02 May 2021,12468,911,16,1212709,483140,327,1213036,483467,25.27938307632,10.0753378281924,262
-7.6926,53.28823,2021/08/18 23:00:00+00,Thu 19 Aug 2021,11365,25718,544,3392234,3015362,234217,3626451,3249579,75.574380345269,67.7204570826957,263
-7.6926,53.28823,2021/05/02 23:00:00+00,Mon 03 May 2021,14268,929,21,1226977,484069,348,1227325,484417,25.5771624536654,10.0951356032976,264
-7.6926,53.28823,2021/08/19 23:00:00+00,Fri 20 Aug 2021,14853,22253,686,3407087,3037615,234903,3641990,3272518,75.8982094267002,68.1985004123147,265
-7.6926,53.28823,2021/05/03 23:00:00+00,Tue 04 May 2021,26662,6800,10,1253639,490869,358,1253997,491227,26.1330006195662,10.2370543911569,266
-7.6926,53.28823,2021/08/20 23:00:00+00,Sat 21 Aug 2021,11895,7986,246,3418982,3045601,235149,3654131,3280750,76.1512249925446,68.370053343542,267
-7.6926,53.28823,2021/05/04 23:00:00+00,Wed 05 May 2021,32121,13459,69,1285760,504328,427,1286187,504755,26.8038325991832,10.5189747086549,268
-7.6926,53.28823,2021/08/21 23:00:00+00,Sun 22 Aug 2021,8004,12254,161,3426986,3057855,235310,3662296,3293165,76.3213816596329,68.628779004522,269
-7.6926,53.28823,2021/05/05 23:00:00+00,Thu 06 May 2021,37296,14375,132,1323056,518703,559,1323615,519262,27.5838232588013,10.8212971543928,270
-7.6926,53.28823,2021/11/11 00:00:00+00,Thu 11 Nov 2021,1384,1118,1,3635042,3568137,240788,3875830,3808925,80.7713796694355,79.3770953079481,271
-7.6926,53.28823,2021/08/22 23:00:00+00,Mon 23 Aug 2021,10870,15390,291,3437856,3073245,235601,3673457,3308846,76.553974257474,68.9555673323373,272
-7.6926,53.28823,2021/05/06 23:00:00+00,Fri 07 May 2021,40597,15079,98,1363653,533782,657,1364310,534439,28.431897425018,11.1375822415208,273
-7.6926,53.28823,2021/11/12 00:00:00+00,Fri 12 Nov 2021,1141,1156,6,3636183,3569293,240794,3876977,3810087,80.7952828779046,79.4013111128663,274
-7.6926,53.28823,2021/08/23 23:00:00+00,Tue 24 Aug 2021,9717,22928,384,3447573,3096173,235985,3683558,3332158,76.7644767062504,69.4413838936555,275
-7.6926,53.28823,2021/05/07 23:00:00+00,Sat 08 May 2021,25628,7056,10,1389281,540838,667,1389948,541505,28.966187275699,11.2848360087769,276
-7.6926,53.28823,2021/11/13 00:00:00+00,Sat 13 Nov 2021,1396,1382,0,3637579,3570675,240794,3878373,3811469,80.8243751874276,79.4301116657035,277
-7.6926,53.28823,2021/08/24 23:00:00+00,Wed 25 Aug 2021,9420,19536,316,3456993,3115709,236301,3693294,3352010,76.9673726414337,69.8550948740643,278
-7.6926,53.28823,2021/05/08 23:00:00+00,Sun 09 May 2021,19674,929,5,1408955,541767,672,1409627,542439,29.3762929770623,11.3043003476698,279
-7.6926,53.28823,2021/11/14 00:00:00+00,Sun 14 Nov 2021,1646,1807,1,3639225,3572482,240795,3880020,3813277,80.858698277531,79.4677899576932,280
-7.6926,53.28823,2021/08/25 23:00:00+00,Thu 26 Aug 2021,8591,19446,369,3465584,3135155,236670,3702254,3371825,77.1540969203206,70.2680347832321,281
-7.6926,53.28823,2021/05/09 23:00:00+00,Mon 10 May 2021,28847,4653,171,1437802,546420,843,1438645,547263,29.9810212275913,11.4048313656776,282
-7.6926,53.28823,2021/11/15 00:00:00+00,Mon 15 Nov 2021,1239,597,1,3640464,3573079,240796,3881260,3813875,80.8845395839841,79.4802521361278,283
-7.6926,53.28823,2021/08/26 23:00:00+00,Fri 27 Aug 2021,9727,19216,432,3475311,3154371,237102,3712413,3391473,77.3658080753666,70.677494451934,284
-7.6926,53.28823,2021/05/10 23:00:00+00,Tue 11 May 2021,33930,14810,153,1471732,561230,996,1472728,562226,30.6913028790758,11.7166567434661,285
-7.6926,53.28823,2021/11/16 00:00:00+00,Tue 16 Nov 2021,1311,1076,5,3641775,3574155,240801,3882576,3814956,80.9119647124457,79.5027799202212,286
-7.6926,53.28823,2021/08/27 23:00:00+00,Sat 28 Aug 2021,9925,7931,153,3485236,3162302,237255,3722491,3399557,77.5758312095878,70.8459630981976,287
-7.6926,53.28823,2021/05/11 23:00:00+00,Wed 12 May 2021,31297,20923,173,1503029,582153,1169,1504198,583322,31.3471302291394,12.156292389381,288
-7.6926,53.28823,2021/11/17 00:00:00+00,Wed 17 Nov 2021,1495,1119,2,3643270,3575274,240803,3884073,3816077,80.9431618380588,79.5261412948453,289
-7.6926,53.28823,2021/08/28 23:00:00+00,Sun 29 Aug 2021,8800,9192,30,3494036,3171494,237285,3731321,3408779,77.7598463192497,71.0381473950608,290
-7.6926,53.28823,2021/08/29 23:00:00+00,Mon 30 Aug 2021,5067,11142,84,3499103,3182636,237369,3736472,3420005,77.8671919398464,71.2720945775144,291
-7.6926,53.28823,2021/08/30 23:00:00+00,Tue 31 Aug 2021,4070,12900,145,3503173,3195536,237514,3740687,3433050,77.9550315420237,71.5439492893536,292
-7.6926,53.28823,2021/08/31 23:00:00+00,Wed 01 Sep 2021,4970,12547,181,3508143,3208083,237695,3745838,3445778,78.0623771626204,71.8091977962367,293
-7.6926,53.28823,2021/09/01 23:00:00+00,Thu 02 Sep 2021,5011,12363,248,3513154,3220446,237943,3751097,3458389,78.1719734776501,72.0720080508173,294
-7.6926,53.28823,2021/09/02 23:00:00+00,Fri 03 Sep 2021,4778,16079,166,3517932,3236525,238109,3756041,3474634,78.2750052672502,72.4105500051162,295
-7.6926,53.28823,2021/09/03 23:00:00+00,Sat 04 Sep 2021,4630,10586,135,3522562,3247111,238244,3760806,3485355,78.3743067392252,72.6339731071191,296
-7.6926,53.28823,2021/09/04 23:00:00+00,Sun 05 Sep 2021,5309,11904,1,3527871,3259015,238245,3766116,3497260,78.4849658821816,72.8820704888321,297
-7.6926,53.28823,2021/09/05 23:00:00+00,Mon 06 Sep 2021,2164,9688,75,3530035,3268703,238320,3768355,3507023,78.53162611214,73.0855290976237,298
-7.6926,53.28823,2021/09/06 23:00:00+00,Tue 07 Sep 2021,3032,10026,160,3533067,3278729,238480,3771547,3517209,78.5981466364935,73.2978029262779,299
-7.6926,53.28823,2021/09/07 23:00:00+00,Wed 08 Sep 2021,2612,14800,191,3535679,3293529,238671,3774350,3532200,78.6565604929354,73.6102118174378,300
-7.6926,53.28823,2021/09/08 23:00:00+00,Thu 09 Sep 2021,3119,14814,138,3538798,3308343,238809,3777607,3547152,78.7244356019013,73.9218079578303,301
-7.6926,53.28823,2021/09/09 23:00:00+00,Fri 10 Sep 2021,3386,13947,116,3542184,3322290,238925,3781109,3561215,78.7974164528681,74.214877548677,302
-7.6926,53.28823,2021/09/10 23:00:00+00,Sat 11 Sep 2021,2560,11340,62,3544744,3333630,238987,3783731,3572617,78.8520583121584,74.4524925294659,303
-7.6926,53.28823,2021/09/11 23:00:00+00,Sun 12 Sep 2021,2043,12883,1,3546787,3346513,238988,3785775,3585501,78.8946547882795,74.7209920394188,304
-7.6926,53.28823,2021/09/12 23:00:00+00,Mon 13 Sep 2021,1618,7746,52,3548405,3354259,239040,3787445,3593299,78.9294571929381,74.8835005133876,305
-7.6926,53.28823,2021/09/13 23:00:00+00,Tue 14 Sep 2021,1548,10786,82,3549953,3365045,239122,3789075,3604167,78.9634260070659,75.109987060591,306
-7.6926,53.28823,2021/09/14 23:00:00+00,Wed 15 Sep 2021,3284,12370,138,3553237,3377415,239260,3792497,3616675,79.0347396769712,75.370650819555,307
-7.6926,53.28823,2021/09/15 23:00:00+00,Thu 16 Sep 2021,1917,10580,115,3555154,3387995,239375,3794529,3627370,79.077086075933,75.5935320877129,308
-7.6926,53.28823,2021/09/16 23:00:00+00,Fri 17 Sep 2021,2565,14616,94,3557719,3402611,239469,3797188,3642080,79.1324990064643,75.9000850053944,309
-7.6926,53.28823,2021/09/17 23:00:00+00,Sat 18 Sep 2021,2289,11237,47,3560008,3413848,239516,3799524,3653364,79.1811806934598,76.1352408941175,310
-7.6926,53.28823,2021/09/18 23:00:00+00,Sun 19 Sep 2021,1863,8491,16,3561871,3422339,239532,3801403,3661871,79.2203386086415,76.3125247602437,311
-7.6926,53.28823,2021/09/19 23:00:00+00,Mon 20 Sep 2021,958,5629,35,3562829,3427968,239567,3802396,3667535,79.2410324935673,76.4305611793972,312
-7.6926,53.28823,2021/09/20 23:00:00+00,Tue 21 Sep 2021,1469,6675,90,3564298,3434643,239657,3803955,3674300,79.2735216845031,76.5715421779095,313
-7.6926,53.28823,2021/09/21 23:00:00+00,Wed 22 Sep 2021,1898,8156,97,3566196,3442799,239754,3805950,3682553,79.315097012224,76.7435327441654,314
-7.6926,53.28823,2021/09/22 23:00:00+00,Thu 23 Sep 2021,1688,8729,89,3567884,3451528,239843,3807727,3691371,79.3521292715523,76.9272977766682,315
-7.6926,53.28823,2021/09/23 23:00:00+00,Fri 24 Sep 2021,1912,7391,79,3569796,3458919,239922,3809718,3698841,79.3936212402202,77.0829708082848,316
-7.6926,53.28823,2021/09/24 23:00:00+00,Sat 25 Sep 2021,2422,6605,53,3572218,3465524,239975,3812193,3705499,79.44519965431,77.2217219521273,317
-7.6926,53.28823,2021/09/25 23:00:00+00,Sun 26 Sep 2021,1549,7100,0,3573767,3472624,239975,3813742,3712599,79.4774804476131,77.3696842713345,318
-7.6926,53.28823,2021/09/26 23:00:00+00,Mon 27 Sep 2021,1175,3828,45,3574942,3476452,240020,3814962,3716472,79.5029049588008,77.4503966744739,319
-7.6926,53.28823,2021/09/27 23:00:00+00,Tue 28 Sep 2021,1451,5139,93,3576393,3481591,240113,3816506,3721704,79.5350815532876,77.5594303158954,320
-7.6926,53.28823,2021/09/28 23:00:00+00,Wed 29 Sep 2021,1650,3628,80,3578043,3485219,240193,3818236,3725412,79.5711343437423,77.6367041580955,321
-7.6926,53.28823,2021/09/29 23:00:00+00,Thu 30 Sep 2021,1277,3977,78,3579320,3489196,240271,3819591,3729467,79.5993722229713,77.7212093981497,322
-7.6926,53.28823,2021/09/30 23:00:00+00,Fri 01 Oct 2021,1860,5187,42,3581180,3494383,240313,3821493,3734696,79.6390094527082,77.8301805202814,323
-7.6926,53.28823,2021/10/01 23:00:00+00,Sat 02 Oct 2021,1681,4095,40,3582861,3498478,240353,3823214,3738831,79.6748746852935,77.9163529413971,324
-7.6926,53.28823,2021/10/02 23:00:00+00,Sun 03 Oct 2021,1196,3021,9,3584057,3501499,240362,3824419,3741861,79.6999866000322,77.9794974241011,325
-7.6926,53.28823,2021/10/03 23:00:00+00,Mon 04 Oct 2021,340,1224,18,3584397,3502723,240380,3824777,3743103,79.7074472352824,78.0053804100807,326
-7.6926,53.28823,2021/10/04 23:00:00+00,Tue 05 Oct 2021,942,2827,70,3585339,3505550,240450,3825789,3746000,79.7285370757102,78.0657532042699,327
-7.6926,53.28823,2021/10/05 23:00:00+00,Wed 06 Oct 2021,965,2577,40,3586304,3508127,240490,3826794,3748617,79.7494810377952,78.1202908647439,328
-7.6926,53.28823,2021/10/06 23:00:00+00,Thu 07 Oct 2021,1212,2704,44,3587516,3510831,240534,3828050,3751365,79.7756557804606,78.1775585342061,329
-7.6926,53.28823,2021/10/07 23:00:00+00,Fri 08 Oct 2021,908,2743,48,3588424,3513574,240582,3829006,3754156,79.7955785941454,78.2357223134888,330
-7.6926,53.28823,2021/10/08 23:00:00+00,Sat 09 Oct 2021,720,2363,23,3589144,3515937,240605,3829749,3756542,79.811062538254,78.2854459886478,331
-7.6926,53.28823,2021/10/09 23:00:00+00,Sun 10 Oct 2021,1508,3920,2,3590652,3519857,240607,3831259,3760464,79.8425305807896,78.3671795401873,332
-7.6926,53.28823,2021/10/10 23:00:00+00,Mon 11 Oct 2021,334,1133,19,3590986,3520990,240626,3831612,3761616,79.8498870172234,78.3911869474727,333
-7.6926,53.28823,2021/10/11 23:00:00+00,Tue 12 Oct 2021,562,1617,20,3591548,3522607,240646,3832194,3763253,79.8620157594458,78.4253016399435,334
-7.6926,53.28823,2021/10/12 23:00:00+00,Wed 13 Oct 2021,986,2074,11,3592534,3524681,240657,3833191,3765338,79.8827930034246,78.4687525463586,335
-7.6926,53.28823,2021/10/13 23:00:00+00,Thu 14 Oct 2021,648,1605,8,3593182,3526286,240665,3833847,3766951,79.8964638881288,78.5023670845109,336
-7.6926,53.28823,2022/06/01 23:00:00+00,Thu 02 Jun 2022,91,138,0,3848267,3799451,240944,4089211,4040395,85.218189195458,84.2008753117368,337
-7.6926,53.28823,2021/10/14 23:00:00+00,Fri 15 Oct 2021,956,2075,9,3594138,3528361,240674,3834812,3769035,79.916574259683,78.5457971511627,338
-7.6926,53.28823,2021/10/15 23:00:00+00,Sat 16 Oct 2021,1373,2642,14,3595511,3531003,240688,3836199,3771691,79.9454790113366,78.6011475624042,339
-7.6926,53.28823,2021/10/16 23:00:00+00,Sun 17 Oct 2021,1700,2892,2,3597211,3533895,240690,3837901,3774585,79.9809482884198,78.6614578373035,340
-7.6926,53.28823,2021/10/17 23:00:00+00,Mon 18 Oct 2021,675,1248,6,3597886,3535143,240696,3838582,3775839,79.9951401672058,78.6875909004424,341
-7.6926,53.28823,2021/10/18 23:00:00+00,Tue 19 Oct 2021,1335,1804,13,3599221,3536947,240709,3839930,3777656,80.0232321680919,78.7254567503015,342
-7.6926,53.28823,2021/10/19 23:00:00+00,Wed 20 Oct 2021,2250,2331,0,3601471,3539278,240709,3842180,3779987,80.0701216354463,78.7740342384807,343
-7.6926,53.28823,2021/10/20 23:00:00+00,Thu 21 Oct 2021,1724,1844,11,3603195,3541122,240720,3843915,3781842,80.1062786247173,78.812691999344,344
-7.6926,53.28823,2021/10/21 23:00:00+00,Fri 22 Oct 2021,1504,1931,3,3604699,3543053,240723,3845422,3783776,80.1376841479632,78.8529961015055,345
-7.6926,53.28823,2021/10/22 23:00:00+00,Sat 23 Oct 2021,2018,1702,1,3606717,3544755,240724,3847441,3785479,80.1797596300025,78.8884862183519,346
-7.6926,53.28823,2021/10/23 23:00:00+00,Sun 24 Oct 2021,1954,2186,2,3608671,3546941,240726,3849397,3787667,80.2205222069559,78.9340836203837,347
-7.6926,53.28823,2021/10/24 23:00:00+00,Mon 25 Oct 2021,1229,854,2,3609900,3547795,240728,3850628,3788523,80.2461759555396,78.9519224577417,348
-7.6926,53.28823,2021/10/25 23:00:00+00,Tue 26 Oct 2021,1234,1234,6,3611134,3549029,240734,3851868,3789763,80.2720172619927,78.9777637641947,349
-7.6926,53.28823,2021/10/26 23:00:00+00,Wed 27 Oct 2021,1556,1424,6,3612690,3550453,240740,3853430,3791193,80.3045689722183,79.0075646256689,350
-7.6926,53.28823,2021/10/27 23:00:00+00,Thu 28 Oct 2021,2150,1694,5,3614840,3552147,240745,3855585,3792892,80.3494786620622,79.0429713834623,351
-7.6926,53.28823,2021/10/28 23:00:00+00,Fri 29 Oct 2021,2138,1365,2,3616978,3553512,240747,3857725,3794259,80.3940757554571,79.0714593398505,352
-7.6926,53.28823,2021/10/29 23:00:00+00,Sat 30 Oct 2021,2019,1453,1,3618997,3554965,240748,3859745,3795713,80.4361720772597,79.1017603556431,353
-7.6926,53.28823,2021/10/30 23:00:00+00,Sun 31 Oct 2021,1596,1320,0,3620593,3556285,240748,3861341,3797033,80.4694323394364,79.1292688431576,354
-7.6926,53.28823,2021/11/01 00:00:00+00,Mon 01 Nov 2021,282,290,2,3620875,3556575,240750,3861625,3797325,80.4753508322047,79.1353540540321,355
-7.6926,53.28823,2021/11/02 00:00:00+00,Tue 02 Nov 2021,1099,1095,10,3621974,3557670,240760,3862734,3798430,80.4984621296696,79.1583819924439,356
-7.6926,53.28823,2021/11/03 00:00:00+00,Wed 03 Nov 2021,2534,1880,7,3624508,3559550,240767,3865275,3800317,80.5514159681352,79.1977066257318,357
-7.6926,53.28823,2021/11/04 00:00:00+00,Thu 04 Nov 2021,1532,1285,2,3626040,3560835,240769,3866809,3801604,80.5833841649892,79.2245274010585,358
-7.6926,53.28823,2021/05/12 23:00:00+00,Thu 13 May 2021,36004,25470,152,1539033,607623,1321,1540354,608944,32.1006127098799,12.6902488038497,359
-7.6926,53.28823,2022/06/02 23:00:00+00,Fri 03 Jun 2022,60,143,0,3848327,3799594,240944,4089271,4040538,85.2194395812541,84.2038553978842,360
-7.6926,53.28823,2021/05/13 23:00:00+00,Fri 14 May 2021,38225,27949,236,1577258,635572,1557,1578815,637129,32.9021308449544,13.2776175315759,361
-7.6926,53.28823,2022/06/03 23:00:00+00,Sat 04 Jun 2022,305,606,0,3848632,3800200,240944,4089576,4041144,85.2257957090511,84.216484294425,362
-7.6926,53.28823,2021/05/14 23:00:00+00,Sat 15 May 2021,28862,12455,22,1606120,648027,1579,1607699,649606,33.5040665672054,13.5376352578785,363
-7.6926,53.28823,2022/06/04 23:00:00+00,Sun 05 Jun 2022,143,273,0,3848775,3800473,240944,4089719,4041417,85.2287757951985,84.2221735497973,364
-7.6926,53.28823,2021/05/15 23:00:00+00,Sun 16 May 2021,23184,1175,10,1629304,649202,1589,1630893,650791,33.9874240364579,13.5623303773518,365
-7.6926,53.28823,2022/06/05 23:00:00+00,Mon 06 Jun 2022,4,7,1,3848779,3800480,240945,4089724,4041425,85.2288799940148,84.2223402679035,366
-7.6926,53.28823,2021/05/16 23:00:00+00,Mon 17 May 2021,35392,3953,118,1664696,653155,1707,1666403,654862,34.7274440301268,13.6471690536184,367
-7.6926,53.28823,2022/06/06 23:00:00+00,Tue 07 Jun 2022,29,50,0,3848808,3800530,240945,4089753,4041475,85.2294843471496,84.2233822560669,368
-7.6926,53.28823,2021/05/17 23:00:00+00,Tue 18 May 2021,39014,12505,128,1703710,665660,1835,1705545,667495,35.5431540439873,13.910437782991,369
-7.6926,53.28823,2022/06/07 23:00:00+00,Wed 08 Jun 2022,36,76,0,3848844,3800606,240945,4089789,4041551,85.2302345786273,84.2249660780753,370
-7.6926,53.28823,2021/05/18 23:00:00+00,Wed 19 May 2021,37028,17595,211,1740738,683255,2046,1742784,685301,36.3192059883477,14.2815106077521,371
-7.6926,53.28823,2022/06/08 23:00:00+00,Thu 09 Jun 2022,71,123,0,3848915,3800729,240945,4089860,4041674,85.2317142018194,84.2275293689574,372
-7.6926,53.28823,2021/05/19 23:00:00+00,Thu 20 May 2021,39091,19643,136,1779829,702898,2182,1782011,705080,37.136687382086,14.6937002854422,373
-7.6926,53.28823,2022/06/09 23:00:00+00,Fri 10 Jun 2022,56,108,0,3848971,3800837,240945,4089916,4041782,85.2328812285624,84.2297800633904,374
-7.6926,53.28823,2021/05/20 23:00:00+00,Fri 21 May 2021,25840,23250,14934,1805669,726148,17116,1822785,743264,37.9864078896009,15.4894458060914,375
-7.6926,53.28823,2022/06/10 23:00:00+00,Sat 11 Jun 2022,189,561,0,3849160,3801398,240945,4090105,4042343,85.2368199438202,84.2414711705841,376
-7.6926,53.28823,2021/05/21 23:00:00+00,Sat 22 May 2021,16589,10252,13523,1822258,736400,30639,1852897,767039,38.6139348411458,15.984911177803,377
-7.6926,53.28823,2022/06/11 23:00:00+00,Sun 12 Jun 2022,143,288,0,3849303,3801686,240945,4090248,4042631,85.2398000299676,84.2474730224054,378
-7.6926,53.28823,2021/05/22 23:00:00+00,Sun 23 May 2021,8219,5528,10205,1830477,741928,40844,1871321,782772,38.9978866396069,16.3127831733083,379
-7.6926,53.28823,2022/06/12 23:00:00+00,Mon 13 Jun 2022,17,44,0,3849320,3801730,240945,4090265,4042675,85.2401543059432,84.2483899719893,380
-7.6926,53.28823,2021/05/23 23:00:00+00,Mon 24 May 2021,22552,8219,8450,1853029,750147,49294,1902323,799441,39.6439609804608,16.660161187233,381
-7.6926,53.28823,2022/06/13 23:00:00+00,Tue 14 Jun 2022,37,54,0,3849357,3801784,240945,4090302,4042729,85.2409253771841,84.2495153192058,382
-7.6926,53.28823,2021/05/24 23:00:00+00,Tue 25 May 2021,30346,16506,3224,1883375,766653,52518,1935893,819171,40.3435518333886,17.0713297165229,383
-7.6926,53.28823,2022/06/14 23:00:00+00,Wed 15 Jun 2022,66,122,0,3849423,3801906,240945,4090368,4042851,85.2423008015598,84.2520577703246,384
-7.6926,53.28823,2021/05/25 23:00:00+00,Wed 26 May 2021,19981,25458,3054,1903356,792111,55572,1958928,847683,40.8235957802814,17.665513046838,385
-7.6926,53.28823,2021/05/26 23:00:00+00,Thu 27 May 2021,17018,36045,550,1920374,828156,56122,1976496,884278,41.1897087413846,18.4281441836533,386
-7.6926,53.28823,2021/11/18 00:00:00+00,Thu 18 Nov 2021,1637,2503,5,3644907,3577777,240808,3885715,3818585,80.9773807293459,79.5784074211231,387
-7.6926,53.28823,2021/05/27 23:00:00+00,Fri 28 May 2021,27046,31830,1559,1947420,859986,57681,2005101,917667,41.7858301696836,19.1239630394295,388
-7.6926,53.28823,2021/05/28 23:00:00+00,Sat 29 May 2021,24485,7389,537,1971905,867375,58218,2030123,925593,42.3072827261911,19.2891390030966,389
-7.6926,53.28823,2021/05/29 23:00:00+00,Sun 30 May 2021,24256,1681,209,1996161,869056,58427,2054588,927483,42.8171275345581,19.3285261556743,390
-7.6926,53.28823,2021/05/30 23:00:00+00,Mon 31 May 2021,22591,7308,3444,2018752,876364,61871,2080623,938235,43.3596907712567,19.5525952903385,391
-7.6926,53.28823,2021/05/31 23:00:00+00,Tue 01 Jun 2021,27585,11517,3653,2046337,887881,65524,2111861,953405,44.010683296242,19.8687344991236,392
-7.6926,53.28823,2021/06/01 23:00:00+00,Wed 02 Jun 2021,18704,20908,4008,2065041,908789,69532,2134573,978321,44.483995999599,20.3879780407247,393
-7.6926,53.28823,2021/06/02 23:00:00+00,Thu 03 Jun 2021,16695,30704,1978,2081736,939493,71510,2153246,1011003,44.8731368991141,21.0690631838699,394
-7.6926,53.28823,2021/06/03 23:00:00+00,Fri 04 Jun 2021,28987,23340,153,2110723,962833,71663,2182386,1034496,45.4804076007618,21.5586517423397,395
-7.6926,53.28823,2021/06/04 23:00:00+00,Sat 05 Jun 2021,20969,11494,33,2131692,974327,71696,2203388,1046023,45.9180843089295,21.7988716935371,396
-7.6926,53.28823,2021/06/05 23:00:00+00,Sun 06 Jun 2021,19947,3915,47,2151639,978242,71743,2223382,1049985,46.3347545357224,21.8814388356074,397
-7.6926,53.28823,2021/06/06 23:00:00+00,Mon 07 Jun 2021,19824,4597,45,2171463,982839,71788,2243251,1054627,46.7488197921067,21.9781770167004,398
-7.6926,53.28823,2021/06/07 23:00:00+00,Tue 08 Jun 2021,26415,18348,45,2197878,1001187,71833,2269711,1073020,47.3002399281945,22.3614827825002,399
-7.6926,53.28823,2021/06/08 23:00:00+00,Wed 09 Jun 2021,32807,20120,174,2230685,1021307,72007,2302692,1093314,47.987556160557,22.7844049382737,400
-7.6926,53.28823,2021/06/09 23:00:00+00,Thu 10 Jun 2021,27704,27497,273,2258389,1048804,72280,2330669,1121084,48.5705902175234,23.3631251642434,401
-7.6926,53.28823,2021/06/10 23:00:00+00,Fri 11 Jun 2021,26443,32907,42,2284832,1081711,72322,2357154,1154033,49.1225313476929,24.0497745241813,402
-7.6926,53.28823,2021/06/11 23:00:00+00,Sat 12 Jun 2021,12219,19721,105,2297051,1101432,72427,2369478,1173859,49.3793605902154,24.4629436707451,403
-7.6926,53.28823,2021/06/12 23:00:00+00,Sun 13 Jun 2021,8553,18175,834,2305604,1119607,73261,2378865,1192868,49.574983448018,24.8590867307184,404
-7.6926,53.28823,2021/06/13 23:00:00+00,Mon 14 Jun 2021,16022,31308,52,2321626,1150915,73313,2394939,1224228,49.9099618027979,25.5126217068225,405
-7.6926,53.28823,2021/06/14 23:00:00+00,Tue 15 Jun 2021,14704,41592,205,2336330,1192507,73518,2409848,1266025,50.2206618333698,26.3836612921612,406
-7.6926,53.28823,2021/06/15 23:00:00+00,Wed 16 Jun 2021,13475,48391,217,2349805,1240898,73735,2423540,1314633,50.5059998720439,27.3966405051225,407
-7.6926,53.28823,2021/06/16 23:00:00+00,Thu 17 Jun 2021,21573,42690,535,2371378,1283588,74270,2445648,1357858,50.9667253583866,28.2974392724088,408
-7.6926,53.28823,2021/06/17 23:00:00+00,Fri 18 Jun 2021,12021,50020,554,2383399,1333608,74824,2458223,1408432,51.2287853814896,29.3513894599563,409
-7.6926,53.28823,2021/06/18 23:00:00+00,Sat 19 Jun 2021,6326,32810,433,2389725,1366418,75257,2464982,1441675,51.3696413414222,30.0441657102952,410
-7.6926,53.28823,2021/06/19 23:00:00+00,Sun 20 Jun 2021,8519,26143,177,2398244,1392561,75434,2473678,1467995,51.5508639228062,30.5926682795254,411
-7.6926,53.28823,2021/06/20 23:00:00+00,Mon 21 Jun 2021,15484,32336,574,2413728,1424897,76008,2489736,1500905,51.8855088413738,31.2785048886959,412
-7.6926,53.28823,2021/06/21 23:00:00+00,Tue 22 Jun 2021,15150,43546,722,2428878,1468443,76730,2505608,1545173,52.2162775639734,32.2010395290714,413
-7.6926,53.28823,2021/06/22 23:00:00+00,Wed 23 Jun 2021,20093,39397,883,2448971,1507840,77613,2526584,1585453,52.6534124382961,33.0404651935316,414
-7.6926,53.28823,2021/06/23 23:00:00+00,Thu 24 Jun 2021,19024,44278,1032,2467995,1552118,78645,2546640,1630763,53.0713747304116,33.984714867233,415
-7.6926,53.28823,2021/06/24 23:00:00+00,Fri 25 Jun 2021,15212,50125,843,2483207,1602243,79488,2562695,1681731,53.4059571296894,35.0468759215083,416
-7.6926,53.28823,2021/06/25 23:00:00+00,Sat 26 Jun 2021,9068,30566,511,2492275,1632809,79999,2572274,1712808,53.6055812220396,35.6945132446073,417
-7.6926,53.28823,2021/06/26 23:00:00+00,Sun 27 Jun 2021,8736,30478,59,2501011,1663287,80058,2581069,1743345,53.7888669399871,36.3308970955414,418
-7.6926,53.28823,2021/06/27 23:00:00+00,Mon 28 Jun 2021,24239,24653,524,2525250,1687940,80582,2605832,1768522,54.3049219978081,36.8555798153555,419
-7.6926,53.28823,2021/06/28 23:00:00+00,Tue 29 Jun 2021,28147,31048,811,2553397,1718988,81393,2634790,1800381,54.9083998625409,37.5195138333307,420
-7.6926,53.28823,2021/06/29 23:00:00+00,Wed 30 Jun 2021,22578,36870,590,2575975,1755858,81983,2657958,1837841,55.3912154979484,38.3001713653734,421
-7.6926,53.28823,2021/06/30 23:00:00+00,Thu 01 Jul 2021,15032,48307,642,2591007,1804165,82625,2673632,1886790,55.7178579474209,39.3202569376093,422
-7.6926,53.28823,2021/07/01 23:00:00+00,Fri 02 Jul 2021,13691,47271,818,2604698,1851436,83443,2688141,1934879,56.0202220726853,40.3224203134342,423
-7.6926,53.28823,2021/07/02 23:00:00+00,Sat 03 Jul 2021,9317,30480,505,2614015,1881916,83948,2697963,1965864,56.2249102275098,40.9681403783126,424
-7.6926,53.28823,2021/07/03 23:00:00+00,Sun 04 Jul 2021,6457,27784,233,2620472,1909700,84181,2704653,1993881,56.3643282437769,41.5520080258096,425
-7.6926,53.28823,2021/07/04 23:00:00+00,Mon 05 Jul 2021,15619,33468,5343,2636091,1943168,89524,2725615,2032692,56.8011713614138,42.3608200780282,426
-7.6926,53.28823,2021/07/05 23:00:00+00,Tue 06 Jul 2021,12415,48303,5487,2648506,1991471,95011,2743517,2086482,57.1742448034487,43.4817909442476,427
-7.6926,53.28823,2021/07/06 23:00:00+00,Wed 07 Jul 2021,19711,43763,5060,2668217,2035234,100071,2768288,2135305,57.6904665793758,44.4992507063117,428
-7.6926,53.28823,2021/07/07 23:00:00+00,Thu 08 Jul 2021,17787,45599,5998,2686004,2080833,106069,2792073,2186902,58.1861403487201,45.5745199716829,429
-7.6926,53.28823,2021/07/08 23:00:00+00,Fri 09 Jul 2021,13532,45093,6531,2699536,2125926,112600,2812136,2238526,58.6042485191785,46.6503519106624,430
-7.6926,53.28823,2021/07/09 23:00:00+00,Sat 10 Jul 2021,8639,23875,4364,2708175,2149801,116964,2825139,2266765,58.8752279609605,47.2388459856051,431
-7.6926,53.28823,2021/07/10 23:00:00+00,Sun 11 Jul 2021,15240,16114,2153,2723415,2165915,119117,2842532,2285032,59.2376939634917,47.6195259412331,432
-7.6926,53.28823,2021/07/11 23:00:00+00,Mon 12 Jul 2021,17112,31774,6092,2740527,2197689,125209,2865736,2322898,59.7212598303768,48.4086444171629,433
-7.6926,53.28823,2021/07/12 23:00:00+00,Tue 13 Jul 2021,20112,36569,8491,2760639,2234258,133700,2894339,2367958,60.3173395791493,49.3476841500471,434
-7.6926,53.28823,2021/07/13 23:00:00+00,Wed 14 Jul 2021,20802,35713,9335,2781441,2269971,143035,2924476,2413006,60.9453875247759,50.2864738057722,435
-7.6926,53.28823,2021/07/14 23:00:00+00,Thu 15 Jul 2021,23655,28835,9586,2805096,2298806,152621,2957717,2451427,61.6381220955882,51.087158350316,436
-7.6926,53.28823,2021/07/15 23:00:00+00,Fri 16 Jul 2021,23530,27431,9167,2828626,2326237,161788,2990414,2488025,62.3195198351825,51.8498520064212,437
-7.6926,53.28823,2021/07/16 23:00:00+00,Sat 17 Jul 2021,11509,19432,4677,2840135,2345669,166465,3006600,2512134,62.6568322434484,52.3522778590644,438
-7.6926,53.28823,2021/07/17 23:00:00+00,Sun 18 Jul 2021,16865,15818,1932,2857000,2361487,168397,3025397,2529884,63.0485572736088,52.7221836570825,439
-7.6926,53.28823,2021/07/18 23:00:00+00,Mon 19 Jul 2021,24895,18442,6255,2881895,2379929,174652,3056547,2554581,63.6977158994265,53.2368632905278,440
-7.6926,53.28823,2021/07/19 23:00:00+00,Tue 20 Jul 2021,30589,18186,7699,2912484,2398115,182351,3094835,2580466,64.4956287554556,53.7763005627361,441
-7.6926,53.28823,2021/07/20 23:00:00+00,Wed 21 Jul 2021,30369,19844,6890,2942853,2417959,189241,3132094,2607200,65.2720974950813,54.3334307939596,442
-7.6926,53.28823,2021/07/21 23:00:00+00,Thu 22 Jul 2021,33543,15934,6934,2976396,2433893,196175,3172571,2630068,66.1156285929054,54.8099945003865,443
-7.6926,53.28823,2021/07/22 23:00:00+00,Fri 23 Jul 2021,27094,20839,5615,3003490,2454732,201790,3205280,2656522,66.7972764096589,55.3612895978947,444
-7.6926,53.28823,2021/11/19 00:00:00+00,Fri 19 Nov 2021,1160,1555,0,3646067,3579332,240808,3886875,3820140,81.0015548547375,79.6108132530058,445
-7.6926,53.28823,2021/11/20 00:00:00+00,Sat 20 Nov 2021,1544,2943,12,3647611,3582275,240820,3888431,3823095,81.0339815263835,79.6723947534646,446
-7.6926,53.28823,2022/06/15 23:00:00+00,Thu 16 Jun 2022,42,87,0,3849465,3801993,240945,4090410,4042938,85.2431760716171,84.2538708297289,447
-7.6926,53.28823,2021/11/21 00:00:00+00,Sun 21 Nov 2021,1787,2767,0,3649398,3585042,240820,3890218,3825862,81.0712221833445,79.7300583784289,448
-7.6926,53.28823,2022/06/16 23:00:00+00,Fri 17 Jun 2022,57,95,0,3849522,3802088,240945,4090467,4043033,85.2443639381234,84.2558506072395,449
-7.6926,53.28823,2021/11/22 00:00:00+00,Mon 22 Nov 2021,720,519,3,3650118,3585561,240823,3890941,3826384,81.0862893321877,79.7409367348551,450
-7.6926,53.28823,2022/06/17 23:00:00+00,Sat 18 Jun 2022,223,487,0,3849745,3802575,240945,4090690,4043520,85.2490112053323,84.2659995719513,451
-7.6926,53.28823,2021/11/23 00:00:00+00,Tue 23 Nov 2021,2152,1596,8,3652270,3587157,240831,3893101,3827988,81.1313032208479,79.7743637151379,452
-7.6926,53.28823,2022/06/18 23:00:00+00,Sun 19 Jun 2022,80,129,0,3849825,3802704,240945,4090770,4043649,85.2506783863938,84.2686879014129,453
-7.6926,53.28823,2021/11/24 00:00:00+00,Wed 24 Nov 2021,1606,3149,2,3653876,3590306,240833,3894709,3831139,81.1648135601839,79.8400298091974,454
-7.6926,53.28823,2022/06/19 23:00:00+00,Mon 20 Jun 2022,8,27,0,3849833,3802731,240945,4090778,4043676,85.2508451044999,84.2692505750212,455
-7.6926,53.28823,2021/11/25 00:00:00+00,Thu 25 Nov 2021,974,1186,1,3654850,3591492,240834,3895684,3832326,81.1851323293708,79.8647666081972,456
-7.6926,53.28823,2022/06/20 23:00:00+00,Tue 21 Jun 2022,73,168,1,3849906,3802899,240946,4090852,4043845,85.2523872469818,84.2727724950136,457
-7.6926,53.28823,2021/11/26 00:00:00+00,Fri 26 Nov 2021,1279,1108,12,3656129,3592600,240846,3896975,3833446,81.2120364637506,79.8881071430581,458
-7.6926,53.28823,2022/06/21 23:00:00+00,Wed 22 Jun 2022,60,95,0,3849966,3802994,240946,4090912,4043940,85.253637632778,84.2747522725241,459
-7.6926,53.28823,2021/11/27 00:00:00+00,Sat 27 Nov 2021,1198,1564,6,3657327,3594164,240852,3898179,3835016,81.237127538726,79.9208255713898,460
-7.6926,53.28823,2022/06/22 23:00:00+00,Thu 23 Jun 2022,64,114,0,3850030,3803108,240946,4090976,4044054,85.2549713776271,84.2771280055367,461
-7.6926,53.28823,2021/11/28 00:00:00+00,Sun 28 Nov 2021,1950,2258,1,3659277,3596422,240853,3900130,3837275,81.2777859168631,79.9679025966137,462
-7.6926,53.28823,2022/06/23 23:00:00+00,Fri 24 Jun 2022,56,92,1,3850086,3803200,240947,4091033,4044147,85.2561592441334,84.2790661035207,463
-7.6926,53.28823,2021/11/29 00:00:00+00,Mon 29 Nov 2021,532,993,1,3659809,3597415,240854,3900663,3838269,81.2888935106853,79.9886173213027,464
-7.6926,53.28823,2022/06/24 23:00:00+00,Sat 25 Jun 2022,210,291,0,3850296,3803491,240947,4091243,4044438,85.2605355944199,84.2851304746319,465
-7.6926,53.28823,2021/11/30 00:00:00+00,Tue 30 Nov 2021,1888,1647,6,3661697,3599062,240860,3902557,3839922,81.3283640223161,80.0230654499857,466
-7.6926,53.28823,2022/06/25 23:00:00+00,Sun 26 Jun 2022,174,403,0,3850470,3803894,240947,4091417,4044841,85.2641617132286,84.2935288992291,467
-7.6926,53.28823,2021/12/01 00:00:00+00,Wed 01 Dec 2021,1029,1386,4,3662726,3600448,240864,3903590,3841312,81.3498914977725,80.0520327209291,468
-7.6926,53.28823,2022/06/26 23:00:00+00,Mon 27 Jun 2022,4,33,0,3850474,3803927,240947,4091421,4044874,85.2642450722817,84.294216611417,469
-7.6926,53.28823,2021/12/02 00:00:00+00,Thu 02 Dec 2021,1727,1411,0,3664453,3601859,240864,3905317,3842723,81.3858817689375,80.0814376269011,470
-7.6926,53.28823,2022/06/27 23:00:00+00,Tue 28 Jun 2022,47,60,0,3850521,3803987,240947,4091468,4044934,85.2652245411553,84.2954669972131,471
-7.6926,53.28823,2021/12/03 00:00:00+00,Fri 03 Dec 2021,1006,1189,2,3665459,3603048,240866,3906325,3843914,81.4068882503122,80.1062577849541,472
-7.6926,53.28823,2022/06/28 23:00:00+00,Wed 29 Jun 2022,63,81,3,3850584,3804068,240950,4091534,4045018,85.266599965531,84.2972175373277,473
-7.6926,53.28823,2021/12/04 00:00:00+00,Sat 04 Dec 2021,1201,1700,1,3666660,3604748,240867,3907527,3845615,81.4319376457611,80.141706222274,474
-7.6926,53.28823,2022/06/29 23:00:00+00,Thu 30 Jun 2022,49,86,0,3850633,3804154,240950,4091583,4045104,85.2676211139312,84.2990097569688,475
-7.6926,53.28823,2021/12/05 00:00:00+00,Sun 05 Dec 2021,1347,1776,2,3668007,3606524,240869,3908876,3847393,81.4600504864105,80.1787593213656,476
-7.6926,53.28823,2022/06/30 23:00:00+00,Fri 01 Jul 2022,46,62,0,3850679,3804216,240950,4091629,4045166,85.2685797430416,84.3003018222914,477
-7.6926,53.28823,2021/12/06 00:00:00+00,Mon 06 Dec 2021,930,1299,0,3668937,3607823,240869,3909806,3848692,81.4794314662503,80.2058301738516,478
-7.6926,53.28823,2022/07/01 23:00:00+00,Sat 02 Jul 2022,182,228,0,3850861,3804444,240950,4091811,4045394,85.2723725799564,84.3050532883167,479
-7.6926,53.28823,2021/12/07 00:00:00+00,Tue 07 Dec 2021,483,743,2,3669420,3608566,240871,3910291,3849437,81.4895387514356,80.2213557974867,480
-7.6926,53.28823,2022/07/02 23:00:00+00,Sun 03 Jul 2022,108,273,0,3850969,3804717,240950,4091919,4045667,85.2746232743895,84.310742543689,481
-7.6926,53.28823,2022/07/03 23:00:00+00,Mon 04 Jul 2022,13,15,0,3850982,3804732,240950,4091932,4045682,85.2748941913119,84.311055140138,482
-7.6926,53.28823,2022/07/04 23:00:00+00,Tue 05 Jul 2022,51,69,0,3851033,3804801,240950,4091983,4045751,85.2759570192386,84.3124930838036,483
-7.6926,53.28823,2022/07/05 23:00:00+00,Wed 06 Jul 2022,61,83,0,3851094,3804884,240950,4092044,4045834,85.277228244798,84.3142227841549,484
-7.6926,53.28823,2022/07/06 23:00:00+00,Thu 07 Jul 2022,77,75,0,3851171,3804959,240950,4092121,4045909,85.2788329065697,84.3157857664,485
-7.6926,53.28823,2022/07/07 23:00:00+00,Fri 08 Jul 2022,99,89,0,3851270,3805048,240950,4092220,4045998,85.2808960431333,84.3176405053309,486
-7.6926,53.28823,2022/07/08 23:00:00+00,Sat 09 Jul 2022,119,143,0,3851389,3805191,240950,4092339,4046141,85.2833759749623,84.3206205914783,487
-7.6926,53.28823,2022/07/09 23:00:00+00,Sun 10 Jul 2022,131,219,0,3851520,3805410,240950,4092470,4046360,85.2861059839505,84.3251844996341,488
-7.6926,53.28823,2022/07/10 23:00:00+00,Mon 11 Jul 2022,11,16,0,3851531,3805426,240950,4092481,4046376,85.2863352213464,84.3255179358465,489
-7.6926,53.28823,2022/07/11 23:00:00+00,Tue 12 Jul 2022,43,80,0,3851574,3805506,240950,4092524,4046456,85.287231331167,84.3271851169079,490
-7.6926,53.28823,2022/07/12 23:00:00+00,Wed 13 Jul 2022,99,73,0,3851673,3805579,240950,4092623,4046529,85.2892944677306,84.3287064196266,491
-7.6926,53.28823,2022/07/13 23:00:00+00,Thu 14 Jul 2022,70,39,0,3851743,3805618,240950,4092693,4046568,85.2907532511594,84.329519170394,492
-7.6926,53.28823,2022/07/14 23:00:00+00,Fri 15 Jul 2022,79,117,1,3851822,3805735,240951,4092773,4046686,85.2924204322209,84.3319782624597,493
-7.6926,53.28823,2022/07/15 23:00:00+00,Sat 16 Jul 2022,124,209,0,3851946,3805944,240951,4092897,4046895,85.2950045628662,84.3363337729829,494
-7.6926,53.28823,2022/07/16 23:00:00+00,Sun 17 Jul 2022,119,165,0,3852065,3806109,240951,4093016,4047060,85.2974844946951,84.3397723339222,495
-7.6926,53.28823,2022/07/17 23:00:00+00,Mon 18 Jul 2022,14,17,0,3852079,3806126,240951,4093030,4047077,85.2977762513809,84.3401266098978,496
-7.6926,53.28823,2022/07/18 23:00:00+00,Tue 19 Jul 2022,29,33,0,3852108,3806159,240951,4093059,4047110,85.2983806045157,84.3408143220856,497
-7.6926,53.28823,2022/07/19 23:00:00+00,Wed 20 Jul 2022,78,66,0,3852186,3806225,240951,4093137,4047176,85.3000061060506,84.3421897464614,498
-7.6926,53.28823,2022/07/20 23:00:00+00,Thu 21 Jul 2022,51,30,0,3852237,3806255,240951,4093188,4047206,85.3010689339773,84.3428149393594,499
-7.6926,53.28823,2022/07/21 23:00:00+00,Fri 22 Jul 2022,73,70,0,3852310,3806325,240951,4093261,4047276,85.3025902366959,84.3442737227882,500
-7.6926,53.28823,2022/07/22 23:00:00+00,Sat 23 Jul 2022,97,175,0,3852407,3806500,240951,4093358,4047451,85.304611693733,84.3479206813602,501
-7.6926,53.28823,2022/07/23 23:00:00+00,Sun 24 Jul 2022,107,232,0,3852514,3806732,240951,4093465,4047683,85.3068415484027,84.3527555064385,502
-7.6926,53.28823,2022/07/24 23:00:00+00,Mon 25 Jul 2022,13,23,0,3852527,3806755,240951,4093478,4047706,85.3071124653252,84.3532348209937,503
-7.6926,53.28823,2022/07/25 23:00:00+00,Tue 26 Jul 2022,18,16,0,3852545,3806771,240951,4093496,4047722,85.3074875810641,84.353568257206,504
-7.6926,53.28823,2022/07/26 23:00:00+00,Wed 27 Jul 2022,61,72,1,3852606,3806843,240952,4093558,4047795,85.3087796463867,84.3550895599246,505
-7.6926,53.28823,2022/07/27 23:00:00+00,Thu 28 Jul 2022,48,71,0,3852654,3806914,240952,4093606,4047866,85.3097799550236,84.3565691831167,506
-7.6926,53.28823,2022/07/28 23:00:00+00,Fri 29 Jul 2022,70,105,0,3852724,3807019,240952,4093676,4047971,85.3112387384524,84.3587573582599,507
-7.6926,53.28823,2022/07/29 23:00:00+00,Sat 30 Jul 2022,100,118,0,3852824,3807137,240952,4093776,4048089,85.3133227147793,84.3612164503256,508
-7.6926,53.28823,2022/07/30 23:00:00+00,Sun 31 Jul 2022,32,57,0,3852856,3807194,240952,4093808,4048146,85.3139895872039,84.3624043168319,509
-7.6926,53.28823,2022/07/31 23:00:00+00,Mon 01 Aug 2022,9,14,0,3852865,3807208,240952,4093817,4048160,85.3141771450733,84.3626960735177,510
-7.6926,53.28823,2022/08/01 23:00:00+00,Tue 02 Aug 2022,36,28,0,3852901,3807236,240952,4093853,4048188,85.314927376551,84.3632795868892,511
-7.6926,53.28823,2022/08/02 23:00:00+00,Wed 03 Aug 2022,93,139,0,3852994,3807375,240952,4093946,4048327,85.3168654745349,84.3661763139835,512
-7.6926,53.28823,2022/08/03 23:00:00+00,Thu 04 Aug 2022,45,51,0,3853039,3807426,240952,4093991,4048378,85.317803263882,84.3672391419102,513
-7.6926,53.28823,2022/08/04 23:00:00+00,Fri 05 Aug 2022,96,91,0,3853135,3807517,240952,4094087,4048469,85.3198038811558,84.3691355603677,514
-7.6926,53.28823,2022/08/05 23:00:00+00,Sat 06 Aug 2022,72,130,0,3853207,3807647,240952,4094159,4048599,85.3213043441112,84.3718447295926,515
-7.6926,53.28823,2022/08/06 23:00:00+00,Sun 07 Aug 2022,28,80,0,3853235,3807727,240952,4094187,4048679,85.3218878574827,84.3735119106541,516
-7.6926,53.28823,2022/08/07 23:00:00+00,Mon 08 Aug 2022,10,16,0,3853245,3807743,240952,4094197,4048695,85.3220962551154,84.3738453468664,517
-7.6926,53.28823,2022/08/08 23:00:00+00,Tue 09 Aug 2022,47,42,0,3853292,3807785,240952,4094244,4048737,85.323075723989,84.3747206169237,518
-7.6926,53.28823,2022/08/09 23:00:00+00,Wed 10 Aug 2022,54,94,0,3853346,3807879,240952,4094298,4048831,85.3242010712055,84.3766795546709,519
-7.6926,53.28823,2022/08/10 23:00:00+00,Thu 11 Aug 2022,46,38,0,3853392,3807917,240952,4094344,4048869,85.3251597003159,84.3774714656751,520
-7.6926,53.28823,2022/08/11 23:00:00+00,Fri 12 Aug 2022,70,75,0,3853462,3807992,240952,4094414,4048944,85.3266184837447,84.3790344479203,521
-7.6926,53.28823,2022/08/12 23:00:00+00,Sat 13 Aug 2022,102,151,0,3853564,3808143,240952,4094516,4049095,85.3287441395981,84.3821812521739,522
-7.6926,53.28823,2022/08/13 23:00:00+00,Sun 14 Aug 2022,18,26,0,3853582,3808169,240952,4094534,4049121,85.3291192553369,84.3827230860188,523
-7.6926,53.28823,2022/08/14 23:00:00+00,Mon 15 Aug 2022,7,11,0,3853589,3808180,240952,4094541,4049132,85.3292651336798,84.3829523234148,524
-7.6926,53.28823,2022/08/15 23:00:00+00,Tue 16 Aug 2022,40,28,0,3853629,3808208,240952,4094581,4049160,85.3300987242105,84.3835358367863,525
-7.6926,53.28823,2022/08/16 23:00:00+00,Wed 17 Aug 2022,50,57,0,3853679,3808265,240952,4094631,4049217,85.331140712374,84.3847237032926,526
-7.6926,53.28823,2022/08/17 23:00:00+00,Thu 18 Aug 2022,56,38,0,3853735,3808303,240952,4094687,4049255,85.332307739117,84.3855156142968,527
-7.6926,53.28823,2022/08/18 23:00:00+00,Fri 19 Aug 2022,70,57,0,3853805,3808360,240952,4094757,4049312,85.3337665225458,84.3867034808031,528
-7.6926,53.28823,2022/08/19 23:00:00+00,Sat 20 Aug 2022,108,127,0,3853913,3808487,240952,4094865,4049439,85.3360172169788,84.3893501307383,529
-7.6926,53.28823,2022/08/20 23:00:00+00,Sun 21 Aug 2022,38,36,0,3853951,3808523,240952,4094903,4049475,85.336809127983,84.3901003622159,530
-7.6926,53.28823,2022/08/21 23:00:00+00,Mon 22 Aug 2022,12,13,0,3853963,3808536,240952,4094915,4049488,85.3370592051423,84.3903712791384,531
-7.6926,53.28823,2022/08/22 23:00:00+00,Tue 23 Aug 2022,77,71,0,3854040,3808607,240952,4094992,4049559,85.3386638669139,84.3918509023305,532
-7.6926,53.28823,2022/08/23 23:00:00+00,Wed 24 Aug 2022,54,54,0,3854094,3808661,240952,4095046,4049613,85.3397892141304,84.392976249547,533
-7.6926,53.28823,2022/08/24 23:00:00+00,Thu 25 Aug 2022,39,47,0,3854133,3808708,240952,4095085,4049660,85.3406019648979,84.3939557184206,534
-7.6926,53.28823,2022/08/25 23:00:00+00,Fri 26 Aug 2022,94,87,0,3854227,3808795,240952,4095179,4049747,85.3425609026452,84.395768777825,535
-7.6926,53.28823,2022/08/26 23:00:00+00,Sat 27 Aug 2022,86,119,0,3854313,3808914,240952,4095265,4049866,85.3443531222863,84.398248709654,536
-7.6926,53.28823,2022/08/27 23:00:00+00,Sun 28 Aug 2022,44,20,0,3854357,3808934,240952,4095309,4049886,85.3452700718701,84.3986655049193,537
-7.6926,53.28823,2022/08/28 23:00:00+00,Mon 29 Aug 2022,12,12,0,3854369,3808946,240952,4095321,4049898,85.3455201490293,84.3989155820785,538
-7.6926,53.28823,2022/08/29 23:00:00+00,Tue 30 Aug 2022,38,44,0,3854407,3808990,240952,4095359,4049942,85.3463120600335,84.3998325316624,539
-7.6926,53.28823,2022/08/30 23:00:00+00,Wed 31 Aug 2022,28,28,0,3854435,3809018,240952,4095387,4049970,85.346895573405,84.4004160450339,540
-7.6926,53.28823,2022/08/31 23:00:00+00,Thu 01 Sep 2022,29,27,0,3854464,3809045,240952,4095416,4049997,85.3474999265398,84.4009787186422,541
-7.6926,53.28823,2022/09/01 23:00:00+00,Fri 02 Sep 2022,48,44,0,3854512,3809089,240952,4095464,4050041,85.3485002351767,84.401895668226,542
-7.6926,53.28823,2022/09/02 23:00:00+00,Sat 03 Sep 2022,73,100,0,3854585,3809189,240952,4095537,4050141,85.3500215378953,84.4039796445528,543
-7.6926,53.28823,2022/09/03 23:00:00+00,Sun 04 Sep 2022,58,82,0,3854643,3809271,240952,4095595,4050223,85.3512302441649,84.4056885051409,544
-7.6926,53.28823,2022/09/04 23:00:00+00,Mon 05 Sep 2022,5,4,0,3854648,3809275,240952,4095600,4050227,85.3513344429813,84.4057718641939,545
-7.6926,53.28823,2022/09/05 23:00:00+00,Tue 06 Sep 2022,38,21,0,3854686,3809296,240952,4095638,4050248,85.3521263539855,84.4062094992226,546
-7.6926,53.28823,2022/09/06 23:00:00+00,Wed 07 Sep 2022,46,41,0,3854732,3809337,240952,4095684,4050289,85.3530849830958,84.4070639295166,547
-7.6926,53.28823,2022/09/07 23:00:00+00,Thu 08 Sep 2022,37,39,2,3854769,3809376,240954,4095723,4050330,85.3538977338633,84.4079183598106,548
-7.6926,53.28823,2022/09/08 23:00:00+00,Fri 09 Sep 2022,60,56,0,3854829,3809432,240954,4095783,4050386,85.3551481196594,84.4090853865536,549
-7.6926,53.28823,2022/09/09 23:00:00+00,Sat 10 Sep 2022,93,135,0,3854922,3809567,240954,4095876,4050521,85.3570862176434,84.4118987545949,550
-7.6926,53.28823,2022/09/10 23:00:00+00,Sun 11 Sep 2022,57,58,0,3854979,3809625,240954,4095933,4050579,85.3582740841497,84.4131074608645,551
-7.6926,53.28823,2022/09/11 23:00:00+00,Mon 12 Sep 2022,10,11,0,3854989,3809636,240954,4095943,4050590,85.3584824817824,84.4133366982604,552
-7.6926,53.28823,2021/12/08 00:00:00+00,Wed 08 Dec 2021,782,1523,2,3670202,3610089,240873,3911075,3850962,81.5058771258382,80.2531364364713,553
-7.6926,53.28823,2021/12/09 00:00:00+00,Thu 09 Dec 2021,784,1209,1,3670986,3611298,240874,3911860,3852172,81.5222363400041,80.2783525500264,554
-7.6926,53.28823,2021/12/10 00:00:00+00,Fri 10 Dec 2021,887,1614,1,3671873,3612912,240875,3912748,3853787,81.5407420497866,80.3120087677052,555
-7.6926,53.28823,2021/12/11 00:00:00+00,Sat 11 Dec 2021,639,842,2,3672512,3613754,240877,3913389,3854631,81.5541003380418,80.3295975279039,556
-7.6926,53.28823,2021/12/12 00:00:00+00,Sun 12 Dec 2021,686,1193,0,3673198,3614947,240877,3914075,3855824,81.5683964156441,80.3544593654834,557
-7.6926,53.28823,2021/12/13 00:00:00+00,Mon 13 Dec 2021,719,1069,1,3673917,3616016,240878,3914795,3856894,81.5834010451975,80.3767579121808,558
-7.6926,53.28823,2021/12/14 00:00:00+00,Tue 14 Dec 2021,626,1202,3,3674543,3617218,240881,3915424,3858099,81.5965092562934,80.4018698269195,559
-7.6926,53.28823,2021/12/15 00:00:00+00,Wed 15 Dec 2021,789,1259,1,3675332,3618477,240882,3916214,3859359,81.6129726692757,80.428127928638,560
-7.6926,53.28823,2021/12/16 00:00:00+00,Thu 16 Dec 2021,1042,1543,7,3676374,3620020,240889,3917263,3860909,81.6348335809445,80.4604295617043,561
-7.6926,53.28823,2021/12/17 00:00:00+00,Fri 17 Dec 2021,1196,2460,1,3677570,3622480,240890,3918460,3863370,81.659778777577,80.5117162191084,562
-7.6926,53.28823,2021/12/18 00:00:00+00,Sat 18 Dec 2021,1247,1183,0,3678817,3623663,240890,3919707,3864553,81.685765962373,80.5363696590552,563
-7.6926,53.28823,2021/12/19 00:00:00+00,Sun 19 Dec 2021,544,887,1,3679361,3624550,240891,3920252,3865441,81.6971236333544,80.5548753688378,564
-7.6926,53.28823,2021/12/20 00:00:00+00,Mon 20 Dec 2021,506,616,1,3679867,3625166,240892,3920759,3866058,81.7076893933316,80.5677335027745,565
-7.6926,53.28823,2021/12/21 00:00:00+00,Tue 21 Dec 2021,1398,1817,3,3681265,3626983,240895,3922160,3867878,81.7368859016709,80.6056618719234,566
-7.6926,53.28823,2021/12/22 00:00:00+00,Wed 22 Dec 2021,1155,1596,2,3682420,3628579,240897,3923317,3869476,81.7609975077727,80.6389638136267,567
-7.6926,53.28823,2021/12/23 00:00:00+00,Thu 23 Dec 2021,923,1395,0,3683343,3629974,240897,3924240,3870871,81.7802326092697,80.6680352833864,568
-7.6926,53.28823,2021/12/24 00:00:00+00,Fri 24 Dec 2021,102,157,0,3683445,3630131,240897,3924342,3871028,81.7823582651231,80.6713071262196,569
-7.6926,53.28823,2021/12/25 00:00:00+00,Sat 25 Dec 2021,1,6,0,3683446,3630137,240897,3924343,3871034,81.7823791048863,80.6714321647992,570
-7.6926,53.28823,2021/12/26 00:00:00+00,Sun 26 Dec 2021,12,11,0,3683458,3630148,240897,3924355,3871045,81.7826291820455,80.6716614021951,571
-7.6926,53.28823,2021/12/27 00:00:00+00,Mon 27 Dec 2021,389,589,0,3683847,3630737,240897,3924744,3871634,81.790735849957,80.6839360227604,572
-7.6926,53.28823,2021/12/28 00:00:00+00,Tue 28 Dec 2021,466,747,0,3684313,3631484,240897,3925210,3872381,81.8004471796402,80.699503325922,573
-7.6926,53.28823,2021/12/29 00:00:00+00,Wed 29 Dec 2021,1057,1309,0,3685370,3632793,240897,3926267,3873690,81.8224748094152,80.7267825760406,574
-7.6926,53.28823,2021/12/30 00:00:00+00,Thu 30 Dec 2021,1047,1197,1,3686417,3633990,240898,3927315,3874888,81.8443148813207,80.7517486124365,575
-7.6926,53.28823,2021/12/31 00:00:00+00,Fri 31 Dec 2021,711,1680,0,3687128,3635670,240898,3928026,3876568,81.8591319530047,80.7867594147278,576
-7.6926,53.28823,2022/01/01 00:00:00+00,Sat 01 Jan 2022,64,99,0,3687192,3635769,240898,3928090,3876667,81.8604656978539,80.7888225512913,577
-7.6926,53.28823,2022/01/02 00:00:00+00,Sun 02 Jan 2022,270,629,0,3687462,3636398,240898,3928360,3877296,81.8660924339364,80.8019307623873,578
-7.6926,53.28823,2022/01/03 00:00:00+00,Mon 03 Jan 2022,3630,728,1,3691092,3637126,240899,3931991,3878025,81.9417616143648,80.8171229498101,579
-7.6926,53.28823,2022/01/04 00:00:00+00,Tue 04 Jan 2022,1186,782,1,3692278,3637908,240900,3933178,3878808,81.9664984133646,80.8334404844495,580
-7.6926,53.28823,2022/01/05 00:00:00+00,Wed 05 Jan 2022,2141,909,0,3694419,3638817,240900,3935319,3879717,82.0111163465228,80.8523838292607,581
-7.6926,53.28823,2022/01/06 00:00:00+00,Thu 06 Jan 2022,2454,1695,1,3696873,3640512,240901,3937774,3881413,82.0622779653472,80.8877280677642,582
-7.6926,53.28823,2022/01/07 00:00:00+00,Fri 07 Jan 2022,4853,784,2,3701726,3641296,240903,3942629,3882199,82.1634550160164,80.9041081216934,583
-7.6926,53.28823,2022/01/08 00:00:00+00,Sat 08 Jan 2022,9789,740,2,3711515,3642036,240905,3952420,3882941,82.3674971381795,80.9195712260387,584
-7.6926,53.28823,2022/01/09 00:00:00+00,Sun 09 Jan 2022,7115,666,0,3718630,3642702,240905,3959535,3883607,82.5157720538358,80.9334505083756,585
-7.6926,53.28823,2022/01/10 00:00:00+00,Mon 10 Jan 2022,6659,508,1,3725289,3643210,240906,3966195,3884116,82.6545648772048,80.9440579478793,586
-7.6926,53.28823,2022/01/11 00:00:00+00,Tue 11 Jan 2022,4783,1367,1,3730072,3644577,240907,3970979,3885484,82.7542623046819,80.9725667440308,587
-7.6926,53.28823,2022/01/12 00:00:00+00,Wed 12 Jan 2022,7559,921,1,3737631,3645498,240908,3978539,3886406,82.9118109149927,80.9917810057645,588
-7.6926,53.28823,2022/01/13 00:00:00+00,Thu 13 Jan 2022,7322,816,0,3744953,3646314,240908,3985861,3887222,83.0643996616456,81.0087862525917,589
-7.6926,53.28823,2022/01/14 00:00:00+00,Fri 14 Jan 2022,10721,835,0,3755674,3647149,240908,3996582,3888057,83.2878227636485,81.026187454921,590
-7.6926,53.28823,2022/01/15 00:00:00+00,Sat 15 Jan 2022,8360,652,2,3764034,3647801,240910,4004944,3888711,83.4620848641008,81.0398166600987,591
-7.6926,53.28823,2022/01/16 00:00:00+00,Sun 16 Jan 2022,6965,1215,1,3770999,3649016,240911,4011910,3889927,83.60725465503,81.0651578122333,592
-7.6926,53.28823,2022/01/17 00:00:00+00,Mon 17 Jan 2022,2561,560,0,3773560,3649576,240911,4014471,3890487,83.660625288761,81.0768280796637,593
-7.6926,53.28823,2022/01/18 00:00:00+00,Tue 18 Jan 2022,4056,452,3,3777616,3650028,240914,4018530,3890942,83.7452138878683,81.086310171951,594
-7.6926,53.28823,2022/01/19 00:00:00+00,Wed 19 Jan 2022,3486,622,0,3781102,3650650,240914,4022016,3891564,83.8178613026227,81.0992725047041,595
-7.6926,53.28823,2022/01/20 00:00:00+00,Thu 20 Jan 2022,3693,935,0,3784795,3651585,240914,4025709,3892499,83.8948225483738,81.1187576833602,596
-7.6926,53.28823,2022/01/21 00:00:00+00,Fri 21 Jan 2022,3252,978,0,3788047,3652563,240914,4028961,3893477,83.9625934585233,81.1391389718369,597
-7.6926,53.28823,2022/01/22 00:00:00+00,Sat 22 Jan 2022,4270,644,0,3792317,3653207,240914,4033231,3894121,84.0515792476804,81.1525597793819,598
-7.6926,53.28823,2022/01/23 00:00:00+00,Sun 23 Jan 2022,3092,677,0,3795409,3653884,240914,4036323,3894798,84.116015795707,81.1666682991148,599
-7.6926,53.28823,2022/01/24 00:00:00+00,Mon 24 Jan 2022,646,464,0,3796055,3654348,240914,4036969,3895262,84.1294782827785,81.1763379492714,600
-7.6926,53.28823,2022/01/25 00:00:00+00,Tue 25 Jan 2022,692,1836,0,3796747,3656184,240914,4037661,3897098,84.1438993989604,81.2145997546326,601
-7.6926,53.28823,2022/01/26 00:00:00+00,Wed 26 Jan 2022,700,897,0,3797447,3657081,240914,4038361,3897995,84.1584872332484,81.2332930222846,602
-7.6926,53.28823,2022/01/27 00:00:00+00,Thu 27 Jan 2022,1274,1178,0,3798721,3658259,240914,4039635,3899173,84.1850370916527,81.257842263415,603
-7.6926,53.28823,2022/01/28 00:00:00+00,Fri 28 Jan 2022,1028,3094,1,3799749,3661353,240915,4040664,3902268,84.2064812080561,81.3223413307314,604
-7.6926,53.28823,2022/01/29 00:00:00+00,Sat 29 Jan 2022,2328,3445,0,3802077,3664798,240915,4042992,3905713,84.2549961769454,81.3941343151918,605
-7.6926,53.28823,2022/01/30 00:00:00+00,Sun 30 Jan 2022,1639,7537,0,3803716,3672335,240915,4044631,3913250,84.2891525489427,81.5512036109475,606
-7.6926,53.28823,2022/01/31 00:00:00+00,Mon 31 Jan 2022,480,1392,0,3804196,3673727,240915,4045111,3914642,84.2991556353116,81.5802125614174,607
-7.6926,53.28823,2022/02/01 00:00:00+00,Tue 01 Feb 2022,747,3417,1,3804943,3677144,240916,4045859,3918060,84.3147437782366,81.6514428722696,608
-7.6926,53.28823,2022/02/02 00:00:00+00,Wed 02 Feb 2022,650,2997,0,3805593,3680141,240916,4046509,3921057,84.3282896243612,81.7138996427856,609
-7.6926,53.28823,2022/02/03 00:00:00+00,Thu 03 Feb 2022,905,2435,1,3806498,3682576,240917,4047415,3923493,84.3471704498826,81.764665306108,610
-7.6926,53.28823,2022/02/04 00:00:00+00,Fri 04 Feb 2022,1172,6523,0,3807670,3689099,240917,4048587,3930016,84.3715946524334,81.9006030819092,611
-7.6926,53.28823,2022/02/05 00:00:00+00,Sat 05 Feb 2022,1777,5749,0,3809447,3694848,240917,4050364,3935765,84.4086269117617,82.0204108809406,612
-7.6926,53.28823,2022/02/06 00:00:00+00,Sun 06 Feb 2022,1407,7555,0,3810854,3702403,240917,4051771,3943320,84.4379484586807,82.177855292435,613
-7.6926,53.28823,2022/02/07 00:00:00+00,Mon 07 Feb 2022,441,1351,0,3811295,3703754,240917,4052212,3944671,84.4471387942822,82.2060098126109,614
-7.6926,53.28823,2022/02/08 00:00:00+00,Tue 08 Feb 2022,899,1238,0,3812194,3704992,240917,4053111,3945909,84.4658737414607,82.2318094395375,615
-7.6926,53.28823,2022/02/09 00:00:00+00,Wed 09 Feb 2022,1334,1784,0,3813528,3706776,240917,4054445,3947693,84.493673985661,82.2689875772087,616
-7.6926,53.28823,2022/02/10 00:00:00+00,Thu 10 Feb 2022,685,2550,0,3814213,3709326,240917,4055130,3950243,84.5079492235,82.3221289735437,617
-7.6926,53.28823,2022/02/11 00:00:00+00,Fri 11 Feb 2022,548,4921,0,3814761,3714247,240917,4055678,3955164,84.5193694137712,82.4246814485886,618
-7.6926,53.28823,2022/02/12 00:00:00+00,Sat 12 Feb 2022,1397,5462,0,3816158,3719709,240917,4057075,3960626,84.5484825630575,82.5385082355618,619
-7.6926,53.28823,2022/02/13 00:00:00+00,Sun 13 Feb 2022,1566,4706,0,3817724,3724415,240917,4058641,3965332,84.5811176323361,82.636580161504,620
-7.6926,53.28823,2022/02/14 00:00:00+00,Mon 14 Feb 2022,173,954,0,3817897,3725369,240917,4058814,3966286,84.5847229113816,82.6564612956623,621
-7.6926,53.28823,2022/02/15 00:00:00+00,Tue 15 Feb 2022,650,817,1,3818547,3726186,240918,4059465,3967104,84.5982895972695,82.673508222016,622
-7.6926,53.28823,2022/02/16 00:00:00+00,Wed 16 Feb 2022,800,1786,0,3819347,3727972,240918,4060265,3968890,84.6149614078844,82.7107280392138,623
