X,Y,VaccinationDate,VaccineText,Dose1,Dose2,SingleDose,Dose1Cum,Dose2Cum,SingleDoseCum,PartiallyVacc,FullyVacc,PartialPercent,FullyPercent,ObjectId
-7.6926,53.28823,2021/04/08 23:00:00+00,Fri 09 Apr 2021,20677,9160,16,775197,331603,204,775401,331807,16.4666874924478,7.04636978390102,1
-7.6926,53.28823,2020/12/28 00:00:00+00,Mon 28 Dec 2020,226,14,1,226,14,1,227,15,0.00482065158645095,0.000318545259016583,2
-7.6926,53.28823,2021/04/09 23:00:00+00,Sat 10 Apr 2021,11180,4177,12,786377,335780,216,786593,335996,16.7043647283754,7.13532885656905,3
-7.6926,53.28823,2020/12/29 00:00:00+00,Tue 29 Dec 2020,78,2,0,304,16,1,305,17,0.00647708693333718,0.000361017960218794,4
-7.6926,53.28823,2021/04/10 23:00:00+00,Sun 11 Apr 2021,2864,366,8,789241,336146,224,789465,336370,16.7653555273018,7.14327125169386,5
-7.6926,53.28823,2021/04/11 23:00:00+00,Mon 12 Apr 2021,7778,2797,13,797019,338943,237,797256,339180,16.930807934835,7.20294539688297,6
-7.6926,53.28823,2020/12/30 00:00:00+00,Wed 30 Dec 2020,1059,1,0,1363,17,1,1364,18,0.0289663822199079,0.000382254310819899,7
-7.6926,53.28823,2021/04/12 23:00:00+00,Tue 13 Apr 2021,11519,8588,1,808538,347531,238,808776,347769,17.1754506937597,7.38534441219587,8
-7.6926,53.28823,2020/12/31 00:00:00+00,Thu 31 Dec 2020,1033,1,0,2396,18,1,2397,19,0.0509035323908499,0.000403490661421005,9
-7.6926,53.28823,2021/04/13 23:00:00+00,Wed 14 Apr 2021,20343,6585,2,828881,354116,240,829121,354356,17.6075042467392,7.52522825360535,10
-7.6926,53.28823,2021/01/01 00:00:00+00,Fri 01 Jan 2021,814,0,0,3210,18,1,3211,19,0.0681899217801498,0.000403490661421005,11
-7.6926,53.28823,2021/04/14 23:00:00+00,Thu 15 Apr 2021,27102,10812,1,855983,364928,241,856224,365169,18.183073057081,7.7548569126551,12
-7.6926,53.28823,2021/04/15 23:00:00+00,Fri 16 Apr 2021,27959,9835,1,883942,374763,242,884184,375005,18.7768414198879,7.96373765716758,13
-7.6926,53.28823,2021/01/02 00:00:00+00,Sat 02 Jan 2021,1016,0,0,4226,18,1,4227,19,0.089766053990873,0.000403490661421005,14
-7.6926,53.28823,2021/04/16 23:00:00+00,Sat 17 Apr 2021,15850,4557,3,899792,379320,245,900037,379565,19.1135012859672,8.06057541590862,15
-7.6926,53.28823,2021/01/03 00:00:00+00,Sun 03 Jan 2021,20,2,1,4246,20,2,4248,22,0.0902120173534963,0.000467199713224322,16
-7.6926,53.28823,2021/04/17 23:00:00+00,Sun 18 Apr 2021,1073,484,0,900865,379804,245,901110,380049,19.1362878901622,8.07085380959955,17
-7.6926,53.28823,2021/01/04 00:00:00+00,Mon 04 Jan 2021,1190,3,0,5436,23,2,5438,25,0.115483274568812,0.000530908765027638,18
-7.6926,53.28823,2021/01/05 00:00:00+00,Tue 05 Jan 2021,3532,13,0,8968,36,2,8970,38,0.190490064891917,0.00080698132284201,19
-7.6926,53.28823,2021/01/06 00:00:00+00,Wed 06 Jan 2021,6778,13,0,15746,49,2,15748,51,0.33443004926621,0.00108305388065638,20
-7.6926,53.28823,2021/04/18 23:00:00+00,Mon 19 Apr 2021,6748,2259,0,907613,382063,245,907858,382308,19.2795907840185,8.11882672560745,21
-7.6926,53.28823,2021/01/07 00:00:00+00,Thu 07 Jan 2021,11728,8,0,27474,57,2,27476,59,0.583489969115975,0.00125294468546523,22
-7.6926,53.28823,2021/04/19 23:00:00+00,Tue 20 Apr 2021,15088,7322,1,922701,389385,246,922947,389631,19.6000260782385,8.27434052105935,23
-7.6926,53.28823,2021/01/08 00:00:00+00,Fri 08 Jan 2021,12682,5,0,40156,62,2,40158,64,0.852809367439196,0.00135912643847075,24
-7.6926,53.28823,2021/04/20 23:00:00+00,Wed 21 Apr 2021,26728,9889,4,949429,399274,250,949679,399524,20.1677162025073,8.48443173755608,25
-7.6926,53.28823,2021/01/09 00:00:00+00,Sat 09 Jan 2021,8073,7,0,48229,69,2,48231,71,1.02425042584192,0.00150778089267849,26
-7.6926,53.28823,2021/04/21 23:00:00+00,Thu 22 Apr 2021,31620,12183,1,981049,411457,251,981300,411708,20.8392308448648,8.74317543327995,27
-7.6926,53.28823,2021/01/10 00:00:00+00,Sun 10 Jan 2021,4782,4,1,53011,73,3,53014,76,1.12582389076701,0.00161396264568402,28
-7.6926,53.28823,2021/04/22 23:00:00+00,Fri 23 Apr 2021,33615,12351,3,1014664,423808,254,1014918,424062,21.5531544793728,9.00552930860601,29
-7.6926,53.28823,2021/01/11 00:00:00+00,Mon 11 Jan 2021,8342,7,0,61353,80,3,61356,83,1.30297752748143,0.00176261709989176,30
-7.6926,53.28823,2021/04/23 23:00:00+00,Sat 24 Apr 2021,23702,6995,2,1038366,430803,256,1038622,431059,22.0565409340214,9.15412005376194,31
-7.6926,53.28823,2021/01/12 00:00:00+00,Tue 12 Jan 2021,8886,10,0,70239,90,3,70242,93,1.49168373892285,0.00197498060590281,32
-7.6926,53.28823,2021/04/24 23:00:00+00,Sun 25 Apr 2021,9752,304,2,1048118,431107,258,1048376,431365,22.2636802977846,9.16061837704588,33
-7.6926,53.28823,2021/01/13 00:00:00+00,Wed 13 Jan 2021,9890,4,0,80129,94,3,80132,97,1.70171124636779,0.00205992600830724,34
-7.6926,53.28823,2021/04/25 23:00:00+00,Mon 26 Apr 2021,15594,3055,3,1063712,434162,261,1063973,434423,22.59490365811,9.22555913718406,35
-7.6926,53.28823,2021/01/14 00:00:00+00,Thu 14 Jan 2021,8084,5,0,88213,99,3,88216,102,1.87338590462712,0.00216610776131276,36
-7.6926,53.28823,2021/04/26 23:00:00+00,Tue 27 Apr 2021,25917,7820,9,1089629,441982,270,1089899,442252,23.1454772837943,9.39181852604012,37
-7.6926,53.28823,2021/01/15 00:00:00+00,Fri 15 Jan 2021,7692,2,0,95905,101,3,95908,104,2.03673591345083,0.00220858046251497,38
-7.6926,53.28823,2021/01/16 00:00:00+00,Sat 16 Jan 2021,5240,2,0,101145,103,3,101148,106,2.14801439060062,0.00225105316371719,39
-7.6926,53.28823,2021/04/27 23:00:00+00,Wed 28 Apr 2021,26042,8613,5,1115671,450595,275,1115946,450870,23.6986205079013,9.57483339552045,40
-7.6926,53.28823,2021/01/17 00:00:00+00,Sun 17 Jan 2021,1113,4,0,102258,107,3,102261,110,2.17165044881965,0.00233599856612161,41
-7.6926,53.28823,2021/04/28 23:00:00+00,Thu 29 Apr 2021,31690,11322,6,1147361,461917,281,1147642,462198,24.3717278765539,9.81539877512977,42
-7.6926,53.28823,2021/01/18 00:00:00+00,Mon 18 Jan 2021,8717,8,1,110975,115,4,110979,119,2.35678895336009,0.00252712572153156,43
-7.6926,53.28823,2021/04/29 23:00:00+00,Fri 30 Apr 2021,36098,13534,8,1183459,475451,289,1183748,475740,25.1384875513575,10.1029814349699,44
-7.6926,53.28823,2021/01/19 00:00:00+00,Tue 19 Jan 2021,8383,19,0,119358,134,4,119362,138,2.53481328044916,0.00293061638295256,45
-7.6926,53.28823,2021/04/30 23:00:00+00,Sat 01 May 2021,16588,6693,18,1200047,482144,307,1200354,482451,25.4911383894394,10.245498583854,46
-7.6926,53.28823,2021/01/20 00:00:00+00,Wed 20 Jan 2021,8448,962,0,127806,1096,4,127810,1100,2.7142179703273,0.0233599856612161,47
-7.6926,53.28823,2021/05/01 23:00:00+00,Sun 02 May 2021,12466,911,16,1212513,483055,323,1212836,483378,25.7562105176424,10.2651846808612,48
-7.6926,53.28823,2021/01/21 00:00:00+00,Thu 21 Jan 2021,9005,962,0,136811,2058,4,136815,2062,2.90545130749025,0.0437893549394796,49
-7.6926,53.28823,2021/05/02 23:00:00+00,Mon 03 May 2021,14267,926,21,1226780,483981,344,1227124,484325,26.059635495031,10.2852955048804,50
-7.6926,53.28823,2021/05/03 23:00:00+00,Tue 04 May 2021,26662,6796,10,1253442,490777,354,1253796,491131,26.6260514382637,10.4298301070716,51
-7.6926,53.28823,2021/05/04 23:00:00+00,Wed 05 May 2021,32118,13459,69,1285560,504236,423,1285983,504659,27.3095858550615,10.7171154580033,52
-7.6926,53.28823,2021/05/05 23:00:00+00,Thu 06 May 2021,37295,14374,132,1322855,518610,555,1323410,519165,28.1043987490091,11.0251699598229,53
-7.6926,53.28823,2021/05/06 23:00:00+00,Fri 07 May 2021,40594,15077,98,1363449,533687,653,1364102,534340,28.9685483276692,11.3474315801947,54
-7.6926,53.28823,2021/05/07 23:00:00+00,Sat 08 May 2021,25626,7054,10,1389075,540741,663,1389738,541404,29.5129634116792,11.4974451608409,55
-7.6926,53.28823,2021/05/08 23:00:00+00,Sun 09 May 2021,19674,926,5,1408749,541667,668,1409417,542335,29.9308735551583,11.5172162032506,56
-7.6926,53.28823,2021/05/09 23:00:00+00,Mon 10 May 2021,28844,4650,171,1437593,546317,839,1438432,547156,30.5470462678494,11.6195966494985,57
-7.6926,53.28823,2021/05/10 23:00:00+00,Tue 11 May 2021,33928,14809,153,1471521,561126,992,1472513,562118,31.2708023326857,11.9373349271922,58
-7.6926,53.28823,2021/05/11 23:00:00+00,Wed 12 May 2021,31294,20922,173,1502815,582048,1165,1503980,583213,31.9390465770507,12.3853157431226,59
-7.6926,53.28823,2021/05/12 23:00:00+00,Thu 13 May 2021,36003,25468,152,1538818,607516,1317,1540135,608833,32.7068468330337,12.9293910455229,60
-7.6926,53.28823,2021/05/13 23:00:00+00,Fri 14 May 2021,38221,27945,236,1577039,635461,1553,1578592,637014,33.5235331681004,13.5278526418126,61
-7.6926,53.28823,2021/05/14 23:00:00+00,Sat 15 May 2021,28861,12455,22,1605900,647916,1575,1607475,649491,34.1369026825121,13.7928185882626,62
-7.6926,53.28823,2021/05/15 23:00:00+00,Sun 16 May 2021,23182,1175,10,1629082,649091,1585,1630667,650676,34.6294161256529,13.8179836637249,63
-7.6926,53.28823,2021/05/16 23:00:00+00,Mon 17 May 2021,35391,3953,118,1664473,653044,1703,1666176,654747,35.3834976991476,13.904436847022,64
-7.6926,53.28823,2021/05/17 23:00:00+00,Tue 18 May 2021,39013,12501,128,1703486,665545,1831,1705317,667376,36.2147096980255,14.1726307187634,65
-7.6926,53.28823,2021/05/18 23:00:00+00,Wed 19 May 2021,37027,17592,211,1740513,683137,2042,1742555,685179,37.0055089217094,14.5507014685149,66
-7.6926,53.28823,2021/05/19 23:00:00+00,Thu 20 May 2021,39090,19643,136,1779603,702780,2178,1781781,704958,37.8385260103884,14.9707352470541,67
-7.6926,53.28823,2021/05/20 23:00:00+00,Fri 21 May 2021,25837,23247,14934,1805440,726027,17112,1822552,743139,38.7043532607461,15.781560349355,68
-7.6926,53.28823,2021/05/21 23:00:00+00,Sat 22 May 2021,16588,10248,13523,1822028,736275,30635,1852663,766910,39.343801013696,16.2863696394938,69
-7.6926,53.28823,2021/05/22 23:00:00+00,Sun 23 May 2021,8219,5527,10205,1830247,741802,40840,1871087,782642,39.7350595371707,16.6204599071504,70
-7.6926,53.28823,2021/05/23 23:00:00+00,Mon 24 May 2021,22552,8217,8450,1852799,750019,49290,1902089,799309,40.3934288785062,16.9744061626191,71
-7.6926,53.28823,2021/05/24 23:00:00+00,Tue 25 May 2021,30343,16505,3224,1883142,766524,52514,1935656,819038,41.1062694591335,17.3933781236283,72
-7.6926,53.28823,2021/05/25 23:00:00+00,Wed 26 May 2021,19980,25455,3054,1903122,791979,55568,1958690,847547,41.5954275588794,17.9988052429152,73
-7.6926,53.28823,2021/05/26 23:00:00+00,Thu 27 May 2021,17016,36040,550,1920138,828019,56118,1976256,884137,41.9684652935384,18.7758433114096,74
-7.6926,53.28823,2021/05/27 23:00:00+00,Fri 28 May 2021,27044,31827,1559,1947182,859846,57677,2004859,917523,42.5758886297818,19.4848401125781,75
-7.6926,53.28823,2021/05/28 23:00:00+00,Sat 29 May 2021,24482,7386,535,1971664,867232,58212,2029876,925444,43.1071584127697,19.6530532456895,76
-7.6926,53.28823,2021/05/29 23:00:00+00,Sun 30 May 2021,24255,1679,209,1995919,868911,58421,2054340,927332,43.6266844938751,19.6931474756244,77
-7.6926,53.28823,2021/05/30 23:00:00+00,Mon 31 May 2021,22589,7307,3444,2018508,876218,61865,2080373,938083,44.1795304090737,19.9214594809369,78
-7.6926,53.28823,2021/05/31 23:00:00+00,Tue 01 Jun 2021,27582,11515,3653,2046090,887733,65518,2111608,953251,44.8428478200992,20.2435724468544,79
-7.6926,53.28823,2021/06/01 23:00:00+00,Wed 02 Jun 2021,18701,20905,4008,2064791,908638,69526,2134317,978164,45.3251041058997,20.7726336493798,80
-7.6926,53.28823,2021/06/02 23:00:00+00,Thu 03 Jun 2021,16695,30700,1977,2081486,939338,71503,2152989,1010841,45.7216292443236,21.4665738779721,81
-7.6926,53.28823,2021/06/03 23:00:00+00,Fri 04 Jun 2021,28986,23339,153,2110472,962677,71656,2182128,1034333,46.3404352644892,21.9654582262933,82
-7.6926,53.28823,2021/06/04 23:00:00+00,Sat 05 Jun 2021,20968,11493,33,2131440,974170,71689,2203129,1045859,46.786419863463,22.2102284033216,83
-7.6926,53.28823,2021/06/05 23:00:00+00,Sun 06 Jun 2021,19947,3914,47,2151387,978084,71736,2223123,1049820,47.2110194573815,22.2943455880526,84
-7.6926,53.28823,2021/06/06 23:00:00+00,Mon 07 Jun 2021,19823,4593,45,2171210,982677,71781,2242991,1054458,47.6329432711243,22.3928397821405,85
-7.6926,53.28823,2021/06/07 23:00:00+00,Tue 08 Jun 2021,26413,18347,45,2197623,1001024,71826,2269449,1072850,48.1948146353283,22.7834187423961,86
-7.6926,53.28823,2021/06/08 23:00:00+00,Wed 09 Jun 2021,32806,20116,174,2230429,1021140,72000,2302429,1093140,48.8951894781528,23.2143042960925,87
-7.6926,53.28823,2021/06/09 23:00:00+00,Thu 10 Jun 2021,27702,27493,273,2258131,1048633,72273,2330404,1120906,49.4892763862187,23.8039528068828,88
-7.6926,53.28823,2021/06/10 23:00:00+00,Fri 11 Jun 2021,26443,32905,42,2284574,1081538,72315,2356889,1153853,50.051721131889,24.5036268501374,89
-7.6926,53.28823,2021/06/11 23:00:00+00,Sat 12 Jun 2021,12215,19721,105,2296789,1101259,72420,2369209,1173679,50.3133529712946,24.9246587371549,90
-7.6926,53.28823,2021/06/12 23:00:00+00,Sun 13 Jun 2021,8551,18174,834,2305340,1119433,73254,2378594,1192687,50.512656121686,25.3283192893807,91
-7.6926,53.28823,2021/06/13 23:00:00+00,Mon 14 Jun 2021,16021,31307,52,2321361,1150740,73306,2394667,1224046,50.8539879848976,25.9942700078808,92
-7.6926,53.28823,2021/06/14 23:00:00+00,Tue 15 Jun 2021,14703,41591,205,2336064,1192331,73511,2409575,1265842,51.1705794996588,26.8818645176046,93
-7.6926,53.28823,2021/06/15 23:00:00+00,Wed 16 Jun 2021,13473,48390,217,2349537,1240721,73728,2423265,1314449,51.461305139388,27.9140998112726,94
-7.6926,53.28823,2021/06/16 23:00:00+00,Thu 17 Jun 2021,21571,42688,535,2371108,1283409,74263,2445371,1357672,51.930755905776,28.8319985933041,95
-7.6926,53.28823,2021/06/17 23:00:00+00,Fri 18 Jun 2021,12020,50020,554,2383128,1333429,74817,2457945,1408246,52.1977817782343,29.9060057886044,96
-7.6926,53.28823,2021/06/18 23:00:00+00,Sat 19 Jun 2021,6322,32808,433,2389450,1366237,75250,2464700,1441487,52.3412333265448,30.6119233189358,97
-7.6926,53.28823,2021/06/19 23:00:00+00,Sun 20 Jun 2021,8518,26142,177,2397968,1392379,75427,2473395,1467806,52.5258833950214,31.1708428304063,98
-7.6926,53.28823,2021/06/20 23:00:00+00,Mon 21 Jun 2021,15484,32336,574,2413452,1424715,76001,2489453,1500716,52.8668967129739,31.8697311286887,99
-7.6926,53.28823,2021/06/21 23:00:00+00,Tue 22 Jun 2021,15149,43545,722,2428601,1468260,76723,2505324,1544983,53.2039388333641,32.8098006607478,100
-7.6926,53.28823,2021/06/22 23:00:00+00,Wed 23 Jun 2021,20091,39394,883,2448692,1507654,77606,2526298,1585260,53.6493500508717,33.6651371539085,101
-7.6926,53.28823,2021/06/23 23:00:00+00,Thu 24 Jun 2021,19022,44276,1032,2467714,1551930,78638,2546352,1630568,54.0752238258262,34.6273137269434,102
-7.6926,53.28823,2021/06/24 23:00:00+00,Fri 25 Jun 2021,15211,50125,843,2482925,1602055,79481,2562406,1681536,54.4161521983764,35.7096880443806,103
-7.6926,53.28823,2021/06/25 23:00:00+00,Sat 26 Jun 2021,9066,30563,511,2491991,1632618,79992,2571983,1712610,54.6195327280832,36.3695864029593,104
-7.6926,53.28823,2021/06/26 23:00:00+00,Sun 27 Jun 2021,8736,30478,59,2500727,1663096,80051,2580778,1743147,54.8063064316199,37.0180808412653,105
-7.6926,53.28823,2021/06/27 23:00:00+00,Mon 28 Jun 2021,24237,24650,524,2524964,1687746,80575,2605539,1768321,55.3321397088539,37.5526847312975,106
-7.6926,53.28823,2021/06/28 23:00:00+00,Tue 29 Jun 2021,28147,31044,811,2553111,1718790,81386,2634497,1800176,55.9471019495607,38.2291686796957,107
-7.6926,53.28823,2021/06/29 23:00:00+00,Wed 30 Jun 2021,22577,36870,590,2575688,1755660,81976,2657664,1837636,56.4390844839365,39.0246823732131,108
-7.6926,53.28823,2021/06/30 23:00:00+00,Thu 01 Jul 2021,15030,48306,640,2590718,1803966,82616,2673334,1886582,56.7718580978558,40.0641167897349,109
-7.6926,53.28823,2021/07/01 23:00:00+00,Fri 02 Jul 2021,13688,47269,818,2604406,1851235,83434,2687840,1934669,57.0799125996755,41.0853091810902,110
-7.6926,53.28823,2021/07/02 23:00:00+00,Sat 03 Jul 2021,9317,30479,505,2613723,1881714,83939,2697662,1965653,57.2884960352795,41.7432962681149,111
-7.6926,53.28823,2021/07/03 23:00:00+00,Sun 04 Jul 2021,6455,27784,233,2620178,1909498,84172,2704350,1993670,57.4305247480997,42.338275102906,112
-7.6926,53.28823,2021/07/04 23:00:00+00,Mon 05 Jul 2021,15618,33464,5343,2635796,1942962,89515,2725311,2032477,57.8756598930495,43.1623941606831,113
-7.6926,53.28823,2021/07/05 23:00:00+00,Tue 06 Jul 2021,12414,48301,5487,2648210,1991263,95002,2743212,2086265,58.2558118051599,44.3046549868154,114
-7.6926,53.28823,2021/07/06 23:00:00+00,Wed 07 Jul 2021,19708,43760,5059,2667918,2035023,100061,2767979,2135084,58.7817725004975,45.3413923868108,115
-7.6926,53.28823,2021/07/07 23:00:00+00,Thu 08 Jul 2021,17784,45598,5998,2685702,2080621,106059,2791761,2186680,59.286815390493,46.4371031324254,116
-7.6926,53.28823,2021/07/08 23:00:00+00,Fri 09 Jul 2021,13530,45090,6531,2699232,2125711,112590,2811822,2238301,59.7128378199017,47.5333447868051,117
-7.6926,53.28823,2021/07/09 23:00:00+00,Sat 10 Jul 2021,8640,23873,4364,2707872,2149584,116954,2824826,2266538,59.9889953231185,48.1329956187285,118
-7.6926,53.28823,2021/07/10 23:00:00+00,Sun 11 Jul 2021,15239,16112,2153,2723111,2165696,119107,2842218,2284803,60.3583379327729,48.5208775624577,119
-7.6926,53.28823,2021/07/11 23:00:00+00,Mon 12 Jul 2021,17110,31771,6092,2740221,2197467,125199,2865420,2322666,60.8510637394198,49.3249495052674,120
-7.6926,53.28823,2021/07/12 23:00:00+00,Tue 13 Jul 2021,20109,36568,8491,2760330,2234035,133690,2894020,2367725,61.4584233666114,50.2818382270026,121
-7.6926,53.28823,2021/07/13 23:00:00+00,Wed 14 Jul 2021,20801,35713,9335,2781131,2269748,143025,2924156,2412773,62.0984020283263,51.2384933488812,122
-7.6926,53.28823,2021/07/14 23:00:00+00,Thu 15 Jul 2021,23648,28832,9586,2804779,2298580,152611,2957390,2451191,62.8041709042035,52.0543514662744,123
-7.6926,53.28823,2021/07/15 23:00:00+00,Fri 16 Jul 2021,23528,27431,9167,2828307,2326011,161778,2990085,2487789,63.4984933871066,52.8315594255737,124
-7.6926,53.28823,2021/07/16 23:00:00+00,Sat 17 Jul 2021,11510,19430,4677,2839817,2345441,166455,3006272,2511896,63.8422461942867,53.3435041295145,125
-7.6926,53.28823,2021/07/17 23:00:00+00,Sun 18 Jul 2021,16866,15818,1932,2856683,2361259,168387,3025070,2529646,64.2414471128863,53.7204493526842,126
-7.6926,53.28823,2021/07/18 23:00:00+00,Mon 19 Jul 2021,24892,18441,6255,2881575,2379700,174642,3056217,2554342,64.9028957250589,54.2449022671291,127
-7.6926,53.28823,2021/10/29 23:00:00+00,Sat 30 Oct 2021,2020,1451,1,3618750,3554657,240735,3859485,3795392,81.9613765997077,80.6002751806311,128
-7.6926,53.28823,2022/02/09 00:00:00+00,Wed 09 Feb 2022,1334,1783,0,3813376,3706416,240901,4054277,3947317,86.0980478059983,83.826607745704,129
-7.6926,53.28823,2021/07/19 23:00:00+00,Tue 20 Jul 2021,30587,18184,7699,2912162,2397884,182341,3094503,2580225,65.7159506441728,54.7945627297375,130
-7.6926,53.28823,2021/01/22 00:00:00+00,Fri 22 Jan 2021,6783,967,0,143594,3025,4,143598,3029,3.04949747361755,0.0643249059707486,131
-7.6926,53.28823,2021/10/30 23:00:00+00,Sun 31 Oct 2021,1596,1320,0,3620346,3555977,240735,3861081,3796712,81.9952698152671,80.6283071634246,132
-7.6926,53.28823,2022/02/10 00:00:00+00,Thu 10 Feb 2022,685,2549,0,3814061,3708965,240901,4054962,3949866,86.1125947061601,83.8807392033863,133
-7.6926,53.28823,2021/01/23 00:00:00+00,Sat 23 Jan 2021,4191,460,0,147785,3485,4,147789,3489,3.13849901898678,0.0740936272472572,134
-7.6926,53.28823,2021/11/01 00:00:00+00,Mon 01 Nov 2021,278,290,2,3620624,3556267,240737,3861361,3797004,82.0012159934354,80.6345081778001,135
-7.6926,53.28823,2021/07/20 23:00:00+00,Wed 21 Jul 2021,30364,19845,6890,2942526,2417729,189231,3131757,2606960,66.5070896494664,55.3623165630581,136
-7.6926,53.28823,2022/02/11 00:00:00+00,Fri 11 Feb 2022,547,4920,0,3814608,3713885,240901,4055509,3954786,86.1242109899389,83.9852220483437,137
-7.6926,53.28823,2021/01/24 00:00:00+00,Sun 24 Jan 2021,1184,398,0,148969,3883,4,148973,3887,3.16364285809849,0.0825456947864972,138
-7.6926,53.28823,2021/11/02 00:00:00+00,Tue 02 Nov 2021,1100,1095,10,3621724,3557362,240747,3862471,3798109,82.0247883426026,80.6579743452143,139
-7.6926,53.28823,2021/07/21 23:00:00+00,Thu 22 Jul 2021,33543,15931,6934,2976069,2433660,196165,3172234,2629825,67.3666734127474,55.8478857195523,140
-7.6926,53.28823,2022/02/12 00:00:00+00,Sat 12 Feb 2022,1397,5462,0,3816005,3719347,240901,4056906,3960248,86.1538781717286,84.1012149953269,141
-7.6926,53.28823,2021/01/25 00:00:00+00,Mon 25 Jan 2021,1363,1289,0,150332,5172,4,150336,5176,3.1925880039678,0.109919350711322,142
-7.6926,53.28823,2021/11/03 00:00:00+00,Wed 03 Nov 2021,2535,1880,7,3624259,3559242,240754,3865013,3799996,82.0787711458307,80.6980473387986,143
-7.6926,53.28823,2021/07/22 23:00:00+00,Fri 23 Jul 2021,27092,20837,5615,3003161,2454497,201780,3204941,2656277,68.0612507318577,56.4096296656528,144
-7.6926,53.28823,2022/02/13 00:00:00+00,Sun 13 Feb 2022,1566,4706,0,3817571,3724053,240901,4058472,3964954,86.1871342967699,84.2011532612557,145
-7.6926,53.28823,2021/01/26 00:00:00+00,Tue 26 Jan 2021,1002,3502,0,151334,8674,4,151338,8678,3.21386682727011,0.184289050516394,146
-7.6926,53.28823,2021/11/04 00:00:00+00,Thu 04 Nov 2021,1534,1285,2,3625793,3560527,240756,3866549,3801283,82.111390180354,80.7253785220222,147
-7.6926,53.28823,2021/11/05 00:00:00+00,Fri 05 Nov 2021,1628,1097,4,3627421,3561624,240760,3868181,3802384,82.146047904535,80.748759744034,148
-7.6926,53.28823,2021/11/06 00:00:00+00,Sat 06 Nov 2021,1816,1357,6,3629237,3562981,240766,3870003,3803747,82.1847405353302,80.7777048899033,149
-7.6926,53.28823,2021/11/07 00:00:00+00,Sun 07 Nov 2021,696,775,0,3629933,3563756,240766,3870699,3804522,82.1995210353485,80.7941630616192,150
-7.6926,53.28823,2021/11/08 00:00:00+00,Mon 08 Nov 2021,517,530,3,3630450,3564286,240769,3871219,3805055,82.2105639376611,80.8054820364896,151
-7.6926,53.28823,2021/11/09 00:00:00+00,Tue 09 Nov 2021,1370,1063,3,3631820,3565349,240772,3872592,3806121,82.2397214470364,80.8281199862303,152
-7.6926,53.28823,2021/11/10 00:00:00+00,Wed 10 Nov 2021,1608,1360,1,3633428,3566709,240773,3874201,3807482,82.2738907351536,80.8570226593985,153
-7.6926,53.28823,2021/11/11 00:00:00+00,Thu 11 Nov 2021,1386,1115,1,3634814,3567824,240774,3875588,3808598,82.3033455534373,80.8807224266693,154
-7.6926,53.28823,2021/11/12 00:00:00+00,Fri 12 Nov 2021,1143,1156,6,3635957,3568980,240780,3876737,3809760,82.327746120278,80.9053990660678,155
-7.6926,53.28823,2021/11/13 00:00:00+00,Sat 13 Nov 2021,1397,1378,0,3637354,3570358,240780,3878134,3811138,82.3574133020678,80.9346627571961,156
-7.6926,53.28823,2021/11/14 00:00:00+00,Sun 14 Nov 2021,1647,1807,1,3639001,3572165,240781,3879782,3812946,82.3924108078584,80.9730580790829,157
-7.6926,53.28823,2021/11/15 00:00:00+00,Mon 15 Nov 2021,1240,597,1,3640241,3572762,240782,3881023,3813544,82.4187651189544,80.9857574167424,158
-7.6926,53.28823,2021/11/16 00:00:00+00,Tue 16 Nov 2021,1315,1075,5,3641556,3573837,240787,3882343,3814624,82.4467971017478,81.0086926753915,159
-7.6926,53.28823,2021/11/17 00:00:00+00,Wed 17 Nov 2021,1502,1116,2,3643058,3574953,240789,3883847,3815742,82.4787365730519,81.0324349153636,160
-7.6926,53.28823,2021/11/18 00:00:00+00,Thu 18 Nov 2021,1643,2502,5,3644701,3577455,240794,3885495,3818249,82.5137340788425,81.0856744463206,161
-7.6926,53.28823,2021/11/19 00:00:00+00,Fri 19 Nov 2021,1163,1555,0,3645864,3579010,240794,3886658,3819804,82.5384319545916,81.1186969715053,162
-7.6926,53.28823,2021/11/20 00:00:00+00,Sat 20 Nov 2021,1545,2943,12,3647409,3581953,240806,3888215,3822759,82.5714969524775,81.1814503875315,163
-7.6926,53.28823,2021/11/21 00:00:00+00,Sun 21 Nov 2021,1788,2766,0,3649197,3584719,240806,3890003,3825525,82.6094675473523,81.2401901332942,164
-7.6926,53.28823,2021/11/22 00:00:00+00,Mon 22 Nov 2021,719,519,3,3649916,3585238,240809,3890725,3826047,82.6248001924863,81.251275508308,165
-7.6926,53.28823,2021/11/23 00:00:00+00,Tue 23 Nov 2021,2153,1596,7,3652069,3586834,240816,3892885,3827650,82.6706707097847,81.2853173783216,166
-7.6926,53.28823,2021/11/24 00:00:00+00,Wed 24 Nov 2021,1609,3145,2,3653678,3589979,240818,3894496,3830797,82.7048824706031,81.3521481736632,167
-7.6926,53.28823,2021/11/25 00:00:00+00,Thu 25 Nov 2021,976,1186,1,3654654,3591165,240819,3895473,3831984,82.7256303851403,81.3773557218267,168
-7.6926,53.28823,2021/11/26 00:00:00+00,Fri 26 Nov 2021,1285,1108,12,3655939,3592273,240831,3896770,3833104,82.75317393187,81.4011404345,169
-7.6926,53.28823,2021/11/27 00:00:00+00,Sat 27 Nov 2021,1200,1564,6,3657139,3593837,240837,3897976,3834674,82.7787849706949,81.4344815049437,170
-7.6926,53.28823,2021/11/28 00:00:00+00,Sun 28 Nov 2021,1953,2257,1,3659092,3596094,240838,3899930,3836932,82.8202807997695,81.482433184601,171
-7.6926,53.28823,2021/11/29 00:00:00+00,Mon 29 Nov 2021,534,993,1,3659626,3597087,240839,3900465,3837926,82.8316422473411,81.5035421170985,172
-7.6926,53.28823,2021/11/30 00:00:00+00,Tue 30 Nov 2021,1893,1646,6,3661519,3598733,240845,3902364,3839578,82.8719700771325,81.5386245682915,173
-7.6926,53.28823,2021/12/01 00:00:00+00,Wed 01 Dec 2021,1037,1381,4,3662556,3600114,240849,3903405,3840963,82.8940771181083,81.5680369138741,174
-7.6926,53.28823,2021/12/02 00:00:00+00,Thu 02 Dec 2021,1739,1411,0,3664295,3601525,240849,3905144,3842374,82.9310071318036,81.5980014045722,175
-7.6926,53.28823,2021/12/03 00:00:00+00,Fri 03 Dec 2021,1014,1189,2,3665309,3602714,240851,3906160,3843565,82.9525832640144,81.6232938981381,176
-7.6926,53.28823,2021/12/04 00:00:00+00,Sat 04 Dec 2021,1202,1700,1,3666511,3604414,240852,3907363,3845266,82.9781305937875,81.6594169305106,177
-7.6926,53.28823,2021/12/05 00:00:00+00,Sun 05 Dec 2021,1346,1774,2,3667857,3606188,240854,3908711,3847042,83.0067571943978,81.6971326891782,178
-7.6926,53.28823,2021/12/06 00:00:00+00,Mon 06 Dec 2021,932,1298,0,3668789,3607486,240854,3909643,3848340,83.026549473158,81.7246974722584,179
-7.6926,53.28823,2021/12/07 00:00:00+00,Tue 07 Dec 2021,484,742,2,3669273,3608228,240856,3910129,3849084,83.0368703395501,81.7404973171056,180
-7.6926,53.28823,2021/12/08 00:00:00+00,Wed 08 Dec 2021,785,1522,2,3670058,3609750,240858,3910916,3850608,83.0535833474732,81.7728615154217,181
-7.6926,53.28823,2021/12/09 00:00:00+00,Thu 09 Dec 2021,787,1210,1,3670845,3610960,240859,3911704,3851819,83.0703175917469,81.7985787359997,182
-7.6926,53.28823,2021/12/10 00:00:00+00,Fri 10 Dec 2021,887,1613,1,3671732,3612573,240860,3912592,3853433,83.0891754710807,81.8328542058699,183
-7.6926,53.28823,2021/12/11 00:00:00+00,Sat 11 Dec 2021,638,842,2,3672370,3613415,240862,3913232,3854277,83.1027667354654,81.8507776857772,184
-7.6926,53.28823,2021/12/12 00:00:00+00,Sun 12 Dec 2021,685,1192,0,3673055,3614607,240862,3913917,3855469,83.1173136356271,81.8760914156937,185
-7.6926,53.28823,2021/12/13 00:00:00+00,Mon 13 Dec 2021,719,1069,1,3673774,3615676,240863,3914637,3856539,83.1326038080599,81.8988143108369,186
-7.6926,53.28823,2021/12/14 00:00:00+00,Tue 14 Dec 2021,626,1201,3,3674400,3616877,240866,3915266,3857743,83.145961472588,81.9243828769606,187
-7.6926,53.28823,2021/12/15 00:00:00+00,Wed 15 Dec 2021,789,1259,0,3675189,3618136,240866,3916055,3859002,83.1627169532123,81.9511194423674,188
-7.6926,53.28823,2021/12/16 00:00:00+00,Thu 16 Dec 2021,1042,1542,7,3676231,3619678,240873,3917104,3860551,83.1849938849928,81.9840145494485,189
-7.6926,53.28823,2021/12/17 00:00:00+00,Fri 17 Dec 2021,1197,2459,1,3677428,3622137,240874,3918302,3863011,83.210435033013,82.0362559719272,190
-7.6926,53.28823,2021/12/18 00:00:00+00,Sat 18 Dec 2021,1245,1183,0,3678673,3623320,240874,3919547,3864194,83.2368742895113,82.0613785746883,191
-7.6926,53.28823,2021/12/19 00:00:00+00,Sun 19 Dec 2021,544,887,1,3679217,3624207,240875,3920092,3865082,83.2484481005889,82.0802364540221,192
-7.6926,53.28823,2021/12/20 00:00:00+00,Mon 20 Dec 2021,506,615,1,3679723,3624822,240876,3920599,3865698,83.2592149303437,82.0933180459924,193
-7.6926,53.28823,2021/12/21 00:00:00+00,Tue 21 Dec 2021,1398,1816,3,3681121,3626638,240879,3922000,3867517,83.2889670575359,82.1319469677358,194
-7.6926,53.28823,2021/12/22 00:00:00+00,Wed 22 Dec 2021,1153,1595,2,3682274,3628233,240881,3923155,3869114,83.3134950424801,82.1658614196458,195
-7.6926,53.28823,2021/12/23 00:00:00+00,Thu 23 Dec 2021,923,1394,0,3683197,3629627,240881,3924078,3870508,83.333096194085,82.1954648923837,196
-7.6926,53.28823,2021/12/24 00:00:00+00,Fri 24 Dec 2021,102,157,0,3683299,3629784,240881,3924180,3870665,83.3352623018463,82.1987989994281,197
-7.6926,53.28823,2021/12/25 00:00:00+00,Sat 25 Dec 2021,1,6,0,3683300,3629790,240881,3924181,3870671,83.3352835381969,82.1989264175317,198
-7.6926,53.28823,2021/12/26 00:00:00+00,Sun 26 Dec 2021,12,11,0,3683312,3629801,240881,3924193,3870682,83.3355383744041,82.1991600173883,199
-7.6926,53.28823,2021/12/27 00:00:00+00,Mon 27 Dec 2021,389,589,0,3683701,3630390,240881,3924582,3871271,83.3437993147879,82.2116682278924,200
-7.6926,53.28823,2021/12/28 00:00:00+00,Tue 28 Dec 2021,465,747,0,3684166,3631137,240881,3925047,3872018,83.3536742178174,82.2275317817914,201
-7.6926,53.28823,2021/12/29 00:00:00+00,Wed 29 Dec 2021,1057,1309,0,3685223,3632446,240881,3926104,3873327,83.3761210404028,82.2553301647282,202
-7.6926,53.28823,2021/12/30 00:00:00+00,Thu 30 Dec 2021,1048,1196,1,3686271,3633642,240882,3927153,3874524,83.3983979721834,82.2807500763978,203
-7.6926,53.28823,2021/12/31 00:00:00+00,Fri 31 Dec 2021,711,1680,0,3686982,3635322,240882,3927864,3876204,83.4134970174607,82.3164271454076,204
-7.6926,53.28823,2022/01/01 00:00:00+00,Sat 01 Jan 2022,64,99,0,3687046,3635421,240882,3927928,3876303,83.4148561438992,82.3185295441171,205
-7.6926,53.28823,2022/01/02 00:00:00+00,Sun 02 Jan 2022,270,628,0,3687316,3636049,240882,3928198,3876931,83.4205899585615,82.3318659722946,206
-7.6926,53.28823,2022/01/03 00:00:00+00,Mon 03 Jan 2022,3630,728,1,3690946,3636777,240883,3931829,3877660,83.4976991475941,82.3473472718828,207
-7.6926,53.28823,2022/01/04 00:00:00+00,Tue 04 Jan 2022,1186,782,1,3692132,3637559,240884,3933016,3878443,83.5229066957576,82.3639753344035,208
-7.6926,53.28823,2022/01/05 00:00:00+00,Wed 05 Jan 2022,2140,908,0,3694272,3638467,240884,3935156,3879351,83.568352486044,82.3832579407493,209
-7.6926,53.28823,2022/01/06 00:00:00+00,Thu 06 Jan 2022,2455,1694,1,3696727,3640161,240885,3937612,3881046,83.6205089631203,82.4192535550182,210
-7.6926,53.28823,2022/01/07 00:00:00+00,Fri 07 Jan 2022,4852,784,2,3701579,3640945,240887,3942466,3881832,83.7235902089381,82.4359453265907,211
-7.6926,53.28823,2022/01/08 00:00:00+00,Sat 08 Jan 2022,9789,740,2,3711368,3641685,240889,3952257,3882574,83.9315153176735,82.4517026987367,212
-7.6926,53.28823,2022/01/09 00:00:00+00,Sun 09 Jan 2022,7115,666,0,3718483,3642351,240889,3959372,3883240,84.0826119522004,82.465846108237,213
-7.6926,53.28823,2022/01/10 00:00:00+00,Mon 10 Jan 2022,6659,508,1,3725142,3642859,240890,3966032,3883749,84.2240460472037,82.476655410693,214
-7.6926,53.28823,2022/01/11 00:00:00+00,Tue 11 Jan 2022,4780,1366,1,3729922,3644225,240891,3970813,3885116,84.3255770394276,82.5056855019647,215
-7.6926,53.28823,2022/01/12 00:00:00+00,Wed 12 Jan 2022,7559,919,1,3737481,3645144,240892,3978373,3886036,84.486123849972,82.5252229445177,216
-7.6926,53.28823,2022/01/13 00:00:00+00,Thu 13 Jan 2022,7322,816,0,3744803,3645960,240892,3985695,3886852,84.6416164090733,82.5425518066082,217
-7.6926,53.28823,2022/01/14 00:00:00+00,Fri 14 Jan 2022,10721,835,0,3755524,3646795,240892,3996416,3887687,84.8692913238677,82.5602841593601,218
-7.6926,53.28823,2022/01/15 00:00:00+00,Sat 15 Jan 2022,8360,652,2,3763884,3647447,240894,4004778,3888341,85.0468696875942,82.5741727326533,219
-7.6926,53.28823,2022/01/16 00:00:00+00,Sun 16 Jan 2022,6965,1215,1,3770849,3648662,240895,4011744,3889557,85.1948021058815,82.5999961349842,220
-7.6926,53.28823,2022/01/17 00:00:00+00,Mon 17 Jan 2022,2562,560,0,3773411,3649222,240895,4014306,3890117,85.2492096361215,82.6118884913208,221
-7.6926,53.28823,2022/01/18 00:00:00+00,Tue 18 Jan 2022,4056,451,3,3777467,3649673,240898,4018365,3890571,85.3354079832114,82.6215297944937,222
-7.6926,53.28823,2022/01/19 00:00:00+00,Wed 19 Jan 2022,3486,621,0,3780953,3650294,240898,4021851,3891192,85.4094379014068,82.634717568217,223
-7.6926,53.28823,2022/01/20 00:00:00+00,Thu 20 Jan 2022,3693,934,0,3784646,3651228,240898,4025544,3892126,85.4878637441767,82.6545523196784,224
-7.6926,53.28823,2022/01/21 00:00:00+00,Fri 21 Jan 2022,3250,977,0,3787896,3652205,240898,4028794,3893103,85.5568818836303,82.6753002342157,225
-7.6926,53.28823,2022/01/22 00:00:00+00,Sat 22 Jan 2022,4270,644,0,3792166,3652849,240898,4033064,3893747,85.647561100697,82.6889764440028,226
-7.6926,53.28823,2022/01/23 00:00:00+00,Sun 23 Jan 2022,3092,677,0,3795258,3653526,240898,4036156,3894424,85.7132238967557,82.7033534533598,227
-7.6926,53.28823,2022/01/24 00:00:00+00,Mon 24 Jan 2022,646,464,0,3795904,3653990,240898,4036802,3894888,85.726942579244,82.7132071200387,228
-7.6926,53.28823,2022/01/25 00:00:00+00,Tue 25 Jan 2022,692,1836,0,3796596,3655826,240898,4037494,3896724,85.7416381338599,82.7521970597423,229
-7.6926,53.28823,2022/01/26 00:00:00+00,Wed 26 Jan 2022,700,897,0,3797296,3656723,240898,4038194,3897621,85.7565035792807,82.7712460662315,230
-7.6926,53.28823,2022/01/27 00:00:00+00,Thu 27 Jan 2022,1274,1178,0,3798570,3657901,240898,4039468,3898799,85.7835586899465,82.7962624872396,231
-7.6926,53.28823,2022/01/28 00:00:00+00,Fri 28 Jan 2022,1027,3094,1,3799597,3660995,240899,4040496,3901894,85.8053896583645,82.86198899235,232
-7.6926,53.28823,2022/01/29 00:00:00+00,Sat 29 Jan 2022,2328,3445,0,3801925,3664440,240899,4042824,3905339,85.8548278825638,82.9351482201708,233
-7.6926,53.28823,2022/01/30 00:00:00+00,Sun 30 Jan 2022,1638,7537,0,3803563,3671977,240899,4044462,3912876,85.8896130248484,83.0952065946514,234
-7.6926,53.28823,2022/01/31 00:00:00+00,Mon 31 Jan 2022,480,1392,0,3804043,3673369,240899,4044942,3914268,85.899806473137,83.1247675946881,235
-7.6926,53.28823,2022/02/01 00:00:00+00,Tue 01 Feb 2022,747,3417,1,3804790,3676786,240900,4045690,3917686,85.9156912633866,83.1973534410427,236
-7.6926,53.28823,2022/02/02 00:00:00+00,Wed 02 Feb 2022,650,2996,0,3805440,3679782,240900,4046340,3920682,85.9294948912773,83.2609775474436,237
-7.6926,53.28823,2022/02/03 00:00:00+00,Thu 03 Feb 2022,905,2435,1,3806345,3682217,240901,4047246,3923118,85.9487350249219,83.3127092975079,238
-7.6926,53.28823,2022/02/04 00:00:00+00,Fri 04 Feb 2022,1172,6523,0,3807517,3688740,240901,4048418,3929641,85.9736240278264,83.4512340124789,239
-7.6926,53.28823,2022/02/05 00:00:00+00,Sat 05 Feb 2022,1777,5750,0,3809294,3694490,240901,4050195,3935391,86.0113610228446,83.5733430284353,240
-7.6926,53.28823,2022/02/06 00:00:00+00,Sun 06 Feb 2022,1407,7555,0,3810701,3702045,240901,4051602,3942946,86.0412405681403,83.7337836572266,241
-7.6926,53.28823,2022/02/07 00:00:00+00,Mon 07 Feb 2022,441,1351,0,3811142,3703396,240901,4052043,3944297,86.0506057987554,83.7624739668887,242
-7.6926,53.28823,2022/02/08 00:00:00+00,Tue 08 Feb 2022,900,1237,0,3812042,3704633,240901,4052943,3945534,86.0697185142964,83.7887433325823,243
-7.6926,53.28823,2022/02/14 00:00:00+00,Mon 14 Feb 2022,173,953,0,3817744,3725006,240901,4058645,3965907,86.1908081854239,84.2213915033786,244
-7.6926,53.28823,2021/01/27 00:00:00+00,Wed 27 Jan 2021,2179,6700,0,153513,15374,4,153517,15378,3.26014083522992,0.326572599543801,245
-7.6926,53.28823,2021/07/23 23:00:00+00,Sat 24 Jul 2021,15440,14812,2275,3018601,2469309,204055,3222656,2673364,68.4374526827563,56.7724951883739,246
-7.6926,53.28823,2022/02/15 00:00:00+00,Tue 15 Feb 2022,649,817,1,3818393,3725823,240902,4059295,3966725,86.2046118133146,84.2387628381703,247
-7.6926,53.28823,2021/01/28 00:00:00+00,Thu 28 Jan 2021,1013,11541,0,154526,26915,4,154530,26919,3.28165325838884,0.571661321831159,248
-7.6926,53.28823,2021/07/24 23:00:00+00,Sun 25 Jul 2021,14725,13647,1046,3033326,2482956,205101,3238427,2688057,68.7723711680864,57.0845208877559,249
-7.6926,53.28823,2022/02/16 00:00:00+00,Wed 16 Feb 2022,800,1786,0,3819193,3727609,240902,4060095,3968511,86.2216008937955,84.2766909603439,250
-7.6926,53.28823,2021/01/29 00:00:00+00,Fri 29 Jan 2021,1579,11526,0,156105,38441,4,156109,38445,3.31518545598798,0.816431498859502,251
-7.6926,53.28823,2021/07/25 23:00:00+00,Mon 26 Jul 2021,23841,18305,3422,3057167,2501261,208523,3265690,2709784,69.3513377945243,57.5459230772661,252
-7.6926,53.28823,2022/02/17 00:00:00+00,Thu 17 Feb 2022,790,1192,2,3819983,3728801,240904,4060887,3969705,86.2384200834716,84.3020471629616,253
-7.6926,53.28823,2021/01/30 00:00:00+00,Sat 30 Jan 2021,645,7792,0,156750,46233,4,156754,46237,3.32888290212569,0.981905142743316,254
-7.6926,53.28823,2021/07/26 23:00:00+00,Tue 27 Jul 2021,25510,23909,3674,3082677,2525170,212197,3294874,2737367,69.971099450467,58.1316853358964,255
-7.6926,53.28823,2022/02/18 00:00:00+00,Fri 18 Feb 2022,791,3293,0,3820774,3732094,240904,4061678,3972998,86.2552180367971,84.371978465491,256
-7.6926,53.28823,2021/01/31 00:00:00+00,Sun 31 Jan 2021,232,4086,0,156982,50319,4,156986,50323,3.33380973546515,1.06867687129943,257
-7.6926,53.28823,2021/07/27 23:00:00+00,Wed 28 Jul 2021,23440,25289,3264,3106117,2550459,215461,3321578,2765920,70.5381949569189,58.7380468546098,258
-7.6926,53.28823,2022/02/19 00:00:00+00,Sat 19 Feb 2022,980,3555,0,3821754,3735649,240904,4062658,3976553,86.2760296603862,84.447473691878,259
-7.6926,53.28823,2021/02/01 00:00:00+00,Mon 01 Feb 2021,1028,8332,1,158010,58651,5,158015,58656,3.35566194023369,1.24563938085845,260
-7.6926,53.28823,2021/07/28 23:00:00+00,Thu 29 Jul 2021,19277,27867,2963,3125394,2578326,218424,3343818,2796750,71.0104913942875,59.3927635436419,261
-7.6926,53.28823,2022/02/20 00:00:00+00,Sun 20 Feb 2022,1366,3587,0,3823120,3739236,240904,4064024,3980140,86.3050385153073,84.5236484814841,262
-7.6926,53.28823,2021/02/02 00:00:00+00,Tue 02 Feb 2021,834,5108,0,158844,63759,5,158849,63764,3.37337305663501,1.35411465972889,263
-7.6926,53.28823,2021/07/29 23:00:00+00,Fri 30 Jul 2021,21957,22944,2120,3147351,2601270,220544,3367895,2821814,71.5217990077103,59.925031435108,264
-7.6926,53.28823,2022/02/21 00:00:00+00,Mon 21 Feb 2022,253,994,1,3823373,3740230,240905,4064278,3981135,86.31043254836,84.5447786503322,265
-7.6926,53.28823,2021/02/03 00:00:00+00,Wed 03 Feb 2021,1405,6868,0,160249,70627,5,160254,70632,3.40321012922956,1.49996591565729,266
-7.6926,53.28823,2021/07/30 23:00:00+00,Sat 31 Jul 2021,13749,12489,907,3161100,2613759,221451,3382551,2835210,71.8330389621201,60.2095135877604,267
-7.6926,53.28823,2022/02/22 00:00:00+00,Tue 22 Feb 2022,476,981,0,3823849,3741211,240905,4064754,3982116,86.3205410512461,84.5656115102719,268
-7.6926,53.28823,2021/02/04 00:00:00+00,Thu 04 Feb 2021,1438,10541,1,161687,81168,6,161693,81174,3.43376923774456,1.72383952369414,269
-7.6926,53.28823,2021/07/31 23:00:00+00,Sun 01 Aug 2021,11124,9337,368,3172224,2623096,221819,3394043,2844915,72.077087103228,60.4156123703441,270
-7.6926,53.28823,2022/02/23 00:00:00+00,Wed 23 Feb 2022,832,1272,1,3824681,3742483,240906,4065587,3983389,86.3382309312968,84.5926453845871,271
-7.6926,53.28823,2021/02/05 00:00:00+00,Fri 05 Feb 2021,3395,8614,0,165082,89782,6,165088,89788,3.50586664803531,1.90676944777206,272
-7.6926,53.28823,2021/08/01 23:00:00+00,Mon 02 Aug 2021,15024,16025,430,3187248,2639121,222249,3409497,2861370,72.4052736654175,60.7650565194853,273
-7.6926,53.28823,2022/02/24 00:00:00+00,Thu 24 Feb 2022,657,1232,0,3825338,3743715,240906,4066244,3984621,86.3521832136417,84.6188085685277,274
-7.6926,53.28823,2021/02/06 00:00:00+00,Sat 06 Feb 2021,902,3870,0,165984,93652,6,165990,93658,3.52502183627751,1.98895412459834,275
-7.6926,53.28823,2021/08/02 23:00:00+00,Tue 03 Aug 2021,17348,25452,1111,3204596,2664573,223360,3427956,2887933,72.7972754611633,61.3291577005025,276
-7.6926,53.28823,2022/02/25 00:00:00+00,Fri 25 Feb 2022,691,1227,0,3826029,3744942,240906,4066935,3985848,86.3668575319071,84.6448655707152,277
-7.6926,53.28823,2021/02/07 00:00:00+00,Sun 07 Feb 2021,332,1300,2,166316,94952,8,166324,94960,3.53211477737828,2.01660385308098,278
-7.6926,53.28823,2021/08/03 23:00:00+00,Wed 04 Aug 2021,22117,17310,1576,3226713,2681883,224936,3451649,2906819,73.3004283159553,61.7302274179549,279
-7.6926,53.28823,2022/02/26 00:00:00+00,Sat 26 Feb 2022,959,2092,0,3826988,3747034,240906,4067894,3987940,86.3872231921335,84.6892920161728,280
-7.6926,53.28823,2021/02/08 00:00:00+00,Mon 08 Feb 2021,1188,879,0,167504,95831,8,167512,95839,3.55734356189239,2.03527060525935,281
-7.6926,53.28823,2021/08/04 23:00:00+00,Thu 05 Aug 2021,13535,30052,1421,3240248,2711935,226357,3466605,2938292,73.6180391755454,62.3985990804235,282
-7.6926,53.28823,2022/02/27 00:00:00+00,Sun 27 Feb 2022,671,1783,0,3827659,3748817,240906,4068565,3989723,86.4014727833869,84.7271564292945,283
-7.6926,53.28823,2021/02/09 00:00:00+00,Tue 09 Feb 2021,4264,545,3,171768,96376,11,171779,96387,3.64795906990731,2.04690812538876,284
-7.6926,53.28823,2021/08/05 23:00:00+00,Fri 06 Aug 2021,12212,24754,948,3252460,2736689,227305,3479765,2963994,73.8975095494559,62.9444157635732,285
-7.6926,53.28823,2022/02/28 00:00:00+00,Mon 28 Feb 2022,82,428,0,3827741,3749245,240906,4068647,3990151,86.4032141641362,84.7362455873518,286
-7.6926,53.28823,2021/02/10 00:00:00+00,Wed 10 Feb 2021,8827,579,0,180595,96955,11,180606,96966,3.83541233666326,2.0592039723868,287
-7.6926,53.28823,2021/08/06 23:00:00+00,Sat 07 Aug 2021,6337,8463,583,3258797,2745152,227888,3486685,2973040,74.0444650956156,63.1365197911108,288
-7.6926,53.28823,2022/03/01 00:00:00+00,Tue 01 Mar 2022,130,937,0,3827871,3750182,240906,4068777,3991088,86.4059748897143,84.756144047865,289
-7.6926,53.28823,2021/02/11 00:00:00+00,Thu 11 Feb 2021,6189,446,0,186784,97401,11,186795,97412,3.96684411053351,2.06867538475489,290
-7.6926,53.28823,2021/02/12 00:00:00+00,Fri 12 Feb 2021,4397,524,0,191181,97925,11,191192,97936,4.06022034412657,2.07980323246987,291
-7.6926,53.28823,2021/02/13 00:00:00+00,Sat 13 Feb 2021,1211,1915,0,192392,99840,11,192403,99851,4.08593756470451,2.12047084387099,292
-7.6926,53.28823,2021/02/14 00:00:00+00,Sun 14 Feb 2021,2701,27,0,195093,99867,11,195104,99878,4.14329694767809,2.12104422533722,293
-7.6926,53.28823,2021/02/15 00:00:00+00,Mon 15 Feb 2021,1964,7891,0,197057,107758,11,197068,107769,4.18500514025866,2.28862026793054,294
-7.6926,53.28823,2021/02/16 00:00:00+00,Tue 16 Feb 2021,5654,8163,0,202711,115921,11,202722,115932,4.30507546655731,2.46197259788737,295
-7.6926,53.28823,2021/02/17 00:00:00+00,Wed 17 Feb 2021,9747,8465,0,212458,124386,11,212469,124397,4.51206617586629,2.64173830572572,296
-7.6926,53.28823,2021/02/18 00:00:00+00,Thu 18 Feb 2021,8467,8354,1,220925,132740,12,220937,132752,4.69189559275645,2.81916801499796,297
-7.6926,53.28823,2021/02/19 00:00:00+00,Fri 19 Feb 2021,9393,6582,0,230318,139322,12,230330,139334,4.89136863395264,2.95894567465444,298
-7.6926,53.28823,2021/02/20 00:00:00+00,Sat 20 Feb 2021,5891,3573,2,236209,142895,14,236223,142909,5.01651444804495,3.03486562805339,299
-7.6926,53.28823,2021/02/21 00:00:00+00,Sun 21 Feb 2021,1112,1024,6,237321,143919,20,237341,143939,5.04025668801699,3.05673906917253,300
-7.6926,53.28823,2021/02/22 00:00:00+00,Mon 22 Feb 2021,3946,1123,1,241267,145042,21,241288,145063,5.12407656383955,3.08060872724817,301
-7.6926,53.28823,2021/02/23 00:00:00+00,Tue 23 Feb 2021,13362,1069,1,254629,146111,22,254651,146133,5.40785791692212,3.10333162239135,302
-7.6926,53.28823,2021/02/24 00:00:00+00,Wed 24 Feb 2021,16941,2106,3,271570,148217,25,271595,148242,5.76768664150725,3.14811908580908,303
-7.6926,53.28823,2021/02/25 00:00:00+00,Thu 25 Feb 2021,18097,1758,2,289667,149975,27,289694,150002,6.15204335103666,3.18549506286703,304
-7.6926,53.28823,2021/02/26 00:00:00+00,Fri 26 Feb 2021,16080,2769,0,305747,152744,27,305774,152771,6.49352386870244,3.24429851768149,305
-7.6926,53.28823,2021/02/27 00:00:00+00,Sat 27 Feb 2021,8996,705,1,314743,153449,28,314771,153477,6.68458731506059,3.25929138120587,306
-7.6926,53.28823,2021/02/28 00:00:00+00,Sun 28 Feb 2021,2446,57,2,317189,153506,30,317219,153536,6.73657390133209,3.26054432589134,307
-7.6926,53.28823,2021/03/01 00:00:00+00,Mon 01 Mar 2021,5604,796,0,322793,154302,30,322823,154332,6.85558241010069,3.27744846096982,308
-7.6926,53.28823,2021/03/02 00:00:00+00,Tue 02 Mar 2021,12181,1611,0,334974,155913,30,335004,155943,7.11426239677275,3.3116602217882,309
-7.6926,53.28823,2021/03/03 00:00:00+00,Wed 03 Mar 2021,12902,1504,1,347876,157417,31,347907,157448,7.38827502857882,3.34362092944286,310
-7.6926,53.28823,2021/03/04 00:00:00+00,Thu 04 Mar 2021,18725,1691,5,366601,159108,36,366637,159144,7.78603187533752,3.37963778006234,311
-7.6926,53.28823,2021/03/05 00:00:00+00,Fri 05 Mar 2021,18450,2400,6,385051,161508,42,385093,161550,8.17796996203153,3.4307324396086,312
-7.6926,53.28823,2021/03/06 00:00:00+00,Sat 06 Mar 2021,10405,141,4,395456,161649,46,395502,161695,8.39901913543844,3.43381171044576,313
-7.6926,53.28823,2021/03/07 00:00:00+00,Sun 07 Mar 2021,1523,12,3,396979,161661,49,397028,161710,8.43142580645572,3.43413025570477,314
-7.6926,53.28823,2021/03/08 00:00:00+00,Mon 08 Mar 2021,6669,1498,5,403648,163159,54,403702,163213,8.5731572103675,3.46604849065824,315
-7.6926,53.28823,2021/03/09 00:00:00+00,Tue 09 Mar 2021,13834,3106,6,417482,166265,60,417542,166325,8.8670683026868,3.53213601372888,316
-7.6926,53.28823,2021/03/10 00:00:00+00,Wed 10 Mar 2021,13740,3990,3,431222,170255,63,431285,170318,9.15891946899779,3.61693276167909,317
-7.6926,53.28823,2021/03/11 00:00:00+00,Thu 11 Mar 2021,18487,2102,3,449709,172357,66,449775,172423,9.55157959161224,3.66163527969442,318
-7.6926,53.28823,2021/03/12 00:00:00+00,Fri 12 Mar 2021,17333,1340,4,467042,173697,70,467112,173767,9.9197542019836,3.6901769349023,319
-7.6926,53.28823,2021/03/13 00:00:00+00,Sat 13 Mar 2021,8313,176,0,475355,173873,70,475425,173943,10.0962919845306,3.6939145326081,320
-7.6926,53.28823,2021/03/14 00:00:00+00,Sun 14 Mar 2021,383,20,2,475738,173893,72,475810,173965,10.104467979512,3.69438173232132,321
-7.6926,53.28823,2021/03/15 00:00:00+00,Mon 15 Mar 2021,2659,992,0,478397,174885,72,478469,174957,10.1609354357604,3.71544819211762,322
-7.6926,53.28823,2021/03/16 00:00:00+00,Tue 16 Mar 2021,8948,3823,2,487345,178708,74,487419,178782,10.3510007736403,3.79667723316685,323
-7.6926,53.28823,2021/03/17 00:00:00+00,Wed 17 Mar 2021,4882,2415,7,492227,181123,81,492308,181204,10.4548252917291,3.84811167432273,324
-7.6926,53.28823,2021/03/18 00:00:00+00,Thu 18 Mar 2021,11720,4683,5,503947,185806,86,504033,185892,10.703821502527,3.94766768594071,325
-7.6926,53.28823,2021/03/19 00:00:00+00,Fri 19 Mar 2021,10376,6133,2,514323,191939,88,514411,192027,10.9242123490653,4.07795269687849,326
-7.6926,53.28823,2021/03/20 00:00:00+00,Sat 20 Mar 2021,5248,3118,4,519571,195057,92,519663,195149,11.0357456624223,4.14425258345514,327
-7.6926,53.28823,2021/03/21 00:00:00+00,Sun 21 Mar 2021,3641,54,3,523212,195111,95,523307,195206,11.1131309240127,4.1454630554394,328
-7.6926,53.28823,2021/03/22 00:00:00+00,Mon 22 Mar 2021,7416,2409,1,530628,197520,96,530724,197616,11.2706409364211,4.19664266038807,329
-7.6926,53.28823,2021/03/23 00:00:00+00,Tue 23 Mar 2021,12567,7392,4,543195,204912,100,543295,205012,11.5376030998276,4.35370670943384,330
-7.6926,53.28823,2021/03/24 00:00:00+00,Wed 24 Mar 2021,13630,9781,2,556825,214693,102,556927,214795,11.8270970312219,4.56146192736446,331
-7.6926,53.28823,2021/03/25 00:00:00+00,Thu 25 Mar 2021,20876,10224,3,577701,224917,105,577806,225022,12.2704907954224,4.77864608496197,332
-7.6926,53.28823,2021/03/26 00:00:00+00,Fri 26 Mar 2021,19700,9498,1,597401,234415,106,597507,234521,12.6888681386148,4.98037017932187,333
-7.6926,53.28823,2021/03/27 00:00:00+00,Sat 27 Mar 2021,11761,5357,3,609162,239772,109,609271,239881,12.9386925670862,5.09419701854379,334
-7.6926,53.28823,2021/03/28 00:00:00+00,Sun 28 Mar 2021,2492,484,0,611654,240256,109,611763,240365,12.9916135527841,5.10447541223473,335
-7.6926,53.28823,2021/03/28 23:00:00+00,Mon 29 Mar 2021,9279,3122,3,620933,243378,112,621045,243490,13.1887293590636,5.17083900786318,336
-7.6926,53.28823,2021/03/29 23:00:00+00,Tue 30 Mar 2021,13333,8670,4,634266,252048,116,634382,252164,13.4719585670305,5.35504311297717,337
-7.6926,53.28823,2021/03/30 23:00:00+00,Wed 31 Mar 2021,15837,10503,4,650103,262551,120,650223,262671,13.8083635969026,5.57817344874299,338
-7.6926,53.28823,2021/03/31 23:00:00+00,Thu 01 Apr 2021,19694,11570,8,669797,274121,128,669925,274249,14.2267621764456,5.82404791600259,339
-7.6926,53.28823,2021/04/01 23:00:00+00,Fri 02 Apr 2021,20147,13722,9,689944,287843,137,690081,287980,14.6548020591615,6.11564424610637,340
-7.6926,53.28823,2021/04/02 23:00:00+00,Sat 03 Apr 2021,7548,4635,6,697492,292478,143,697635,292621,14.8152214516023,6.2142021492461,341
-7.6926,53.28823,2021/04/03 23:00:00+00,Sun 04 Apr 2021,3039,170,3,700531,292648,146,700677,292794,14.8798224301308,6.21787603790009,342
-7.6926,53.28823,2021/04/04 23:00:00+00,Mon 05 Apr 2021,3435,607,4,703966,293255,150,704116,293405,14.952854239848,6.23085144811737,343
-7.6926,53.28823,2021/04/05 23:00:00+00,Tue 06 Apr 2021,11997,8150,11,715963,301405,161,716124,301566,15.2078603378661,6.40416130537299,344
-7.6926,53.28823,2021/04/06 23:00:00+00,Wed 07 Apr 2021,18371,10472,11,734334,311877,172,734506,312049,15.5982269346156,6.62678196872438,345
-7.6926,53.28823,2021/04/07 23:00:00+00,Thu 08 Apr 2021,20186,10566,16,754520,322443,188,754708,322631,16.0272436894591,6.85150503078528,346
-7.6926,53.28823,2022/05/22 23:00:00+00,Mon 23 May 2022,30,36,0,3847203,3797287,240926,4088129,4038213,86.8169407465469,85.7569070699421,347
-7.6926,53.28823,2021/08/07 23:00:00+00,Sun 08 Aug 2021,8628,11980,153,3267425,2757132,228041,3495466,2985173,74.2309414902439,63.394180432954,348
-7.6926,53.28823,2022/05/23 23:00:00+00,Tue 24 May 2022,77,83,0,3847280,3797370,240926,4088206,4038296,86.8185759455432,85.758669687042,349
-7.6926,53.28823,2021/08/08 23:00:00+00,Mon 09 Aug 2021,5547,23040,600,3272972,2780172,228641,3501613,3008813,74.3614813373889,63.8962077611641,350
-7.6926,53.28823,2022/03/02 00:00:00+00,Wed 02 Mar 2022,206,996,2,3828077,3751178,240908,4068985,3992086,86.4103920506393,84.7773379257649,351
-7.6926,53.28823,2022/05/24 23:00:00+00,Wed 25 May 2022,89,134,1,3847369,3797504,240927,4088296,4038431,86.8204872170973,85.7615365943732,352
-7.6926,53.28823,2021/08/09 23:00:00+00,Tue 10 Aug 2021,9357,26014,716,3282329,2806186,229357,3511686,3035543,74.5753950969938,64.4638554127317,353
-7.6926,53.28823,2022/05/25 23:00:00+00,Thu 26 May 2022,135,155,0,3847504,3797659,240927,4088431,4038586,86.8233541244284,85.7648282287164,354
-7.6926,53.28823,2022/03/03 00:00:00+00,Thu 03 Mar 2022,279,1275,0,3828356,3752453,240908,4069264,3993361,86.4163169924571,84.8044142727813,355
-7.6926,53.28823,2021/08/10 23:00:00+00,Wed 11 Aug 2021,7018,31246,666,3289347,2837432,230023,3519370,3067455,74.7385752150127,65.1415498331141,356
-7.6926,53.28823,2022/05/26 23:00:00+00,Fri 27 May 2022,98,152,0,3847602,3797811,240927,4088529,4038738,86.8254352867874,85.7680561540077,357
-7.6926,53.28823,2022/03/04 00:00:00+00,Fri 04 Mar 2022,735,1507,1,3829091,3753960,240909,4070000,3994869,86.4319469464995,84.8364386894878,358
-7.6926,53.28823,2021/08/11 23:00:00+00,Thu 12 Aug 2021,6778,38300,864,3296125,2875732,230887,3527012,3106619,74.9008634063064,65.9732502680558,359
-7.6926,53.28823,2022/05/27 23:00:00+00,Sat 28 May 2022,335,578,0,3847937,3798389,240927,4088864,4039316,86.8325494642387,85.7803307646552,360
-7.6926,53.28823,2022/03/05 00:00:00+00,Sat 05 Mar 2022,962,3341,0,3830053,3757301,240909,4070962,3998210,86.4523763157777,84.9073893368461,361
-7.6926,53.28823,2021/08/12 23:00:00+00,Fri 13 Aug 2021,10933,28252,873,3307058,2903984,231760,3538818,3135744,75.151579761503,66.591758979313,362
-7.6926,53.28823,2022/05/28 23:00:00+00,Sun 29 May 2022,182,349,0,3848119,3798738,240927,4089046,4039665,86.8364144800481,85.7877422510149,363
-7.6926,53.28823,2022/03/06 00:00:00+00,Sun 06 Mar 2022,455,1914,0,3830508,3759215,240909,4071417,4000124,86.4620388553012,84.9480357118966,364
-7.6926,53.28823,2021/08/13 23:00:00+00,Sat 14 Aug 2021,18139,5847,281,3325197,2909831,232041,3557238,3141872,75.5427533395754,66.7218953357966,365
-7.6926,53.28823,2022/05/29 23:00:00+00,Mon 30 May 2022,11,22,0,3848130,3798760,240927,4089057,4039687,86.8366480799047,85.7882094507282,366
-7.6926,53.28823,2022/03/07 00:00:00+00,Mon 07 Mar 2022,114,124,1,3830622,3759339,240910,4071532,4000249,86.4644810356204,84.9506902557218,367
-7.6926,53.28823,2021/08/14 23:00:00+00,Sun 15 Aug 2021,17001,3733,51,3342198,2913564,232092,3574290,3145656,75.9048755900255,66.8022536864712,368
-7.6926,53.28823,2022/05/30 23:00:00+00,Tue 31 May 2022,66,79,1,3848196,3798839,240928,4089124,4039767,86.838070915395,85.7899083587762,369
-7.6926,53.28823,2022/03/08 00:00:00+00,Tue 08 Mar 2022,120,493,0,3830742,3759832,240910,4071652,4000742,86.4670293976925,84.9611597765681,370
-7.6926,53.28823,2021/08/15 23:00:00+00,Mon 16 Aug 2021,10193,23156,384,3352391,2936720,232476,3584867,3169196,76.1294924703333,67.3021573796212,371
-7.6926,53.28823,2022/05/31 23:00:00+00,Wed 01 Jun 2022,71,100,0,3848267,3798939,240928,4089195,4039867,86.8395786962877,85.7920319938364,372
-7.6926,53.28823,2022/03/09 00:00:00+00,Wed 09 Mar 2022,130,345,1,3830872,3760177,240911,4071783,4001088,86.4698113596212,84.9685075538761,373
-7.6926,53.28823,2021/08/16 23:00:00+00,Tue 17 Aug 2021,12873,26866,528,3365264,2963586,233004,3598268,3196590,76.4140808047388,67.8839059679879,374
-7.6926,53.28823,2022/06/01 23:00:00+00,Thu 02 Jun 2022,120,138,0,3848387,3799077,240928,4089315,4040005,86.8421270583598,85.7949626102193,375
-7.6926,53.28823,2022/03/10 00:00:00+00,Thu 10 Mar 2022,258,509,0,3831130,3760686,240911,4072041,4001597,86.4752903380763,84.979316856332,376
-7.6926,53.28823,2021/08/17 23:00:00+00,Wed 18 Aug 2021,15237,25768,658,3380501,2989354,233662,3614163,3223016,76.7516325975433,68.4450977689727,377
-7.6926,53.28823,2022/06/02 23:00:00+00,Fri 03 Jun 2022,63,144,0,3848450,3799221,240928,4089378,4040149,86.8434649484477,85.7980206447059,378
-7.6926,53.28823,2022/03/11 00:00:00+00,Fri 11 Mar 2022,492,2182,0,3831622,3762868,240911,4072533,4003779,86.4857386225721,85.0256545733437,379
-7.6926,53.28823,2021/08/18 23:00:00+00,Thu 19 Aug 2021,11363,25716,544,3391864,3015070,234206,3626070,3249276,77.0044938241507,69.0027643357577,380
-7.6926,53.28823,2022/06/03 23:00:00+00,Sat 04 Jun 2022,307,606,0,3848757,3799827,240928,4089685,4040755,86.8499845080822,85.8108898731702,381
-7.6926,53.28823,2022/03/12 00:00:00+00,Sat 12 Mar 2022,473,2391,2,3832095,3765259,240913,4073008,4006172,86.4958258891076,85.0764731603321,382
-7.6926,53.28823,2021/08/19 23:00:00+00,Fri 20 Aug 2021,14853,22253,686,3406717,3037323,234892,3641609,3272215,77.3344854761413,69.4899049821965,383
-7.6926,53.28823,2022/06/04 23:00:00+00,Sun 05 Jun 2022,143,273,0,3848900,3800100,240928,4089828,4041028,86.8530213062182,85.8166873968842,384
-7.6926,53.28823,2022/03/13 00:00:00+00,Sun 13 Mar 2022,358,1082,0,3832453,3766341,240913,4073366,4007254,86.5034285026228,85.0994508916825,385
-7.6926,53.28823,2021/08/20 23:00:00+00,Sat 21 Aug 2021,11895,7981,246,3418612,3045304,235138,3653750,3280442,77.5923160087893,69.6646164385918,386
-7.6926,53.28823,2021/08/21 23:00:00+00,Sun 22 Aug 2021,8004,12254,161,3426616,3057558,235299,3661915,3292857,77.7657108114473,69.9282657313045,387
-7.6926,53.28823,2021/08/22 23:00:00+00,Mon 23 Aug 2021,10870,15390,291,3437486,3072948,235590,3673076,3308538,78.0027297205063,70.2612729450805,388
-7.6926,53.28823,2021/08/23 23:00:00+00,Tue 24 Aug 2021,9717,22928,384,3447203,3095876,235974,3683177,3331850,78.217238097928,70.7563347502934,389
-7.6926,53.28823,2021/08/24 23:00:00+00,Wed 25 Aug 2021,9418,19531,316,3456621,3115407,236290,3692911,3351697,78.4239527346792,71.1778126006736,390
-7.6926,53.28823,2021/08/25 23:00:00+00,Thu 26 Aug 2021,8587,19445,369,3465208,3134852,236659,3701867,3371511,78.6141454906627,71.5985896514839,391
-7.6926,53.28823,2021/08/26 23:00:00+00,Fri 27 Aug 2021,9726,19215,432,3474934,3154067,237091,3712025,3391158,78.8298643400687,72.0158202317438,392
-7.6926,53.28823,2021/08/27 23:00:00+00,Sat 28 Aug 2021,9923,7930,153,3484857,3161997,237244,3722101,3399241,79.0438418087255,72.1874736536525,393
-7.6926,53.28823,2021/08/28 23:00:00+00,Sun 29 Aug 2021,8800,9191,30,3493657,3171188,237274,3730931,3408462,79.2313587845332,72.3832940425453,394
-7.6926,53.28823,2021/08/29 23:00:00+00,Mon 30 Aug 2021,5065,11139,84,3498722,3182327,237358,3736080,3419685,79.3407047537783,72.6216296053415,395
-7.6926,53.28823,2021/08/30 23:00:00+00,Tue 31 Aug 2021,4068,12900,145,3502790,3195227,237503,3740293,3432730,79.4301734988608,72.898657798933,396
-7.6926,53.28823,2021/08/31 23:00:00+00,Wed 01 Sep 2021,4966,12541,181,3507756,3207768,237684,3745440,3445452,79.5394769954047,73.1688266512802,397
-7.6926,53.28823,2021/09/01 23:00:00+00,Thu 02 Sep 2021,5011,12363,248,3512767,3220131,237932,3750699,3458063,79.6511589632159,73.4366382687108,398
-7.6926,53.28823,2021/09/02 23:00:00+00,Fri 03 Sep 2021,4776,16076,166,3517543,3236207,238098,3755641,3474305,79.7561090078866,73.7815590751739,399
-7.6926,53.28823,2021/09/03 23:00:00+00,Sat 04 Sep 2021,4628,10584,135,3522171,3246791,238233,3760404,3485024,79.8572577457996,74.0091915172672,400
-7.6926,53.28823,2021/09/04 23:00:00+00,Sun 05 Sep 2021,5309,11905,1,3527480,3258696,238234,3765714,3496930,79.9700227674915,74.2620315075239,401
-7.6926,53.28823,2021/09/05 23:00:00+00,Mon 06 Sep 2021,2163,9683,75,3529643,3268379,238309,3767952,3506688,80.0175497201367,74.4692558166895,402
-7.6926,53.28823,2021/09/06 23:00:00+00,Tue 07 Sep 2021,3031,10025,160,3532674,3278404,238469,3771143,3516873,80.0853149149049,74.6855480475618,403
-7.6926,53.28823,2021/09/07 23:00:00+00,Wed 08 Sep 2021,2611,14800,190,3535285,3293204,238659,3773944,3531863,80.1447979329386,75.0038809430724,404
-7.6926,53.28823,2021/09/08 23:00:00+00,Thu 09 Sep 2021,3117,14813,138,3538402,3308017,238797,3777199,3546814,80.2139222541452,75.3213856209095,405
-7.6926,53.28823,2021/09/09 23:00:00+00,Fri 10 Sep 2021,3386,13945,116,3541788,3321962,238913,3780701,3560875,80.2882919539502,75.6199899467116,406
-7.6926,53.28823,2021/09/10 23:00:00+00,Sat 11 Sep 2021,2560,11340,62,3544348,3333302,238975,3783323,3572277,80.3439736652263,75.8621268162654,407
-7.6926,53.28823,2021/09/11 23:00:00+00,Sun 12 Sep 2021,2043,12883,1,3546391,3346185,238976,3785367,3585161,80.387380765855,76.1357359574101,408
-7.6926,53.28823,2021/09/12 23:00:00+00,Mon 13 Sep 2021,1618,7744,52,3548009,3353929,239028,3787037,3592957,80.4228454713589,76.3012945466963,409
-7.6926,53.28823,2021/09/13 23:00:00+00,Tue 14 Sep 2021,1548,10786,82,3549557,3364715,239110,3788667,3603825,80.4574607228387,76.5320912050291,410
-7.6926,53.28823,2021/09/14 23:00:00+00,Wed 15 Sep 2021,3284,12368,137,3552841,3377083,239247,3792088,3616330,80.530110278245,76.7976517692959,411
-7.6926,53.28823,2021/09/15 23:00:00+00,Thu 16 Sep 2021,1915,10576,115,3554756,3387659,239362,3794118,3627021,80.5732200699653,77.0246895935723,412
-7.6926,53.28823,2021/09/16 23:00:00+00,Fri 17 Sep 2021,2563,14615,94,3557319,3402274,239456,3796775,3641730,80.6296450535124,77.337055074564,413
-7.6926,53.28823,2021/09/17 23:00:00+00,Sat 18 Sep 2021,2289,11233,47,3559608,3413507,239503,3799111,3653010,80.6792531685166,77.5766011093445,414
-7.6926,53.28823,2021/09/18 23:00:00+00,Sun 19 Sep 2021,1862,8491,16,3561470,3421998,239519,3800989,3661517,80.7191350349455,77.7572587439081,415
-7.6926,53.28823,2021/09/19 23:00:00+00,Mon 20 Sep 2021,957,5627,35,3562427,3427625,239554,3801981,3667179,80.7402014947418,77.8774989610116,416
-7.6926,53.28823,2021/09/20 23:00:00+00,Tue 21 Sep 2021,1469,6674,90,3563896,3434299,239644,3803540,3673943,80.7733089653289,78.0211416364774,417
-7.6926,53.28823,2021/09/21 23:00:00+00,Wed 22 Sep 2021,1897,8154,97,3565793,3442453,239741,3805534,3682194,80.8156542484275,78.1963627652871,418
-7.6926,53.28823,2021/09/22 23:00:00+00,Thu 23 Sep 2021,1699,8728,89,3567492,3451181,239830,3807322,3691011,80.8536248433023,78.3836036685371,419
-7.6926,53.28823,2021/09/23 23:00:00+00,Fri 24 Sep 2021,1913,7388,79,3569405,3458569,239909,3809314,3698478,80.8959276536997,78.5421754984756,420
-7.6926,53.28823,2021/09/24 23:00:00+00,Sat 25 Sep 2021,2421,6602,53,3571826,3465171,239962,3811788,3705133,80.9484663850868,78.6835034117259,421
-7.6926,53.28823,2021/09/25 23:00:00+00,Sun 26 Sep 2021,1549,7099,0,3573375,3472270,239962,3813337,3712232,80.9813614921679,78.8342602646431,422
-7.6926,53.28823,2021/09/26 23:00:00+00,Mon 27 Sep 2021,1177,3825,45,3574552,3476095,240007,3814559,3716102,81.0073123126025,78.9164449414694,423
-7.6926,53.28823,2021/09/27 23:00:00+00,Tue 28 Sep 2021,1450,5137,93,3576002,3481232,240100,3816102,3721332,81.04008000158,79.0275110551132,424
-7.6926,53.28823,2021/09/28 23:00:00+00,Wed 29 Sep 2021,1652,3630,80,3577654,3484862,240180,3817834,3725042,81.0768613608211,79.1062979158433,425
-7.6926,53.28823,2021/09/29 23:00:00+00,Thu 30 Sep 2021,1281,3976,78,3578935,3488838,240258,3819193,3729096,81.105721561288,79.1923900811802,426
-7.6926,53.28823,2021/09/30 23:00:00+00,Fri 01 Oct 2021,1861,5185,42,3580796,3494023,240300,3821096,3734323,81.1461343364819,79.3033924857722,427
-7.6926,53.28823,2021/10/01 23:00:00+00,Sat 02 Oct 2021,1705,4096,40,3582501,3498119,240340,3822841,3738459,81.1831917682808,79.3912260318584,428
-7.6926,53.28823,2021/10/02 23:00:00+00,Sun 03 Oct 2021,1196,3021,9,3583697,3501140,240349,3824046,3741489,81.2087815707552,79.4555721741797,429
-7.6926,53.28823,2021/10/03 23:00:00+00,Mon 04 Oct 2021,339,1243,18,3584036,3502383,240367,3824403,3742750,81.2163629479198,79.4823512122877,430
-7.6926,53.28823,2021/10/04 23:00:00+00,Tue 05 Oct 2021,959,2829,70,3584995,3505212,240437,3825432,3745649,81.2382151526883,79.5439153926803,431
-7.6926,53.28823,2021/10/05 23:00:00+00,Wed 06 Oct 2021,975,2577,40,3585970,3507789,240477,3826447,3748266,81.2597700485484,79.5994909222034,432
-7.6926,53.28823,2021/10/06 23:00:00+00,Thu 07 Oct 2021,1215,2704,44,3587185,3510493,240521,3827706,3751014,81.2865066139552,79.6578484136552,433
-7.6926,53.28823,2021/10/07 23:00:00+00,Fri 08 Oct 2021,937,2776,48,3588122,3513269,240569,3828691,3753838,81.3074244192973,79.7178198677528,434
-7.6926,53.28823,2021/10/08 23:00:00+00,Sat 09 Oct 2021,732,2378,23,3588854,3515647,240592,3829446,3756239,81.3234578640011,79.768808345546,435
-7.6926,53.28823,2021/10/09 23:00:00+00,Sun 10 Oct 2021,1508,3919,2,3590362,3519566,240594,3830956,3760160,81.3555247534088,79.8520760762529,436
-7.6926,53.28823,2021/10/10 23:00:00+00,Mon 11 Oct 2021,335,1130,19,3590697,3520696,240613,3831310,3761309,81.3630424215216,79.8764766430936,437
-7.6926,53.28823,2021/10/11 23:00:00+00,Tue 12 Oct 2021,563,1615,20,3591260,3522311,240633,3831893,3762944,81.375423213922,79.9111980763264,438
-7.6926,53.28823,2021/10/12 23:00:00+00,Wed 13 Oct 2021,992,2074,11,3592252,3524385,240644,3832896,3765029,81.3967232735749,79.9554758673297,439
-7.6926,53.28823,2021/10/13 23:00:00+00,Thu 14 Oct 2021,670,1605,8,3592922,3525990,240652,3833574,3766642,81.4111215192825,79.9897301008493,440
-7.6926,53.28823,2021/10/14 23:00:00+00,Fri 15 Oct 2021,957,2075,9,3593879,3528065,240661,3834540,3768726,81.4316358339632,80.033986655502,441
-7.6926,53.28823,2021/10/15 23:00:00+00,Sat 16 Oct 2021,1374,2648,14,3595253,3530713,240675,3835928,3771388,81.4611118885975,80.0905178208021,442
-7.6926,53.28823,2021/10/16 23:00:00+00,Sun 17 Oct 2021,1700,2891,2,3596953,3533604,240677,3837630,3774281,81.4972561573206,80.1519545830911,443
-7.6926,53.28823,2021/10/17 23:00:00+00,Mon 18 Oct 2021,675,1247,6,3597628,3534851,240683,3838311,3775534,81.5117181120799,80.1785637303943,444
-7.6926,53.28823,2021/10/18 23:00:00+00,Tue 19 Oct 2021,1336,1802,13,3598964,3536653,240696,3839660,3777349,81.5403659490408,80.2171077067353,445
-7.6926,53.28823,2021/10/19 23:00:00+00,Wed 20 Oct 2021,2255,2330,0,3601219,3538983,240696,3841915,3779679,81.5882539196463,80.2665884036359,446
-7.6926,53.28823,2021/10/20 23:00:00+00,Thu 21 Oct 2021,1731,1844,11,3602950,3540827,240707,3843657,3781534,81.6252476423934,80.305981834001,447
-7.6926,53.28823,2021/10/21 23:00:00+00,Fri 22 Oct 2021,1505,1932,3,3604455,3542759,240710,3845165,3783469,81.6572720590999,80.3470741724141,448
-7.6926,53.28823,2021/10/22 23:00:00+00,Sat 23 Oct 2021,2018,1701,1,3606473,3544460,240711,3847184,3785171,81.7001482509636,80.3832184411372,449
-7.6926,53.28823,2021/10/23 23:00:00+00,Sun 24 Oct 2021,1952,2186,2,3608425,3546646,240713,3849138,3787359,81.7416440800381,80.4296835762524,450
-7.6926,53.28823,2021/10/24 23:00:00+00,Mon 25 Oct 2021,1227,853,2,3609652,3547499,240715,3850367,3788214,81.7677435549269,80.4478406560164,451
-7.6926,53.28823,2021/10/25 23:00:00+00,Tue 26 Oct 2021,1237,1231,6,3610889,3548730,240721,3851610,3789451,81.794140338724,80.4741100217099,452
-7.6926,53.28823,2021/10/26 23:00:00+00,Wed 27 Oct 2021,1555,1422,6,3612444,3550152,240727,3853171,3790879,81.8272902820124,80.5044355303683,453
-7.6926,53.28823,2021/10/27 23:00:00+00,Thu 28 Oct 2021,2148,1691,5,3614592,3551843,240732,3855324,3792575,81.8730121448565,80.5404523809878,454
-7.6926,53.28823,2021/10/28 23:00:00+00,Fri 29 Oct 2021,2138,1363,2,3616730,3553206,240734,3857464,3793940,81.9184579351429,80.5694399995583,455
-7.6926,53.28823,2022/03/14 00:00:00+00,Mon 14 Mar 2022,109,121,0,3832562,3766462,240913,4073475,4007375,86.5057432648383,85.1020204901052,456
-7.6926,53.28823,2022/03/15 00:00:00+00,Tue 15 Mar 2022,220,756,1,3832782,3767218,240914,4073696,4008132,86.5104364983212,85.1180964075103,457
-7.6926,53.28823,2022/06/05 23:00:00+00,Mon 06 Jun 2022,3,7,1,3848903,3800107,240929,4089832,4041036,86.8531062516206,85.816857287689,458
-7.6926,53.28823,2022/03/16 00:00:00+00,Wed 16 Mar 2022,196,797,0,3832978,3768015,240914,4073892,4008929,86.514598823039,85.1350217789394,459
-7.6926,53.28823,2022/06/06 23:00:00+00,Tue 07 Jun 2022,29,50,0,3848932,3800157,240929,4089861,4041086,86.853722105788,85.8179191052191,460
-7.6926,53.28823,2022/03/18 00:00:00+00,Fri 18 Mar 2022,1,6,0,3832979,3768021,240914,4073893,4008935,86.5146200593896,85.135149197043,461
-7.6926,53.28823,2022/06/07 23:00:00+00,Wed 08 Jun 2022,41,76,0,3848973,3800233,240929,4089902,4041162,86.8545927961627,85.8195330678648,462
-7.6926,53.28823,2022/03/19 00:00:00+00,Sat 19 Mar 2022,744,2778,0,3833723,3770799,240914,4074637,4011713,86.5304199042368,85.1941437790128,463
-7.6926,53.28823,2022/06/08 23:00:00+00,Thu 09 Jun 2022,83,123,0,3849056,3800356,240929,4089985,4041285,86.8563554132626,85.8221451389887,464
-7.6926,53.28823,2022/03/20 00:00:00+00,Sun 20 Mar 2022,395,1402,0,3834118,3772201,240914,4075032,4013115,86.5388082627242,85.2239171425556,465
-7.6926,53.28823,2022/06/09 23:00:00+00,Fri 10 Jun 2022,56,108,0,3849112,3800464,240929,4090041,4041393,86.8575446488962,85.8244386648537,466
-7.6926,53.28823,2022/03/21 00:00:00+00,Mon 21 Mar 2022,55,112,0,3834173,3772313,240914,4075087,4013227,86.5399762620073,85.2262956138229,467
-7.6926,53.28823,2022/06/10 23:00:00+00,Sat 11 Jun 2022,189,561,0,3849301,3801025,240929,4090230,4041954,86.8615583191598,85.8363522575409,468
-7.6926,53.28823,2022/03/22 00:00:00+00,Tue 22 Mar 2022,140,574,0,3834313,3772887,240914,4075227,4013801,86.5429493510915,85.2384852790679,469
-7.6926,53.28823,2022/06/11 23:00:00+00,Sun 12 Jun 2022,143,288,0,3849444,3801313,240929,4090373,4042242,86.8645951172958,85.842468326514,470
-7.6926,53.28823,2022/03/23 00:00:00+00,Wed 23 Mar 2022,102,221,0,3834415,3773108,240914,4075329,4014022,86.5451154588528,85.2431785125508,471
-7.6926,53.28823,2022/06/12 23:00:00+00,Mon 13 Jun 2022,19,44,0,3849463,3801357,240929,4090392,4042286,86.8649986079572,85.8434027259404,472
-7.6926,53.28823,2022/03/24 00:00:00+00,Thu 24 Mar 2022,148,244,0,3834563,3773352,240914,4075477,4014266,86.5482584387417,85.2483601820975,473
-7.6926,53.28823,2022/06/13 23:00:00+00,Tue 14 Jun 2022,39,54,0,3849502,3801411,240929,4090431,4042340,86.8658268256307,85.8445494888729,474
-7.6926,53.28823,2022/03/25 00:00:00+00,Fri 25 Mar 2022,435,1625,0,3834998,3774977,240914,4075912,4015891,86.5574962512532,85.2828692518243,475
-7.6926,53.28823,2022/06/14 23:00:00+00,Wed 15 Jun 2022,70,122,0,3849572,3801533,240929,4090501,4042462,86.8673133701727,85.8471403236462,476
-7.6926,53.28823,2022/03/26 00:00:00+00,Sat 26 Mar 2022,874,1848,1,3835872,3776825,240915,4076787,4017740,86.5760780580292,85.3221352640857,477
-7.6926,53.28823,2022/06/15 23:00:00+00,Thu 16 Jun 2022,81,86,0,3849653,3801619,240929,4090582,4042548,86.8690335145714,85.8489666497979,478
-7.6926,53.28823,2022/03/27 00:00:00+00,Sun 27 Mar 2022,380,803,0,3836252,3777628,240915,4077167,4018543,86.5841478712576,85.3391880536184,479
-7.6926,53.28823,2022/06/16 23:00:00+00,Fri 17 Jun 2022,60,95,0,3849713,3801714,240929,4090642,4042643,86.8703076956075,85.850984103105,480
-7.6926,53.28823,2022/03/27 23:00:00+00,Mon 28 Mar 2022,44,53,1,3836296,3777681,240916,4077212,4018597,86.5851035070346,85.3403348165509,481
-7.6926,53.28823,2022/03/28 23:00:00+00,Tue 29 Mar 2022,138,194,3,3836434,3777875,240919,4077353,4018794,86.5880978324694,85.3445183776193,482
-7.6926,53.28823,2022/03/29 23:00:00+00,Wed 30 Mar 2022,109,135,0,3836543,3778010,240919,4077462,4018929,86.5904125946849,85.3473852849504,483
-7.6926,53.28823,2022/03/30 23:00:00+00,Thu 31 Mar 2022,227,358,0,3836770,3778368,240919,4077689,4019287,86.5952332462714,85.3549878984656,484
-7.6926,53.28823,2022/03/31 23:00:00+00,Fri 01 Apr 2022,304,904,0,3837074,3779272,240919,4077993,4020191,86.6016890968541,85.374185559409,485
-7.6926,53.28823,2022/04/01 23:00:00+00,Sat 02 Apr 2022,730,1539,0,3837804,3780811,240919,4078723,4021730,86.6171916327929,85.4068683029841,486
-7.6926,53.28823,2022/04/02 23:00:00+00,Sun 03 Apr 2022,538,815,0,3838342,3781626,240919,4079261,4022545,86.6286167894163,85.424175928724,487
-7.6926,53.28823,2022/04/03 23:00:00+00,Mon 04 Apr 2022,50,52,0,3838392,3781678,240919,4079311,4022597,86.6296786069464,85.4252802189553,488
-7.6926,53.28823,2022/04/04 23:00:00+00,Tue 05 Apr 2022,130,169,0,3838522,3781847,240919,4079441,4022766,86.6324393325245,85.4288691622069,489
-7.6926,53.28823,2022/04/05 23:00:00+00,Wed 06 Apr 2022,159,210,0,3838681,3782057,240919,4079600,4022976,86.6358159122701,85.4333287958331,490
-7.6926,53.28823,2022/04/06 23:00:00+00,Thu 07 Apr 2022,117,178,0,3838798,3782235,240919,4079717,4023154,86.6383005652904,85.4371088662401,491
-7.6926,53.28823,2022/04/07 23:00:00+00,Fri 08 Apr 2022,258,421,2,3839056,3782656,240921,4079977,4023577,86.6438220164467,85.4460918425443,492
-7.6926,53.28823,2022/04/08 23:00:00+00,Sat 09 Apr 2022,559,1018,0,3839615,3783674,240921,4080536,4024595,86.6556931364327,85.4677104474563,493
-7.6926,53.28823,2022/04/09 23:00:00+00,Sun 10 Apr 2022,412,719,0,3840027,3784393,240921,4080948,4025314,86.6644425128804,85.4829793835385,494
-7.6926,53.28823,2022/04/10 23:00:00+00,Mon 11 Apr 2022,70,92,1,3840097,3784485,240922,4081019,4025407,86.6659502937731,85.4849543641444,495
-7.6926,53.28823,2022/04/11 23:00:00+00,Tue 12 Apr 2022,198,177,0,3840295,3784662,240922,4081217,4025584,86.6701550911921,85.4887131982008,496
-7.6926,53.28823,2022/04/12 23:00:00+00,Wed 13 Apr 2022,144,232,0,3840439,3784894,240922,4081361,4025816,86.6732131256786,85.4936400315402,497
-7.6926,53.28823,2022/04/13 23:00:00+00,Thu 14 Apr 2022,360,431,0,3840799,3785325,240922,4081721,4026247,86.680858211895,85.5027928986493,498
-7.6926,53.28823,2022/04/14 23:00:00+00,Fri 15 Apr 2022,446,991,0,3841245,3786316,240922,4082167,4027238,86.6903296242631,85.523838122095,499
-7.6926,53.28823,2022/04/15 23:00:00+00,Sat 16 Apr 2022,42,88,0,3841287,3786404,240922,4082209,4027326,86.6912215509884,85.5257069209479,500
-7.6926,53.28823,2022/04/16 23:00:00+00,Sun 17 Apr 2022,1,0,0,3841288,3786404,240922,4082210,4027326,86.691242787339,85.5257069209479,501
-7.6926,53.28823,2022/04/17 23:00:00+00,Mon 18 Apr 2022,36,62,1,3841324,3786466,240923,4082247,4027389,86.6920285323112,85.5270448110358,502
-7.6926,53.28823,2022/04/18 23:00:00+00,Tue 19 Apr 2022,218,269,1,3841542,3786735,240924,4082466,4027659,86.6966792930929,85.5327786256981,503
-7.6926,53.28823,2022/04/19 23:00:00+00,Wed 20 Apr 2022,250,606,0,3841792,3787341,240924,4082716,4028265,86.7019883807431,85.5456478541623,504
-7.6926,53.28823,2022/04/20 23:00:00+00,Thu 21 Apr 2022,171,236,0,3841963,3787577,240924,4082887,4028501,86.7056197966959,85.5506596329042,505
-7.6926,53.28823,2022/04/21 23:00:00+00,Fri 22 Apr 2022,196,254,0,3842159,3787831,240924,4083083,4028755,86.7097821214137,85.5560536659569,506
-7.6926,53.28823,2022/04/22 23:00:00+00,Sat 23 Apr 2022,324,1010,0,3842483,3788841,240924,4083407,4029765,86.7166626990085,85.577502380064,507
-7.6926,53.28823,2022/04/23 23:00:00+00,Sun 24 Apr 2022,181,252,0,3842664,3789093,240924,4083588,4030017,86.7205064784673,85.5828539404155,508
-7.6926,53.28823,2022/04/24 23:00:00+00,Mon 25 Apr 2022,42,58,1,3842706,3789151,240925,4083631,4030076,86.7214196415431,85.5841068851009,509
-7.6926,53.28823,2022/04/25 23:00:00+00,Tue 26 Apr 2022,145,238,0,3842851,3789389,240925,4083776,4030314,86.7244989123803,85.589161136544,510
-7.6926,53.28823,2022/04/26 23:00:00+00,Wed 27 Apr 2022,122,208,0,3842973,3789597,240925,4083898,4030522,86.7270897471536,85.593578297469,511
-7.6926,53.28823,2022/04/27 23:00:00+00,Thu 28 Apr 2022,103,130,0,3843076,3789727,240925,4084001,4030652,86.7292770912656,85.5963390230472,512
-7.6926,53.28823,2022/04/28 23:00:00+00,Fri 29 Apr 2022,171,222,0,3843247,3789949,240925,4084172,4030874,86.7329085072183,85.6010534928806,513
-7.6926,53.28823,2022/04/29 23:00:00+00,Sat 30 Apr 2022,282,723,0,3843529,3790672,240925,4084454,4031597,86.7388971580879,85.6164073743652,514
-7.6926,53.28823,2022/04/30 23:00:00+00,Sun 01 May 2022,187,746,0,3843716,3791418,240925,4084641,4032343,86.7428683556503,85.6322496919136,515
-7.6926,53.28823,2022/05/01 23:00:00+00,Mon 02 May 2022,13,26,0,3843729,3791444,240925,4084654,4032369,86.7431444282081,85.6328018370293,516
-7.6926,53.28823,2022/05/02 23:00:00+00,Tue 03 May 2022,101,118,0,3843830,3791562,240925,4084755,4032487,86.7452892996188,85.6353077264002,517
-7.6926,53.28823,2022/05/03 23:00:00+00,Wed 04 May 2022,116,128,0,3843946,3791690,240925,4084871,4032615,86.7477527162885,85.6380259792771,518
-7.6926,53.28823,2022/05/04 23:00:00+00,Thu 05 May 2022,117,164,0,3844063,3791854,240925,4084988,4032779,86.7502373693088,85.6415087407757,519
-7.6926,53.28823,2022/05/05 23:00:00+00,Fri 06 May 2022,140,256,0,3844203,3792110,240925,4085128,4033035,86.753210458393,85.6469452465296,520
-7.6926,53.28823,2022/05/06 23:00:00+00,Sat 07 May 2022,442,1087,0,3844645,3793197,240925,4085570,4034122,86.7625969253587,85.670029159633,521
-7.6926,53.28823,2022/05/07 23:00:00+00,Sun 08 May 2022,275,437,0,3844920,3793634,240925,4085845,4034559,86.768436921774,85.6793094448457,522
-7.6926,53.28823,2022/05/08 23:00:00+00,Mon 09 May 2022,27,32,0,3844947,3793666,240925,4085872,4034591,86.7690103032402,85.6799890080649,523
-7.6926,53.28823,2022/05/09 23:00:00+00,Tue 10 May 2022,84,98,1,3845031,3793764,240926,4085957,4034690,86.7708153930413,85.6820914067744,524
-7.6926,53.28823,2022/05/10 23:00:00+00,Wed 11 May 2022,123,132,0,3845154,3793896,240926,4086080,4034822,86.7734274641653,85.6848946050538,525
-7.6926,53.28823,2022/05/11 23:00:00+00,Thu 12 May 2022,248,398,0,3845402,3794294,240926,4086328,4035220,86.7786940791143,85.693346672593,526
-7.6926,53.28823,2022/05/12 23:00:00+00,Fri 13 May 2022,182,326,0,3845584,3794620,240926,4086510,4035546,86.7825590949237,85.700269722889,527
-7.6926,53.28823,2022/05/13 23:00:00+00,Sat 14 May 2022,333,633,0,3845917,3795253,240926,4086843,4036179,86.7896307996739,85.7137123328195,528
-7.6926,53.28823,2022/05/14 23:00:00+00,Sun 15 May 2022,169,254,0,3846086,3795507,240926,4087012,4036433,86.7932197429255,85.7191063658722,529
-7.6926,53.28823,2022/05/15 23:00:00+00,Mon 16 May 2022,32,42,0,3846118,3795549,240926,4087044,4036475,86.7938993061447,85.7199982925974,530
-7.6926,53.28823,2022/05/16 23:00:00+00,Tue 17 May 2022,97,99,0,3846215,3795648,240926,4087141,4036574,86.795959232153,85.7221006913069,531
-7.6926,53.28823,2022/05/17 23:00:00+00,Wed 18 May 2022,103,121,0,3846318,3795769,240926,4087244,4036695,86.7981465762649,85.7246702897297,532
-7.6926,53.28823,2022/05/18 23:00:00+00,Thu 19 May 2022,100,104,0,3846418,3795873,240926,4087344,4036799,86.800270211325,85.7268788701922,533
-7.6926,53.28823,2022/05/19 23:00:00+00,Fri 20 May 2022,128,208,0,3846546,3796081,240926,4087472,4037007,86.802988464202,85.7312960311172,534
-7.6926,53.28823,2022/05/20 23:00:00+00,Sat 21 May 2022,393,761,0,3846939,3796842,240926,4087865,4037768,86.8113343499882,85.7474568939246,535
-7.6926,53.28823,2022/05/21 23:00:00+00,Sun 22 May 2022,234,409,0,3847173,3797251,240926,4088099,4038177,86.8163036560289,85.7561425613205,536
-7.6926,53.28823,2022/06/17 23:00:00+00,Sat 18 Jun 2022,223,487,0,3849936,3802201,240929,4090865,4043130,86.8750434017915,85.8613262058478,537
-7.6926,53.28823,2022/06/18 23:00:00+00,Sun 19 Jun 2022,80,129,0,3850016,3802330,240929,4090945,4043259,86.8767423098396,85.8640656950753,538
-7.6926,53.28823,2022/06/19 23:00:00+00,Mon 20 Jun 2022,9,27,0,3850025,3802357,240929,4090954,4043286,86.876933436995,85.8646390765415,539
-7.6926,53.28823,2022/06/20 23:00:00+00,Tue 21 Jun 2022,79,168,1,3850104,3802525,240930,4091034,4043455,86.8786323450431,85.8682280197931,540
-7.6926,53.28823,2022/06/21 23:00:00+00,Wed 22 Jun 2022,60,95,0,3850164,3802620,240930,4091094,4043550,86.8799065260792,85.8702454731002,541
-7.6926,53.28823,2022/06/22 23:00:00+00,Thu 23 Jun 2022,65,114,0,3850229,3802734,240930,4091159,4043664,86.8812868888683,85.8726664170688,542
-7.6926,53.28823,2022/06/23 23:00:00+00,Fri 24 Jun 2022,56,92,1,3850285,3802826,240931,4091216,4043757,86.8824973608525,85.8746413976747,543
-7.6926,53.28823,2022/06/24 23:00:00+00,Sat 25 Jun 2022,210,292,0,3850495,3803118,240931,4091426,4044049,86.8869569944788,85.8808424120502,544
-7.6926,53.28823,2022/06/25 23:00:00+00,Sun 26 Jun 2022,174,403,0,3850669,3803521,240931,4091600,4044452,86.8906521194834,85.8894006613424,545
-7.6926,53.28823,2022/06/26 23:00:00+00,Mon 27 Jun 2022,4,33,0,3850673,3803554,240931,4091604,4044485,86.8907370648858,85.8901014609123,546
-7.6926,53.28823,2022/06/27 23:00:00+00,Tue 28 Jun 2022,47,60,0,3850720,3803614,240931,4091651,4044545,86.891735173364,85.8913756419483,547
-7.6926,53.28823,2022/06/28 23:00:00+00,Wed 29 Jun 2022,63,81,3,3850783,3803695,240934,4091717,4044629,86.8931367725037,85.8931594953988,548
-7.6926,53.28823,2022/06/29 23:00:00+00,Thu 30 Jun 2022,73,86,0,3850856,3803781,240934,4091790,4044715,86.8946870260976,85.8949858215505,549
-7.6926,53.28823,2022/06/30 23:00:00+00,Fri 01 Jul 2022,49,62,0,3850905,3803843,240934,4091839,4044777,86.895727607277,85.8963024752878,550
-7.6926,53.28823,2022/07/01 23:00:00+00,Sat 02 Jul 2022,182,228,0,3851087,3804071,240934,4092021,4045005,86.8995926230864,85.9011443632248,551
-7.6926,53.28823,2022/07/02 23:00:00+00,Sun 03 Jul 2022,108,273,0,3851195,3804344,240934,4092129,4045278,86.9018861489513,85.906941886939,552
-7.6926,53.28823,2022/07/03 23:00:00+00,Mon 04 Jul 2022,14,15,0,3851209,3804359,240934,4092143,4045293,86.9021834578597,85.907260432198,553
-7.6926,53.28823,2022/07/04 23:00:00+00,Tue 05 Jul 2022,53,69,0,3851262,3804428,240934,4092196,4045362,86.9033089844416,85.9087257403894,554
-7.6926,53.28823,2022/07/05 23:00:00+00,Wed 06 Jul 2022,64,82,0,3851326,3804510,240934,4092260,4045444,86.9046681108801,85.9104671211387,555
-7.6926,53.28823,2022/07/06 23:00:00+00,Thu 07 Jul 2022,80,74,0,3851406,3804584,240934,4092340,4045518,86.9063670189282,85.9120386110832,556
-7.6926,53.28823,2022/07/07 23:00:00+00,Fri 08 Jul 2022,101,88,0,3851507,3804672,240934,4092441,4045606,86.9085118903389,85.9139074099361,557
-7.6926,53.28823,2022/07/08 23:00:00+00,Sat 09 Jul 2022,120,142,0,3851627,3804814,240934,4092561,4045748,86.911060252411,85.9169229717215,558
-7.6926,53.28823,2022/07/09 23:00:00+00,Sun 10 Jul 2022,131,219,0,3851758,3805033,240934,4092692,4045967,86.9138422143398,85.9215737325031,559
-7.6926,53.28823,2022/07/10 23:00:00+00,Mon 11 Jul 2022,12,15,0,3851770,3805048,240934,4092704,4045982,86.914097050547,85.9218922777621,560
-7.6926,53.28823,2022/07/11 23:00:00+00,Tue 12 Jul 2022,43,80,0,3851813,3805128,240934,4092747,4046062,86.9150102136228,85.9235911858102,561
-7.6926,53.28823,2022/07/12 23:00:00+00,Wed 13 Jul 2022,99,73,0,3851912,3805201,240934,4092846,4046135,86.9171126123323,85.9251414394041,562
-7.6926,53.28823,2022/07/13 23:00:00+00,Thu 14 Jul 2022,71,39,0,3851983,3805240,240934,4092917,4046174,86.918620393225,85.9259696570775,563
-7.6926,53.28823,2022/07/14 23:00:00+00,Fri 15 Jul 2022,79,116,1,3852062,3805356,240935,4092997,4046291,86.9203193012731,85.9284543100979,564
-7.6926,53.28823,2022/07/15 23:00:00+00,Sat 16 Jul 2022,124,209,0,3852186,3805565,240935,4093121,4046500,86.9229526087476,85.9328927073735,565
-7.6926,53.28823,2022/07/16 23:00:00+00,Sun 17 Jul 2022,119,165,0,3852305,3805730,240935,4093240,4046665,86.9254797344692,85.9363967052227,566
-7.6926,53.28823,2022/07/17 23:00:00+00,Mon 18 Jul 2022,14,17,0,3852319,3805747,240935,4093254,4046682,86.9257770433776,85.9367577231829,567
-7.6926,53.28823,2022/07/18 23:00:00+00,Tue 19 Jul 2022,29,33,0,3852348,3805780,240935,4093283,4046715,86.926392897545,85.9374585227527,568
-7.6926,53.28823,2022/07/19 23:00:00+00,Wed 20 Jul 2022,77,66,0,3852425,3805846,240935,4093360,4046781,86.9280280965413,85.9388601218924,569
-7.6926,53.28823,2022/07/20 23:00:00+00,Thu 21 Jul 2022,51,30,0,3852476,3805876,240935,4093411,4046811,86.929111150422,85.9394972124104,570
-7.6926,53.28823,2022/07/21 23:00:00+00,Fri 22 Jul 2022,72,69,0,3852548,3805945,240935,4093483,4046880,86.9306401676652,85.9409625206019,571
-7.6926,53.28823,2022/07/22 23:00:00+00,Sat 23 Jul 2022,97,175,0,3852645,3806120,240935,4093580,4047055,86.9327000936735,85.9446788819571,572
-7.6926,53.28823,2022/07/23 23:00:00+00,Sun 24 Jul 2022,107,232,0,3852752,3806352,240935,4093687,4047287,86.9349723831879,85.9496057152966,573
-7.6926,53.28823,2022/07/24 23:00:00+00,Mon 25 Jul 2022,13,22,0,3852765,3806374,240935,4093700,4047309,86.9352484557457,85.9500729150098,574
-7.6926,53.28823,2022/07/25 23:00:00+00,Tue 26 Jul 2022,18,16,0,3852783,3806390,240935,4093718,4047325,86.9356307100565,85.9504126966194,575
-7.6926,53.28823,2022/07/26 23:00:00+00,Wed 27 Jul 2022,60,72,1,3852843,3806462,240936,4093779,4047398,86.9369261274432,85.9519629502133,576
-7.6926,53.28823,2022/07/27 23:00:00+00,Thu 28 Jul 2022,48,71,0,3852891,3806533,240936,4093827,4047469,86.937945472272,85.953470731106,577
-7.6926,53.28823,2022/07/28 23:00:00+00,Fri 29 Jul 2022,70,105,0,3852961,3806638,240936,4093897,4047574,86.9394320168141,85.9557005479191,578
-7.6926,53.28823,2022/07/29 23:00:00+00,Sat 30 Jul 2022,99,118,0,3853060,3806756,240936,4093996,4047692,86.9415344155236,85.95820643729,579
-7.6926,53.28823,2022/07/30 23:00:00+00,Sun 31 Jul 2022,31,57,0,3853091,3806813,240936,4094027,4047749,86.9421927423922,85.9594169092743,580
-7.6926,53.28823,2022/07/31 23:00:00+00,Mon 01 Aug 2022,9,14,0,3853100,3806827,240936,4094036,4047763,86.9423838695476,85.9597142181827,581
-7.6926,53.28823,2022/08/01 23:00:00+00,Tue 02 Aug 2022,35,27,0,3853135,3806854,240936,4094071,4047790,86.9431271418187,85.9602875996489,582
-7.6926,53.28823,2022/08/02 23:00:00+00,Wed 03 Aug 2022,93,139,0,3853228,3806993,240936,4094164,4047929,86.9451021224246,85.9632394523825,583
-7.6926,53.28823,2022/08/03 23:00:00+00,Thu 04 Aug 2022,44,51,0,3853272,3807044,240936,4094208,4047980,86.946036521851,85.9643225062631,584
-7.6926,53.28823,2022/08/04 23:00:00+00,Fri 05 Aug 2022,95,91,0,3853367,3807135,240936,4094303,4048071,86.9480539751581,85.9662550141678,585
-7.6926,53.28823,2022/08/05 23:00:00+00,Sat 06 Aug 2022,71,131,0,3853438,3807266,240936,4094374,4048202,86.9495617560508,85.9690369760966,586
-7.6926,53.28823,2022/08/06 23:00:00+00,Sun 07 Aug 2022,28,80,0,3853466,3807346,240936,4094402,4048282,86.9501563738676,85.9707358841447,587
-7.6926,53.28823,2022/08/07 23:00:00+00,Mon 08 Aug 2022,11,16,0,3853477,3807362,240936,4094413,4048298,86.9503899737243,85.9710756657543,588
-7.6926,53.28823,2022/08/08 23:00:00+00,Tue 09 Aug 2022,47,39,0,3853524,3807401,240936,4094460,4048337,86.9513880822025,85.9719038834277,589
-7.6926,53.28823,2022/08/09 23:00:00+00,Wed 10 Aug 2022,54,94,0,3853578,3807495,240936,4094514,4048431,86.952534845135,85.9739001003842,590
-7.6926,53.28823,2022/08/10 23:00:00+00,Thu 11 Aug 2022,45,38,0,3853623,3807533,240936,4094559,4048469,86.953490480912,85.9747070817071,591
-7.6926,53.28823,2022/08/11 23:00:00+00,Fri 12 Aug 2022,70,75,0,3853693,3807608,240936,4094629,4048544,86.9549770254541,85.9762998080022,592
-7.6926,53.28823,2022/08/12 23:00:00+00,Sat 13 Aug 2022,101,151,0,3853794,3807759,240936,4094730,4048695,86.9571218968648,85.9795064969429,593
-7.6926,53.28823,2022/08/13 23:00:00+00,Sun 14 Aug 2022,18,26,0,3853812,3807785,240936,4094748,4048721,86.9575041511756,85.9800586420586,594
-7.6926,53.28823,2022/08/14 23:00:00+00,Mon 15 Aug 2022,13,7,0,3853825,3807792,240936,4094761,4048728,86.9577802237335,85.9802072965128,595
-7.6926,53.28823,2022/08/15 23:00:00+00,Tue 16 Aug 2022,40,28,0,3853865,3807820,240936,4094801,4048756,86.9586296777575,85.9808019143296,596
-7.6926,53.28823,2022/08/16 23:00:00+00,Wed 17 Aug 2022,52,56,0,3853917,3807876,240936,4094853,4048812,86.9597339679888,85.9819911499632,597
-7.6926,53.28823,2022/08/17 23:00:00+00,Thu 18 Aug 2022,82,38,0,3853999,3807914,240936,4094935,4048850,86.961475348738,85.9827981312861,598
-7.6926,53.28823,2022/08/18 23:00:00+00,Fri 19 Aug 2022,68,56,0,3854067,3807970,240936,4095003,4048906,86.9629194205789,85.9839873669198,599
-7.6926,53.28823,2022/08/19 23:00:00+00,Sat 20 Aug 2022,109,127,0,3854176,3808097,240936,4095112,4049033,86.9652341827944,85.9866843834461,600
-7.6926,53.28823,2022/08/20 23:00:00+00,Sun 21 Aug 2022,38,36,0,3854214,3808133,240936,4095150,4049069,86.9660411641173,85.9874488920677,601
-7.6926,53.28823,2022/08/21 23:00:00+00,Mon 22 Aug 2022,9,12,0,3854223,3808145,240936,4095159,4049081,86.9662322912727,85.987703728275,602
-7.6926,53.28823,2022/08/22 23:00:00+00,Tue 23 Aug 2022,79,71,0,3854302,3808216,240936,4095238,4049152,86.9679099629702,85.9892115091676,603
-7.6926,53.28823,2022/08/23 23:00:00+00,Wed 24 Aug 2022,57,51,0,3854359,3808267,240936,4095295,4049203,86.9691204349544,85.9902945630483,604
-7.6926,53.28823,2022/08/24 23:00:00+00,Thu 25 Aug 2022,66,46,0,3854425,3808313,240936,4095361,4049249,86.9705220340941,85.9912714351759,605
-7.6926,53.28823,2022/08/25 23:00:00+00,Fri 26 Aug 2022,91,81,0,3854516,3808394,240936,4095452,4049330,86.9724545419988,85.9929915795746,606
-7.6926,53.28823,2022/08/26 23:00:00+00,Sat 27 Aug 2022,85,119,0,3854601,3808513,240936,4095537,4049449,86.9742596317999,85.9955187052962,607
-7.6926,53.28823,2022/08/27 23:00:00+00,Sun 28 Aug 2022,44,20,0,3854645,3808533,240936,4095581,4049469,86.9751940312264,85.9959434323082,608
-7.6926,53.28823,2022/08/28 23:00:00+00,Mon 29 Aug 2022,12,11,0,3854657,3808544,240936,4095593,4049480,86.9754488674336,85.9961770321648,609
-7.6926,53.28823,2022/08/29 23:00:00+00,Tue 30 Aug 2022,36,42,0,3854693,3808586,240936,4095629,4049522,86.9762133760552,85.99706895889,610
-7.6926,53.28823,2022/08/30 23:00:00+00,Wed 31 Aug 2022,25,28,0,3854718,3808614,240936,4095654,4049550,86.9767442848202,85.9976635767069,611
