X,Y,VaccinationDate,VaccineText,Dose1,Dose2,SingleDose,Dose1Cum,Dose2Cum,SingleDoseCum,PartiallyVacc,FullyVacc,PartialPercent,FullyPercent,ObjectId
-7.6926,53.28823,2021/04/21 23:00:00+00,Thu 22 Apr 2021,31635,12189,1,982045,411894,267,982312,412161,20.4711495359297,8.58933766855982,1
-7.6926,53.28823,2020/12/28 00:00:00+00,Mon 28 Dec 2020,260,16,2,260,16,2,262,18,0.0054600179763798,0.000375115738835253,2
-7.6926,53.28823,2021/04/22 23:00:00+00,Fri 23 Apr 2021,33612,12362,3,1015657,424256,270,1015927,424526,21.1716781782046,8.84702134137637,3
-7.6926,53.28823,2020/12/29 00:00:00+00,Tue 29 Dec 2020,79,3,0,339,19,2,341,21,0.00710635927460118,0.000437635028641129,4
-7.6926,53.28823,2021/04/23 23:00:00+00,Sat 24 Apr 2021,23707,7004,2,1039364,431260,272,1039636,431532,21.6657681255404,8.99302472283636,5
-7.6926,53.28823,2020/12/30 00:00:00+00,Wed 30 Dec 2020,1063,2,0,1402,21,2,1404,23,0.0292590276291497,0.000479314555178379,6
-7.6926,53.28823,2021/04/24 23:00:00+00,Sun 25 Apr 2021,9755,309,3,1049119,431569,275,1049394,431844,21.8691225355156,8.99952672897617,7
-7.6926,53.28823,2020/12/31 00:00:00+00,Thu 31 Dec 2020,1039,1,0,2441,22,2,2443,24,0.0509115416652513,0.000500154318447004,8
-7.6926,53.28823,2021/04/25 23:00:00+00,Mon 26 Apr 2021,15600,3059,4,1064719,434628,279,1064998,434907,22.1943062015593,9.06335892386797,9
-7.6926,53.28823,2021/01/01 00:00:00+00,Fri 01 Jan 2021,818,0,0,3259,22,2,3261,24,0.0679584680189867,0.000500154318447004,10
-7.6926,53.28823,2021/04/26 23:00:00+00,Tue 27 Apr 2021,25920,7824,9,1090639,442452,288,1090927,442740,22.7346604233515,9.22659678955111,11
-7.6926,53.28823,2021/01/02 00:00:00+00,Sat 02 Jan 2021,1019,0,0,4278,22,2,4280,24,0.0891941867897157,0.000500154318447004,12
-7.6926,53.28823,2021/04/27 23:00:00+00,Wed 28 Apr 2021,26046,8622,5,1116685,451074,293,1116978,451367,23.2775570962624,9.40638142726954,13
-7.6926,53.28823,2022/07/26 23:00:00+00,Wed 27 Jul 2022,60,72,1,3854807,3808666,241042,4095849,4049708,85.3565235440351,84.3949560270575,14
-7.6926,53.28823,2021/01/03 00:00:00+00,Sun 03 Jan 2021,23,3,1,4301,25,3,4304,28,0.0896943411081628,0.000583513371521505,15
-7.6926,53.28823,2021/04/28 23:00:00+00,Thu 29 Apr 2021,31695,11331,6,1148380,462405,299,1148679,462704,23.9381984316411,9.64264182344594,16
-7.6926,53.28823,2021/01/04 00:00:00+00,Mon 04 Jan 2021,1197,5,0,5498,30,3,5501,33,0.114639537740707,0.000687712187864631,17
-7.6926,53.28823,2022/07/27 23:00:00+00,Thu 28 Jul 2022,49,71,0,3854856,3808737,241042,4095898,4049779,85.3575446924353,84.3964356502496,18
-7.6926,53.28823,2021/04/29 23:00:00+00,Fri 30 Apr 2021,36099,13543,8,1184479,475948,307,1184786,476255,24.6906597639813,9.92504145549908,19
-7.6926,53.28823,2021/01/05 00:00:00+00,Tue 05 Jan 2021,3541,13,0,9039,43,3,9042,46,0.188433139474909,0.000958629110356758,20
-7.6926,53.28823,2022/07/28 23:00:00+00,Fri 29 Jul 2022,71,105,0,3854927,3808842,241042,4095969,4049884,85.3590243156274,84.3986238253928,21
-7.6926,53.28823,2021/04/30 23:00:00+00,Sat 01 May 2021,16605,6699,20,1201084,482647,327,1201411,482974,25.0371208283222,10.065063824901,22
-7.6926,53.28823,2022/07/29 23:00:00+00,Sat 30 Jul 2022,100,119,0,3855027,3808961,241042,4096069,4050003,85.3611082919543,84.4011037572218,23
-7.6926,53.28823,2021/01/06 00:00:00+00,Wed 06 Jan 2021,6787,13,0,15826,56,3,15829,59,0.329872612779068,0.00122954603284889,24
-7.6926,53.28823,2021/05/01 23:00:00+00,Sun 02 May 2021,12471,911,16,1213555,483558,343,1213898,483901,25.2973469522576,10.084382285451,25
-7.6926,53.28823,2022/07/30 23:00:00+00,Sun 31 Jul 2022,32,57,0,3855059,3809018,241042,4096101,4050060,85.3617751643788,84.4022916237281,26
-7.6926,53.28823,2021/01/07 00:00:00+00,Thu 07 Jan 2021,11737,9,0,27563,65,3,27566,68,0.574468914262922,0.00141710390226651,27
-7.6926,53.28823,2021/05/02 23:00:00+00,Mon 03 May 2021,14273,931,21,1227828,484489,364,1228192,484853,25.5952305284193,10.1042217400827,28
-7.6926,53.28823,2021/08/14 23:00:00+00,Sun 15 Aug 2021,17003,3739,52,3344066,2914917,232161,3576227,3147078,74.5277240748656,65.5843605078984,29
-7.6926,53.28823,2022/07/31 23:00:00+00,Mon 01 Aug 2022,9,15,0,3855068,3809033,241042,4096110,4050075,85.3619627222483,84.4026042201771,30
-7.6926,53.28823,2021/01/08 00:00:00+00,Fri 08 Jan 2021,12686,6,0,40249,71,3,40252,74,0.8388421510887,0.00154214248187826,31
-7.6926,53.28823,2021/05/03 23:00:00+00,Tue 04 May 2021,26665,6802,10,1254493,491291,374,1254867,491665,26.1511312136099,10.2461822074686,32
-7.6926,53.28823,2022/08/01 23:00:00+00,Tue 02 Aug 2022,36,28,0,3855104,3809061,241042,4096146,4050103,85.3627129537259,84.4031877335486,33
-7.6926,53.28823,2021/08/15 23:00:00+00,Mon 16 Aug 2021,10201,23167,386,3354267,2938084,232547,3586814,3170631,74.7483546485905,66.0751994521643,34
-7.6926,53.28823,2021/01/09 00:00:00+00,Sat 09 Jan 2021,8077,7,0,48326,78,3,48329,81,1.00716491900939,0.00168802082475864,35
-7.6926,53.28823,2021/05/04 23:00:00+00,Wed 05 May 2021,32126,13465,70,1286619,504756,444,1287063,505200,26.8220882318065,10.5282484033094,36
-7.6926,53.28823,2021/08/16 23:00:00+00,Tue 17 Aug 2021,12877,26873,530,3367144,2964957,233077,3600221,3198034,75.027753354733,66.6462714850144,37
-7.6926,53.28823,2021/01/10 00:00:00+00,Sun 10 Jan 2021,4787,4,1,53113,82,4,53117,86,1.10694570553956,0.00179221964110177,38
-7.6926,53.28823,2022/08/02 23:00:00+00,Wed 03 Aug 2022,93,139,0,3855197,3809200,241042,4096239,4050242,85.3646510517099,84.406084460643,39
-7.6926,53.28823,2021/05/05 23:00:00+00,Thu 06 May 2021,37300,14383,133,1323919,519139,577,1324496,519716,27.602183090241,10.8307584069168,40
-7.6926,53.28823,2021/01/11 00:00:00+00,Mon 11 Jan 2021,8347,8,0,61460,90,4,61464,94,1.28089520954278,0.00195893774725077,41
-7.6926,53.28823,2021/08/17 23:00:00+00,Wed 18 Aug 2021,15242,25780,658,3382386,2990737,233735,3616121,3224472,75.3591055907041,67.1972331463104,42
-7.6926,53.28823,2021/05/06 23:00:00+00,Fri 07 May 2021,40598,15090,98,1364517,534229,675,1365192,534904,28.4502780962209,11.1472727314407,43
-7.6926,53.28823,2022/08/03 23:00:00+00,Thu 04 Aug 2022,45,52,0,3855242,3809252,241042,4096284,4050294,85.365588841057,84.4071681283329,44
-7.6926,53.28823,2021/01/12 00:00:00+00,Tue 12 Jan 2021,8896,13,0,70356,103,4,70360,107,1.46628574358047,0.00222985466974289,45
-7.6926,53.28823,2021/05/07 23:00:00+00,Sat 08 May 2021,25632,7063,10,1390149,541292,685,1390834,541977,28.984651305955,11.2946723770397,46
-7.6926,53.28823,2021/08/18 23:00:00+00,Thu 19 Aug 2021,11372,25729,545,3393758,3016466,234280,3628038,3250746,75.6074530495763,67.7447770864302,47
-7.6926,53.28823,2022/08/04 23:00:00+00,Fri 05 Aug 2022,96,91,0,3855338,3809343,241042,4096380,4050385,85.3675894583308,84.4090645467904,48
-7.6926,53.28823,2021/01/13 00:00:00+00,Wed 13 Jan 2021,9899,4,0,80255,107,4,80259,111,1.67257856017659,0.00231321372281739,49
-7.6926,53.28823,2021/05/08 23:00:00+00,Sun 09 May 2021,19675,931,5,1409824,542223,690,1410514,542913,29.3947778470816,11.3141783954591,50
-7.6926,53.28823,2022/08/05 23:00:00+00,Sat 06 Aug 2022,74,130,0,3855412,3809473,241042,4096454,4050515,85.3691316008127,84.4117737160153,51
-7.6926,53.28823,2021/05/09 23:00:00+00,Mon 10 May 2021,28856,4657,171,1438680,546880,861,1439541,547741,29.99969365548,11.41479277252,52
-7.6926,53.28823,2021/05/10 23:00:00+00,Tue 11 May 2021,33926,14819,153,1472606,561699,1014,1473620,562713,30.7098919479114,11.7268057081779,53
-7.6926,53.28823,2021/05/11 23:00:00+00,Wed 12 May 2021,31302,20932,175,1503908,582631,1189,1505097,583820,31.3658651763179,12.1666705914887,54
-7.6926,53.28823,2021/05/12 23:00:00+00,Thu 13 May 2021,36008,25486,152,1539916,608117,1341,1541257,609458,32.1194310161114,12.7009604421698,55
-7.6926,53.28823,2021/05/13 23:00:00+00,Fri 14 May 2021,38234,27953,237,1578150,636070,1578,1579728,637648,32.9211575488187,13.2884333687123,56
-7.6926,53.28823,2021/05/14 23:00:00+00,Sat 15 May 2021,28877,12463,22,1607027,648533,1600,1608627,650133,33.5234058675187,13.5486178131211,57
-7.6926,53.28823,2021/05/15 23:00:00+00,Sun 16 May 2021,23187,1182,11,1630214,649715,1611,1631825,651326,34.0068466958243,13.5734796507006,58
-7.6926,53.28823,2021/05/16 23:00:00+00,Mon 17 May 2021,35399,3958,120,1665613,653673,1731,1667344,655404,34.7470542473626,13.65846420531,59
-7.6926,53.28823,2021/05/17 23:00:00+00,Tue 18 May 2021,39024,12511,127,1704637,666184,1858,1706495,668042,35.5629518190925,13.9218371334989,60
-7.6926,53.28823,2021/05/18 23:00:00+00,Wed 19 May 2021,37038,17604,211,1741675,683788,2069,1743744,685857,36.3392121610855,14.2930975161295,61
-7.6926,53.28823,2021/05/19 23:00:00+00,Thu 20 May 2021,39098,19644,136,1780773,703432,2205,1782978,705637,37.1568394331668,14.7053080335829,62
-7.6926,53.28823,2021/05/20 23:00:00+00,Fri 21 May 2021,25846,23257,14934,1806619,726689,17139,1823758,743828,38.0066849792613,15.5011994325749,63
-7.6926,53.28823,2021/05/21 23:00:00+00,Sat 22 May 2021,16594,10257,13523,1823213,736946,30662,1853875,767608,38.6343161296225,15.9967690031028,64
-7.6926,53.28823,2021/05/22 23:00:00+00,Sun 23 May 2021,8225,5535,10205,1831438,742481,40867,1872305,783348,39.0183929666633,16.324786876951,65
-7.6926,53.28823,2021/05/23 23:00:00+00,Mon 24 May 2021,22558,8238,8452,1853996,750719,49319,1903315,800038,39.6646340256233,16.6726025259043,66
-7.6926,53.28823,2021/05/24 23:00:00+00,Tue 25 May 2021,30361,16516,3224,1884357,767235,52543,1936900,819778,40.3645374750001,17.083979452827,67
-7.6926,53.28823,2021/05/25 23:00:00+00,Wed 26 May 2021,19987,25475,3054,1904344,792710,55597,1959941,848307,40.8447064604725,17.6785170591176,68
-7.6926,53.28823,2021/05/26 23:00:00+00,Thu 27 May 2021,17019,36057,550,1921363,828767,56147,1977510,884914,41.210840261339,18.4413982730922,69
-7.6926,53.28823,2021/05/27 23:00:00+00,Fri 28 May 2021,27054,31836,1562,1948417,860603,57709,2006126,918312,41.8071909270339,19.1374046867377,70
-7.6926,53.28823,2021/05/28 23:00:00+00,Sat 29 May 2021,24497,7397,537,1972914,868000,58246,2031160,926246,42.3288935607007,19.302747368511,71
-7.6926,53.28823,2021/05/29 23:00:00+00,Sun 30 May 2021,24260,1687,210,1997174,869687,58456,2055630,928143,42.838842567884,19.3422803994316,72
-7.6926,53.28823,2021/05/30 23:00:00+00,Mon 31 May 2021,22602,7316,3445,2019776,877003,61901,2081677,938904,43.3816558817418,19.5665370919652,73
-7.6926,53.28823,2021/05/31 23:00:00+00,Tue 01 Jun 2021,27602,11526,3654,2047378,888529,65555,2112933,954084,44.033023522466,19.882884698383,74
-7.6926,53.28823,2021/06/01 23:00:00+00,Wed 02 Jun 2021,18717,20918,4008,2066095,909447,69563,2135658,979010,44.5066071427455,20.4023366376167,75
-7.6926,53.28823,2021/06/02 23:00:00+00,Thu 03 Jun 2021,16699,30709,1978,2082794,940156,71541,2154335,1011697,44.8958314013136,21.0835259795783,76
-7.6926,53.28823,2021/06/03 23:00:00+00,Fri 04 Jun 2021,28996,23347,153,2111790,963503,71694,2183484,1035197,45.5032896608308,21.573260416391,77
-7.6926,53.28823,2021/06/04 23:00:00+00,Sat 05 Jun 2021,20976,11502,35,2132766,975005,71729,2204495,1046734,45.9411539268678,21.8136887652211,78
-7.6926,53.28823,2021/06/05 23:00:00+00,Sun 06 Jun 2021,19951,3918,47,2152717,978923,71776,2224493,1050699,46.3579075127138,21.8963184265812,79
-7.6926,53.28823,2021/06/06 23:00:00+00,Mon 07 Jun 2021,19845,4605,47,2172562,983528,71823,2244385,1055351,46.7724520836533,21.9932650053068,80
-7.6926,53.28823,2021/06/07 23:00:00+00,Tue 08 Jun 2021,26423,18347,47,2198985,1001875,71870,2270855,1073745,47.3240806173738,22.3765916108699,81
-7.6926,53.28823,2021/06/08 23:00:00+00,Wed 09 Jun 2021,32818,20128,175,2231803,1022003,72045,2303848,1094048,48.0116469268956,22.7997013245128,82
-7.6926,53.28823,2021/06/09 23:00:00+00,Thu 10 Jun 2021,27710,27508,273,2259513,1049511,72318,2331831,1121829,48.5948060224415,23.3786507878785,83
-7.6926,53.28823,2021/06/10 23:00:00+00,Fri 11 Jun 2021,26457,32915,42,2285970,1082426,72360,2358330,1154786,49.1470389092968,24.0654668659226,84
-7.6926,53.28823,2021/06/11 23:00:00+00,Sat 12 Jun 2021,12223,19730,105,2298193,1102156,72465,2370658,1174621,49.4039515108724,24.4788235703558,85
-7.6926,53.28823,2021/06/12 23:00:00+00,Sun 13 Jun 2021,8558,18178,835,2306751,1120334,73300,2380051,1193634,49.5996994072546,24.8750499893821,86
-7.6926,53.28823,2021/06/13 23:00:00+00,Mon 14 Jun 2021,16028,31313,52,2322779,1151647,73352,2396131,1224999,49.9348028006141,25.5286891643026,87
-7.6926,53.28823,2021/06/14 23:00:00+00,Tue 15 Jun 2021,14709,41596,206,2337488,1193243,73558,2411046,1266801,50.2456278697657,26.3998329484576,88
-7.6926,53.28823,2021/06/15 23:00:00+00,Wed 16 Jun 2021,13482,48400,219,2350970,1241643,73777,2424747,1315420,50.5311534663091,27.4130413988149,89
-7.6926,53.28823,2021/06/16 23:00:00+00,Thu 17 Jun 2021,21580,42696,535,2372550,1284339,74312,2446862,1358651,50.9920248309947,28.3139652046809,90
-7.6926,53.28823,2021/06/17 23:00:00+00,Fri 18 Jun 2021,12021,50026,554,2384571,1334365,74866,2459437,1409231,51.2540848540977,29.3680404308079,91
-7.6926,53.28823,2021/06/18 23:00:00+00,Sat 19 Jun 2021,6329,32820,434,2390900,1367185,75300,2466200,1442485,51.3950241730834,30.0610459185428,92
-7.6926,53.28823,2021/06/19 23:00:00+00,Sun 20 Jun 2021,8523,26147,178,2399423,1393332,75478,2474901,1468810,51.5763509532837,30.6096526865893,93
-7.6926,53.28823,2021/06/20 23:00:00+00,Mon 21 Jun 2021,15494,32345,575,2414917,1425677,76053,2490970,1501730,51.9112251092472,31.2956976933925,94
-7.6926,53.28823,2021/06/21 23:00:00+00,Tue 22 Jun 2021,15152,43553,722,2430069,1469230,76775,2506844,1546005,52.2420355113734,32.2183782121109,95
-7.6926,53.28823,2021/06/22 23:00:00+00,Wed 23 Jun 2021,20105,39409,884,2450174,1508639,77659,2527833,1586298,52.6794413026186,33.0580747934936,96
-7.6926,53.28823,2021/06/23 23:00:00+00,Thu 24 Jun 2021,19029,44277,1032,2469203,1552916,78691,2547894,1631607,53.0975077935505,34.0023036274317,97
-7.6926,53.28823,2021/06/24 23:00:00+00,Fri 25 Jun 2021,15219,50128,843,2484422,1603044,79534,2563956,1682578,53.4322360711711,35.0645272009968,98
-7.6926,53.28823,2021/12/08 00:00:00+00,Wed 08 Dec 2021,795,1526,2,3672257,3611792,240958,3913215,3852750,81.5504742192331,80.2903979331956,99
-7.6926,53.28823,2021/08/19 23:00:00+00,Fri 20 Aug 2021,14860,22271,686,3408618,3038737,234966,3643584,3273703,75.9314280093504,68.223195531788,100
-7.6926,53.28823,2021/06/25 23:00:00+00,Sat 26 Jun 2021,9072,30575,512,2493494,1633619,80046,2573540,1713665,53.6319643623376,35.7123729217286,101
-7.6926,53.28823,2021/06/26 23:00:00+00,Sun 27 Jun 2021,8741,30483,59,2502235,1664102,80105,2582340,1744207,53.8153542791015,36.3488609714789,102
-7.6926,53.28823,2021/06/27 23:00:00+00,Mon 28 Jun 2021,24246,24666,527,2526481,1688768,80632,2607113,1769400,54.3316177345552,36.8738771275054,103
-7.6926,53.28823,2021/06/28 23:00:00+00,Tue 29 Jun 2021,28152,31058,812,2554633,1719826,81444,2636077,1801270,54.9352206378676,37.5380403828765,104
-7.6926,53.28823,2021/06/29 23:00:00+00,Wed 30 Jun 2021,22585,36882,589,2577218,1756708,82033,2659251,1838741,55.4181613118548,38.3189271523151,105
-7.6926,53.28823,2021/06/30 23:00:00+00,Thu 01 Jul 2021,15046,48306,642,2592264,1805014,82675,2674939,1887689,55.745095518013,39.3389918847878,106
-7.6926,53.28823,2021/07/01 23:00:00+00,Fri 02 Jul 2021,13692,47273,817,2605956,1852287,83492,2689448,1935779,56.0474596432774,40.341176100376,107
-7.6926,53.28823,2021/07/02 23:00:00+00,Sat 03 Jul 2021,9322,30487,506,2615278,1882774,83998,2699276,1966772,56.2522728366815,40.9870628833605,108
-7.6926,53.28823,2021/07/03 23:00:00+00,Sun 04 Jul 2021,6460,27786,233,2621738,1910560,84231,2705969,1994791,56.3917533722384,41.5709722103841,109
-7.6926,53.28823,2021/07/04 23:00:00+00,Mon 05 Jul 2021,15630,33476,5342,2637368,1944036,89573,2726941,2033609,56.828804887508,42.3799301409456,110
-7.6926,53.28823,2021/07/05 23:00:00+00,Tue 06 Jul 2021,12407,48303,5488,2649775,1992339,95061,2744836,2087400,57.2017324512001,43.5009218469282,111
-7.6926,53.28823,2021/07/06 23:00:00+00,Wed 07 Jul 2021,19710,43767,5059,2669485,2036106,100120,2769605,2136226,57.7179125476006,44.5184441282821,112
-7.6926,53.28823,2021/07/07 23:00:00+00,Thu 08 Jul 2021,17796,45609,5997,2687281,2081715,106117,2793398,2187832,58.213753035051,45.5939009515228,113
-7.6926,53.28823,2021/07/08 23:00:00+00,Fri 09 Jul 2021,13530,45098,6531,2700811,2126813,112648,2813459,2239461,58.6318195259829,46.6698370893186,114
-7.6926,53.28823,2021/07/09 23:00:00+00,Sat 10 Jul 2021,8644,23882,4364,2709455,2150695,117012,2826467,2267707,58.9029031665812,47.2584770426042,115
-7.6926,53.28823,2021/07/10 23:00:00+00,Sun 11 Jul 2021,15241,16122,2153,2724696,2166817,119165,2843861,2285982,59.2653900088756,47.6393237163383,116
-7.6926,53.28823,2021/07/11 23:00:00+00,Mon 12 Jul 2021,17123,31783,6092,2741819,2198600,125257,2867076,2323857,59.7491851131568,48.4286297501375,117
-7.6926,53.28823,2021/07/12 23:00:00+00,Tue 13 Jul 2021,20116,36576,8490,2761935,2235176,133747,2895682,2368923,60.3453273812191,49.3677945216014,118
-7.6926,53.28823,2021/07/13 23:00:00+00,Wed 14 Jul 2021,20804,35725,9335,2782739,2270901,143082,2925821,2413983,60.9734170063722,50.3068342544856,119
-7.6926,53.28823,2021/07/14 23:00:00+00,Thu 15 Jul 2021,23660,28844,9585,2806399,2299745,152667,2959066,2452412,61.6662349362376,51.1076855171356,120
-7.6926,53.28823,2021/07/15 23:00:00+00,Fri 16 Jul 2021,23519,27436,9168,2829918,2327181,161835,2991753,2489016,62.3474242781992,51.8705042118204,121
-7.6926,53.28823,2021/07/16 23:00:00+00,Sat 17 Jul 2021,11518,19434,4677,2841436,2346615,166512,3007948,2513127,62.6849242443346,52.3729717439902,122
-7.6926,53.28823,2021/07/17 23:00:00+00,Sun 18 Jul 2021,16870,15824,1931,2858306,2362439,168443,3026749,2530882,63.076732633548,52.7429817408246,123
-7.6926,53.28823,2021/07/18 23:00:00+00,Mon 19 Jul 2021,24905,18451,6253,2883211,2380890,174696,3057907,2555586,63.7260579774718,53.2578072526127,124
-7.6926,53.28823,2021/07/19 23:00:00+00,Tue 20 Jul 2021,30600,18188,7699,2913811,2399078,182395,3096206,2581473,64.5242000708969,53.7972862043476,125
-7.6926,53.28823,2021/07/20 23:00:00+00,Wed 21 Jul 2021,30370,19851,6894,2944181,2418929,189289,3133470,2608218,65.3007730093389,54.354645672967,126
-7.6926,53.28823,2021/07/21 23:00:00+00,Thu 22 Jul 2021,33545,15940,6937,2977726,2434869,196226,3173952,2631095,66.1444083059794,54.8313969372634,127
-7.6926,53.28823,2021/07/22 23:00:00+00,Fri 23 Jul 2021,27085,20843,5615,3004811,2455712,201841,3206652,2657553,66.8258685648635,55.3827753938246,128
-7.6926,53.28823,2021/07/23 23:00:00+00,Sat 24 Jul 2021,15444,14819,2276,3020255,2470531,204117,3224372,2674648,67.1951491699835,55.7390311469018,129
-7.6926,53.28823,2021/07/24 23:00:00+00,Sun 25 Jul 2021,14741,13651,1046,3034996,2484182,205163,3240159,2689345,67.5241465127053,56.0453131476608,130
-7.6926,53.28823,2021/07/25 23:00:00+00,Mon 26 Jul 2021,23850,18317,3422,3058846,2502499,208585,3267431,2711084,68.0924885365672,56.4983487613574,131
-7.6926,53.28823,2021/07/26 23:00:00+00,Tue 27 Jul 2021,25525,23917,3672,3084371,2526416,212257,3296628,2738673,68.7009471047213,57.0732969901755,132
-7.6926,53.28823,2021/07/27 23:00:00+00,Wed 28 Jul 2021,23447,25296,3265,3107818,2551712,215522,3323340,2767234,69.2576188611528,57.6685014688907,133
-7.6926,53.28823,2021/07/28 23:00:00+00,Thu 29 Jul 2021,19293,27879,2962,3127111,2579591,218484,3345595,2798075,69.721407792696,58.3112206078584,134
-7.6926,53.28823,2021/07/29 23:00:00+00,Fri 30 Jul 2021,21963,22956,2123,3149074,2602547,220607,3369681,2823154,70.2233543307841,58.8338610308722,135
-7.6926,53.28823,2021/07/30 23:00:00+00,Sat 31 Jul 2021,13754,12494,907,3162828,2615041,221514,3384342,2836555,70.5288861000655,59.1131346984351,136
-7.6926,53.28823,2021/07/31 23:00:00+00,Sun 01 Aug 2021,11142,9347,369,3173970,2624388,221883,3395853,2846271,70.7687726150506,59.315613838353,137
-7.6926,53.28823,2021/08/01 23:00:00+00,Mon 02 Aug 2021,15032,16045,430,3189002,2640433,222313,3411315,2862746,71.0909970347101,59.6589489382036,138
-7.6926,53.28823,2021/08/02 23:00:00+00,Tue 03 Aug 2021,17355,25461,1111,3206357,2665894,223424,3429781,2889318,71.4758241032285,60.2127031277775,139
-7.6926,53.28823,2021/08/03 23:00:00+00,Wed 04 Aug 2021,22128,17313,1575,3228485,2683207,224999,3453484,2908206,71.9697890119847,60.6063245763953,140
-7.6926,53.28823,2021/08/04 23:00:00+00,Thu 05 Aug 2021,13545,30059,1421,3242030,2713266,226420,3468450,2939686,72.281676909063,61.2623603240917,141
-7.6926,53.28823,2021/08/05 23:00:00+00,Fri 06 Aug 2021,12220,24751,949,3254250,2738017,227369,3481619,2965386,72.5561157515475,61.7979422400953,142
-7.6926,53.28823,2021/08/06 23:00:00+00,Sat 07 Aug 2021,6342,8468,583,3260592,2746485,227952,3488544,2974437,72.7004311121827,61.9865629374397,143
-7.6926,53.28823,2021/08/07 23:00:00+00,Sun 08 Aug 2021,8633,11990,153,3269225,2758475,228105,3497330,2986580,72.8835292722609,62.2396201828106,144
-7.6926,53.28823,2021/08/08 23:00:00+00,Mon 09 Aug 2021,5556,23046,600,3274781,2781521,228705,3503486,3010226,73.0118188549425,62.7323972250605,145
-7.6926,53.28823,2021/08/09 23:00:00+00,Tue 10 Aug 2021,9377,26021,717,3284158,2807542,229422,3513580,3036964,73.222175425376,63.289610815337,146
-7.6926,53.28823,2021/08/10 23:00:00+00,Wed 11 Aug 2021,7027,31246,666,3291185,2838788,230088,3521273,3068876,73.3824957242016,63.9546493407653,147
-7.6926,53.28823,2021/08/11 23:00:00+00,Thu 12 Aug 2021,6790,38304,865,3297975,2877092,230953,3528928,3108045,73.5420241120229,64.7709220282341,148
-7.6926,53.28823,2021/08/12 23:00:00+00,Fri 13 Aug 2021,10942,28232,875,3308917,2905324,231828,3540745,3137152,73.7882875945682,65.377505017694,149
-7.6926,53.28823,2021/08/13 23:00:00+00,Sat 14 Aug 2021,18146,5854,281,3327063,2911178,232109,3559172,3143287,74.1723019123192,65.505356965347,150
-7.6926,53.28823,2021/01/14 00:00:00+00,Thu 14 Jan 2021,8096,6,0,88351,113,4,88355,117,1.84129728359938,0.00243825230242915,151
-7.6926,53.28823,2022/08/06 23:00:00+00,Sun 07 Aug 2022,28,80,0,3855440,3809553,241042,4096482,4050595,85.3697151141842,84.4134408970768,152
-7.6926,53.28823,2021/01/15 00:00:00+00,Fri 15 Jan 2021,7699,4,0,96050,117,4,96054,121,2.00174262100452,0.00252161135550365,153
-7.6926,53.28823,2021/12/09 00:00:00+00,Thu 09 Dec 2021,784,1212,1,3673041,3613004,240959,3914000,3853963,81.5668334333989,80.3156765660405,154
-7.6926,53.28823,2022/08/07 23:00:00+00,Mon 08 Aug 2022,11,15,0,3855451,3809568,241042,4096493,4050610,85.3699443515801,84.4137534935258,155
-7.6926,53.28823,2021/01/16 00:00:00+00,Sat 16 Jan 2021,5245,2,0,101295,119,4,101299,123,2.11104717934846,0.0025632908820409,156
-7.6926,53.28823,2022/08/08 23:00:00+00,Tue 09 Aug 2022,47,42,0,3855498,3809610,241042,4096540,4050652,85.3709238204538,84.4146287635831,157
-7.6926,53.28823,2021/08/20 23:00:00+00,Sat 21 Aug 2021,11902,7992,246,3420520,3046729,235212,3655732,3281941,76.1845894535376,68.394873501595,158
-7.6926,53.28823,2021/01/17 00:00:00+00,Sun 17 Jan 2021,1115,5,0,102410,124,4,102414,128,2.13428351539298,0.00266748969838402,159
-7.6926,53.28823,2021/08/21 23:00:00+00,Sun 22 Aug 2021,8005,12260,162,3428525,3058989,235374,3663899,3294363,76.3547878001525,68.6537450409178,160
-7.6926,53.28823,2021/01/18 00:00:00+00,Mon 18 Jan 2021,8724,9,1,111134,133,5,111139,138,2.31611044991173,0.00287588733107027,161
-7.6926,53.28823,2021/12/10 00:00:00+00,Fri 10 Dec 2021,895,1619,1,3673936,3614623,240960,3914896,3855583,81.5855058612876,80.3494369825357,162
-7.6926,53.28823,2021/08/22 23:00:00+00,Mon 23 Aug 2021,10878,15397,291,3439403,3074386,235665,3675068,3310051,76.5875471160998,68.980679247076,163
-7.6926,53.28823,2022/08/09 23:00:00+00,Wed 10 Aug 2022,55,94,0,3855553,3809704,241042,4096595,4050746,85.3720700074335,84.4165877013303,164
-7.6926,53.28823,2021/01/19 00:00:00+00,Tue 19 Jan 2021,8393,21,0,119527,154,5,119532,159,2.4910185830253,0.0033135223597114,165
-7.6926,53.28823,2021/12/11 00:00:00+00,Sat 11 Dec 2021,643,844,2,3674579,3615467,240962,3915541,3856429,81.5989475085959,80.3670674222609,166
-7.6926,53.28823,2022/04/02 23:00:00+00,Sun 03 Apr 2022,538,815,0,3840648,3783784,241024,4081672,4024808,85.0610782201758,83.8760459216687,167
-7.6926,53.28823,2021/08/23 23:00:00+00,Tue 24 Aug 2021,9720,22930,384,3449123,3097316,236049,3685172,3333365,76.798112084166,69.4665374879208,168
-7.6926,53.28823,2022/08/10 23:00:00+00,Thu 11 Aug 2022,45,39,0,3855598,3809743,241042,4096640,4050785,85.3730077967806,84.4174004520978,169
-7.6926,53.28823,2021/01/20 00:00:00+00,Wed 20 Jan 2021,8450,964,0,127977,1118,5,127982,1123,2.66711458264519,0.0234030541506661,170
-7.6926,53.28823,2021/12/12 00:00:00+00,Sun 12 Dec 2021,685,1193,0,3675264,3616660,240962,3916226,3857622,81.6132227464349,80.3919292598404,171
-7.6926,53.28823,2022/04/03 23:00:00+00,Mon 04 Apr 2022,50,51,0,3840698,3783835,241024,4081722,4024859,85.0621202083393,83.8771087495955,172
-7.6926,53.28823,2021/08/24 23:00:00+00,Wed 25 Aug 2021,9425,19545,317,3458548,3116861,236366,3694914,3353227,77.0011330579289,69.8804568659622,173
-7.6926,53.28823,2022/08/11 23:00:00+00,Fri 12 Aug 2022,70,75,0,3855668,3809818,241042,4096710,4050860,85.3744665802094,84.418963434343,174
-7.6926,53.28823,2021/01/21 00:00:00+00,Thu 21 Jan 2021,9010,964,0,136987,2082,5,136992,2087,2.8548808496955,0.0434925859416207,175
-7.6926,53.28823,2021/12/13 00:00:00+00,Mon 13 Dec 2021,721,1071,1,3675985,3617731,240963,3916948,3858694,81.6282690555148,80.4142694860644,176
-7.6926,53.28823,2022/04/04 23:00:00+00,Tue 05 Apr 2022,130,169,0,3840828,3784004,241024,4081852,4025028,85.0648293775642,83.8806306695878,177
-7.6926,53.28823,2021/08/25 23:00:00+00,Thu 26 Aug 2021,8596,19453,369,3467144,3136314,236735,3703879,3373049,77.1879615356321,70.2935426534729,178
-7.6926,53.28823,2022/08/12 23:00:00+00,Sat 13 Aug 2022,103,151,0,3855771,3809969,241042,4096813,4051011,85.3766130758261,84.4221102385965,179
-7.6926,53.28823,2021/01/22 00:00:00+00,Fri 22 Jan 2021,6790,970,0,143777,3052,5,143782,3057,2.99638284228946,0.0637071563121872,180
-7.6926,53.28823,2021/12/14 00:00:00+00,Tue 14 Dec 2021,632,1203,3,3676617,3618934,240966,3917583,3859900,81.6415023051904,80.4394022405663,181
-7.6926,53.28823,2022/04/05 23:00:00+00,Wed 06 Apr 2022,158,210,0,3840986,3784214,241024,4082010,4025238,85.0681220601606,83.8850070198743,182
-7.6926,53.28823,2021/08/26 23:00:00+00,Fri 27 Aug 2021,9731,19227,432,3476875,3155541,237167,3714042,3392708,77.3997560497312,70.7032315595708,183
-7.6926,53.28823,2022/08/13 23:00:00+00,Sun 14 Aug 2022,17,26,0,3855788,3809995,241042,4096830,4051037,85.3769673518017,84.4226520724415,184
-7.6926,53.28823,2021/01/23 00:00:00+00,Sat 23 Jan 2021,4199,460,0,147976,3512,5,147981,3517,3.08388900825442,0.0732934474157547,185
-7.6926,53.28823,2021/12/15 00:00:00+00,Wed 15 Dec 2021,790,1258,1,3677407,3620192,240967,3918374,3861159,81.6579865579359,80.4656395025215,186
-7.6926,53.28823,2022/04/06 23:00:00+00,Thu 07 Apr 2022,117,178,0,3841103,3784392,241024,4082127,4025416,85.0705603124631,83.8887164977361,187
-7.6926,53.28823,2021/08/27 23:00:00+00,Sat 28 Aug 2021,9932,7940,153,3486807,3163481,237320,3724127,3400801,77.6099250622953,70.8718877637038,188
-7.6926,53.28823,2022/08/14 23:00:00+00,Mon 15 Aug 2022,7,11,0,3855795,3810006,241042,4096837,4051048,85.3771132301446,84.4228813098375,189
-7.6926,53.28823,2021/01/24 00:00:00+00,Sun 24 Jan 2021,1188,399,0,149164,3911,5,149169,3916,3.10864664701755,0.0816085129599362,190
-7.6926,53.28823,2021/12/16 00:00:00+00,Thu 16 Dec 2021,1046,1545,8,3678453,3621737,240975,3919428,3862712,81.679951668421,80.4980036548777,191
-7.6926,53.28823,2022/04/07 23:00:00+00,Fri 08 Apr 2022,256,422,2,3841359,3784814,241026,4082385,4025840,85.0759369713864,83.897552557362,192
-7.6926,53.28823,2021/08/28 23:00:00+00,Sun 29 Aug 2021,8801,9196,30,3495608,3172677,237350,3732958,3410027,77.7939610117205,71.0641554196201,193
-7.6926,53.28823,2022/08/15 23:00:00+00,Tue 16 Aug 2022,41,28,0,3855836,3810034,241042,4096878,4051076,85.3779676604386,84.423464823209,194
-7.6926,53.28823,2021/01/25 00:00:00+00,Mon 25 Jan 2021,1368,1292,0,150532,5203,5,150537,5208,3.13715544316903,0.108533487103,195
-7.6926,53.28823,2021/12/17 00:00:00+00,Fri 17 Dec 2021,1197,2459,1,3679650,3624196,240976,3920626,3865172,81.7049177048168,80.5492694725185,196
-7.6926,53.28823,2022/04/08 23:00:00+00,Sat 09 Apr 2022,558,1018,0,3841917,3785832,241026,4082943,4026858,85.0875655592903,83.9187674363694,197
-7.6926,53.28823,2021/08/29 23:00:00+00,Mon 30 Aug 2021,5073,11153,85,3500681,3183830,237435,3738116,3421265,77.9014525106601,71.2983526792329,198
-7.6926,53.28823,2022/08/16 23:00:00+00,Wed 17 Aug 2022,51,58,0,3855887,3810092,241042,4096929,4051134,85.3790304883653,84.4246735294786,199
-7.6926,53.28823,2022/08/17 23:00:00+00,Thu 18 Aug 2022,55,39,0,3855942,3810131,241042,4096984,4051173,85.380176675345,84.425486280246,200
-7.6926,53.28823,2022/08/18 23:00:00+00,Fri 19 Aug 2022,72,56,0,3856014,3810187,241042,4097056,4051229,85.3816771383004,84.4266533069891,201
-7.6926,53.28823,2022/08/19 23:00:00+00,Sat 20 Aug 2022,108,127,0,3856122,3810314,241042,4097164,4051356,85.3839278327334,84.4292999569242,202
-7.6926,53.28823,2022/08/20 23:00:00+00,Sun 21 Aug 2022,39,36,0,3856161,3810350,241042,4097203,4051392,85.3847405835009,84.4300501884019,203
-7.6926,53.28823,2022/08/21 23:00:00+00,Mon 22 Aug 2022,12,13,0,3856173,3810363,241042,4097215,4051405,85.3849906606601,84.4303211053244,204
-7.6926,53.28823,2022/08/22 23:00:00+00,Tue 23 Aug 2022,77,72,0,3856250,3810435,241042,4097292,4051477,85.3865953224318,84.4318215682797,205
-7.6926,53.28823,2022/08/23 23:00:00+00,Wed 24 Aug 2022,53,55,0,3856303,3810490,241042,4097345,4051532,85.387699829885,84.4329677552595,206
-7.6926,53.28823,2022/08/24 23:00:00+00,Thu 25 Aug 2022,40,49,0,3856343,3810539,241042,4097385,4051581,85.3885334204158,84.4339889036597,207
-7.6926,53.28823,2022/08/25 23:00:00+00,Fri 26 Aug 2022,98,89,0,3856441,3810628,241042,4097483,4051670,85.3905757172161,84.4358436425906,208
-7.6926,53.28823,2022/08/26 23:00:00+00,Sat 27 Aug 2022,86,119,0,3856527,3810747,241042,4097569,4051789,85.3923679368572,84.4383235744195,209
-7.6926,53.28823,2022/08/27 23:00:00+00,Sun 28 Aug 2022,44,20,0,3856571,3810767,241042,4097613,4051809,85.393284886441,84.4387403696849,210
-7.6926,53.28823,2022/08/28 23:00:00+00,Mon 29 Aug 2022,13,12,0,3856584,3810779,241042,4097626,4051821,85.3935558033635,84.4389904468441,211
-7.6926,53.28823,2022/08/29 23:00:00+00,Tue 30 Aug 2022,41,44,0,3856625,3810823,241042,4097667,4051865,85.3944102336575,84.4399073964279,212
-7.6926,53.28823,2022/08/30 23:00:00+00,Wed 31 Aug 2022,28,30,0,3856653,3810853,241042,4097695,4051895,85.394993747029,84.440532589326,213
-7.6926,53.28823,2022/08/31 23:00:00+00,Thu 01 Sep 2022,32,29,0,3856685,3810882,241042,4097727,4051924,85.3956606194536,84.4411369424608,214
-7.6926,53.28823,2022/09/01 23:00:00+00,Fri 02 Sep 2022,47,51,0,3856732,3810933,241042,4097774,4051975,85.3966400883273,84.4421997703875,215
-7.6926,53.28823,2022/09/02 23:00:00+00,Sat 03 Sep 2022,73,101,0,3856805,3811034,241042,4097847,4052076,85.3981613910459,84.4443045864776,216
-7.6926,53.28823,2022/09/03 23:00:00+00,Sun 04 Sep 2022,58,82,0,3856863,3811116,241042,4097905,4052158,85.3993700973154,84.4460134470657,217
-7.6926,53.28823,2022/09/04 23:00:00+00,Mon 05 Sep 2022,9,5,0,3856872,3811121,241042,4097914,4052163,85.3995576551849,84.446117645882,218
-7.6926,53.28823,2022/09/05 23:00:00+00,Tue 06 Sep 2022,42,22,0,3856914,3811143,241042,4097956,4052185,85.4004329252421,84.4465761206739,219
-7.6926,53.28823,2022/09/06 23:00:00+00,Wed 07 Sep 2022,49,42,0,3856963,3811185,241042,4098005,4052227,85.4014540736423,84.4474513907312,220
-7.6926,53.28823,2022/09/07 23:00:00+00,Thu 08 Sep 2022,39,49,2,3857002,3811234,241044,4098046,4052278,85.4023085039363,84.4485142186579,221
-7.6926,53.28823,2022/09/08 23:00:00+00,Fri 09 Sep 2022,63,61,0,3857065,3811295,241044,4098109,4052339,85.4036214090223,84.4497854442173,222
-7.6926,53.28823,2022/09/09 23:00:00+00,Sat 10 Sep 2022,94,135,0,3857159,3811430,241044,4098203,4052474,85.4055803467695,84.4525988122585,223
-7.6926,53.28823,2022/09/10 23:00:00+00,Sun 11 Sep 2022,58,58,0,3857217,3811488,241044,4098261,4052532,85.4067890530391,84.4538075185281,224
-7.6926,53.28823,2022/09/11 23:00:00+00,Mon 12 Sep 2022,13,13,0,3857230,3811501,241044,4098274,4052545,85.4070599699616,84.4540784354506,225
-7.6926,53.28823,2022/09/12 23:00:00+00,Tue 13 Sep 2022,29,25,0,3857259,3811526,241044,4098303,4052570,85.4076643230964,84.4545994295323,226
-7.6926,53.28823,2022/09/13 23:00:00+00,Wed 14 Sep 2022,36,33,0,3857295,3811559,241044,4098339,4052603,85.408414554574,84.4552871417202,227
-7.6926,53.28823,2022/09/14 23:00:00+00,Thu 15 Sep 2022,50,35,0,3857345,3811594,241044,4098389,4052638,85.4094565427375,84.4560165334346,228
-7.6926,53.28823,2022/09/15 23:00:00+00,Fri 16 Sep 2022,38,56,0,3857383,3811650,241044,4098427,4052694,85.4102484537417,84.4571835601776,229
-7.6926,53.28823,2022/09/16 23:00:00+00,Sat 17 Sep 2022,67,149,0,3857450,3811799,241044,4098494,4052843,85.4116447178807,84.4602886849047,230
-7.6926,53.28823,2022/09/17 23:00:00+00,Sun 18 Sep 2022,30,53,0,3857480,3811852,241044,4098524,4052896,85.4122699107787,84.4613931923579,231
-7.6926,53.28823,2022/09/18 23:00:00+00,Mon 19 Sep 2022,11,11,0,3857491,3811863,241044,4098535,4052907,85.4124991481747,84.4616224297538,232
-7.6926,53.28823,2022/09/19 23:00:00+00,Tue 20 Sep 2022,39,37,0,3857530,3811900,241044,4098574,4052944,85.4133118989422,84.4623935009948,233
-7.6926,53.28823,2022/09/20 23:00:00+00,Wed 21 Sep 2022,41,32,0,3857571,3811932,241044,4098615,4052976,85.4141663292362,84.4630603734194,234
-7.6926,53.28823,2022/09/21 23:00:00+00,Thu 22 Sep 2022,61,34,0,3857632,3811966,241044,4098676,4053010,85.4154375547955,84.4637689253705,235
-7.6926,53.28823,2022/09/22 23:00:00+00,Fri 23 Sep 2022,38,39,0,3857670,3812005,241044,4098714,4053049,85.4162294657998,84.464581676138,236
-7.6926,53.28823,2022/09/23 23:00:00+00,Sat 24 Sep 2022,56,104,0,3857726,3812109,241044,4098770,4053153,85.4173964925428,84.4667490115179,237
-7.6926,53.28823,2022/09/24 23:00:00+00,Sun 25 Sep 2022,42,74,0,3857768,3812183,241044,4098812,4053227,85.4182717626001,84.4682911539998,238
-7.6926,53.28823,2022/09/25 23:00:00+00,Mon 26 Sep 2022,23,10,0,3857791,3812193,241044,4098835,4053237,85.4187510771553,84.4684995516325,239
-7.6926,53.28823,2022/09/26 23:00:00+00,Tue 27 Sep 2022,30,33,2,3857821,3812226,241046,4098867,4053272,85.4194179495799,84.4692289433469,240
-7.6926,53.28823,2022/09/27 23:00:00+00,Wed 28 Sep 2022,43,27,0,3857864,3812253,241046,4098910,4053299,85.4203140594004,84.4697916169551,241
-7.6926,53.28823,2022/09/28 23:00:00+00,Thu 29 Sep 2022,30,23,0,3857894,3812276,241046,4098940,4053322,85.4209392522985,84.4702709315103,242
-7.6926,53.28823,2022/09/29 23:00:00+00,Fri 30 Sep 2022,39,58,0,3857933,3812334,241046,4098979,4053380,85.4217520030659,84.4714796377799,243
-7.6926,53.28823,2022/09/30 23:00:00+00,Sat 01 Oct 2022,51,105,0,3857984,3812439,241046,4099030,4053485,85.4228148309926,84.4736678129231,244
-7.6926,53.28823,2022/10/01 23:00:00+00,Sun 02 Oct 2022,26,47,0,3858010,3812486,241046,4099056,4053532,85.4233566648376,84.4746472817967,245
-7.6926,53.28823,2022/10/02 23:00:00+00,Mon 03 Oct 2022,24,1,0,3858034,3812487,241046,4099080,4053533,85.4238568191561,84.47466812156,246
-7.6926,53.28823,2022/10/03 23:00:00+00,Tue 04 Oct 2022,31,17,0,3858065,3812504,241046,4099111,4053550,85.4245028518174,84.4750223975356,247
-7.6926,53.28823,2022/10/04 23:00:00+00,Wed 05 Oct 2022,49,37,0,3858114,3812541,241046,4099160,4053587,85.4255240002176,84.4757934687765,248
-7.6926,53.28823,2022/10/05 23:00:00+00,Thu 06 Oct 2022,58,25,0,3858172,3812566,241046,4099218,4053612,85.4267327064872,84.4763144628582,249
-7.6926,53.28823,2022/10/06 23:00:00+00,Fri 07 Oct 2022,82,39,0,3858254,3812605,241046,4099300,4053651,85.4284415670752,84.4771272136257,250
-7.6926,53.28823,2022/10/07 23:00:00+00,Sat 08 Oct 2022,101,101,0,3858355,3812706,241046,4099401,4053752,85.4305463831653,84.4792320297158,251
-7.6926,53.28823,2022/10/08 23:00:00+00,Sun 09 Oct 2022,37,28,0,3858392,3812734,241046,4099438,4053780,85.4313174544062,84.4798155430874,252
-7.6926,53.28823,2022/10/09 23:00:00+00,Mon 10 Oct 2022,19,2,0,3858411,3812736,241046,4099457,4053782,85.4317134099084,84.4798572226139,253
-7.6926,53.28823,2022/10/10 23:00:00+00,Tue 11 Oct 2022,80,14,0,3858491,3812750,241046,4099537,4053796,85.4333805909698,84.4801489792997,254
-7.6926,53.28823,2022/10/11 23:00:00+00,Wed 12 Oct 2022,59,36,0,3858550,3812786,241046,4099596,4053832,85.4346101370027,84.4808992107773,255
-7.6926,53.28823,2022/10/12 23:00:00+00,Thu 13 Oct 2022,79,29,0,3858629,3812815,241046,4099675,4053861,85.4362564783009,84.4815035639121,256
-7.6926,53.28823,2022/10/13 23:00:00+00,Fri 14 Oct 2022,131,21,0,3858760,3812836,241046,4099806,4053882,85.4389864872891,84.4819411989408,257
-7.6926,53.28823,2022/10/14 23:00:00+00,Sat 15 Oct 2022,91,120,0,3858851,3812956,241046,4099897,4054002,85.4408829057465,84.484441970533,258
-7.6926,53.28823,2022/10/15 23:00:00+00,Sun 16 Oct 2022,26,37,1,3858877,3812993,241047,4099924,4054040,85.4414455793548,84.4852338815372,259
-7.6926,53.28823,2022/10/16 23:00:00+00,Mon 17 Oct 2022,67,3,1,3858944,3812996,241048,4099992,4054044,85.4428626832571,84.4853172405903,260
-7.6926,53.28823,2022/10/17 23:00:00+00,Tue 18 Oct 2022,127,17,0,3859071,3813013,241048,4100119,4054061,85.4455093331922,84.4856715165658,261
-7.6926,53.28823,2022/10/18 23:00:00+00,Wed 19 Oct 2022,97,40,0,3859168,3813053,241048,4100216,4054101,85.4475307902292,84.4865051070966,262
-7.6926,53.28823,2022/10/19 23:00:00+00,Thu 20 Oct 2022,122,9,0,3859290,3813062,241048,4100338,4054110,85.450073241348,84.486692664966,263
-7.6926,53.28823,2022/10/20 23:00:00+00,Fri 21 Oct 2022,137,17,0,3859427,3813079,241048,4100475,4054127,85.4529282889158,84.4870469409416,264
-7.6926,53.28823,2022/10/21 23:00:00+00,Sat 22 Oct 2022,101,56,0,3859528,3813135,241048,4100576,4054183,85.4550331050059,84.4882139676846,265
-7.6926,53.28823,2022/10/22 23:00:00+00,Sun 23 Oct 2022,81,46,0,3859609,3813181,241048,4100657,4054229,85.4567211258307,84.489172596795,266
-7.6926,53.28823,2022/10/23 23:00:00+00,Mon 24 Oct 2022,83,4,0,3859692,3813185,241048,4100740,4054233,85.458450826182,84.489255955848,267
-7.6926,53.28823,2022/10/24 23:00:00+00,Tue 25 Oct 2022,72,26,0,3859764,3813211,241048,4100812,4054259,85.4599512891373,84.489797789693,268
-7.6926,53.28823,2022/10/25 23:00:00+00,Wed 26 Oct 2022,46,25,0,3859810,3813236,241048,4100858,4054284,85.4609099182477,84.4903187837747,269
-7.6926,53.28823,2022/10/26 23:00:00+00,Thu 27 Oct 2022,64,34,0,3859874,3813270,241048,4100922,4054318,85.4622436630969,84.4910273357259,270
-7.6926,53.28823,2022/10/27 23:00:00+00,Fri 28 Oct 2022,59,19,0,3859933,3813289,241048,4100981,4054337,85.4634732091297,84.491423291228,271
-7.6926,53.28823,2022/10/28 23:00:00+00,Sat 29 Oct 2022,90,61,0,3860023,3813350,241048,4101071,4054398,85.4653487878239,84.4926945167874,272
-7.6926,53.28823,2022/10/29 23:00:00+00,Sun 30 Oct 2022,11,5,0,3860034,3813355,241048,4101082,4054403,85.4655780252199,84.4927987156037,273
-7.6926,53.28823,2022/10/31 00:00:00+00,Mon 31 Oct 2022,1,1,0,3860035,3813356,241048,4101083,4054404,85.4655988649831,84.492819555367,274
-7.6926,53.28823,2022/11/01 00:00:00+00,Tue 01 Nov 2022,99,25,0,3860134,3813381,241048,4101182,4054429,85.4676620015467,84.4933405494487,275
-7.6926,53.28823,2022/11/02 00:00:00+00,Wed 02 Nov 2022,125,11,0,3860259,3813392,241048,4101307,4054440,85.4702669719553,84.4935697868446,276
-7.6926,53.28823,2022/11/03 00:00:00+00,Thu 03 Nov 2022,93,28,0,3860352,3813420,241048,4101400,4054468,85.4722050699393,84.4941533002162,277
-7.6926,53.28823,2022/11/04 00:00:00+00,Fri 04 Nov 2022,61,20,0,3860413,3813440,241048,4101461,4054488,85.4734762954987,84.4945700954815,278
-7.6926,53.28823,2022/11/05 00:00:00+00,Sat 05 Nov 2022,48,52,0,3860461,3813492,241048,4101509,4054540,85.4744766041356,84.4956537631715,279
-7.6926,53.28823,2022/11/06 00:00:00+00,Sun 06 Nov 2022,57,75,0,3860518,3813567,241048,4101566,4054615,85.4756644706419,84.4972167454167,280
-7.6926,53.28823,2022/11/07 00:00:00+00,Mon 07 Nov 2022,53,4,0,3860571,3813571,241048,4101619,4054619,85.4767689780951,84.4973001044697,281
-7.6926,53.28823,2022/11/08 00:00:00+00,Tue 08 Nov 2022,79,27,0,3860650,3813598,241048,4101698,4054646,85.4784153193933,84.497862778078,282
-7.6926,53.28823,2022/11/09 00:00:00+00,Wed 09 Nov 2022,92,32,0,3860742,3813630,241048,4101790,4054678,85.480332577614,84.4985296505026,283
-7.6926,53.28823,2022/11/10 00:00:00+00,Thu 10 Nov 2022,45,13,0,3860787,3813643,241048,4101835,4054691,85.4812703669611,84.4988005674251,284
-7.6926,53.28823,2022/11/11 00:00:00+00,Fri 11 Nov 2022,47,16,0,3860834,3813659,241048,4101882,4054707,85.4822498358348,84.4991340036374,285
-7.6926,53.28823,2022/11/12 00:00:00+00,Sat 12 Nov 2022,77,84,0,3860911,3813743,241048,4101959,4054791,85.4838544976064,84.5008845437519,286
-7.6926,53.28823,2022/11/13 00:00:00+00,Sun 13 Nov 2022,46,58,0,3860957,3813801,241048,4102005,4054849,85.4848131267168,84.5020932500215,287
-7.6926,53.28823,2022/11/14 00:00:00+00,Mon 14 Nov 2022,16,1,0,3860973,3813802,241048,4102021,4054850,85.4851465629291,84.5021140897848,288
-7.6926,53.28823,2022/11/15 00:00:00+00,Tue 15 Nov 2022,82,6,0,3861055,3813808,241048,4102103,4054856,85.4868554235171,84.5022391283644,289
-7.6926,53.28823,2022/11/16 00:00:00+00,Wed 16 Nov 2022,52,18,0,3861107,3813826,241048,4102155,4054874,85.4879390912071,84.5026142441032,290
-7.6926,53.28823,2021/01/26 00:00:00+00,Tue 26 Jan 2021,1008,3506,0,151540,8709,5,151545,8714,3.1581619245438,0.1815976971228,291
-7.6926,53.28823,2021/12/18 00:00:00+00,Sat 18 Dec 2021,1251,1184,0,3680901,3625380,240976,3921877,3866356,81.7309882486659,80.5739437522285,292
-7.6926,53.28823,2022/04/09 23:00:00+00,Sun 10 Apr 2022,413,719,0,3842330,3786551,241026,4083356,4027577,85.0961723815202,83.9337512261596,293
-7.6926,53.28823,2022/04/10 23:00:00+00,Mon 11 Apr 2022,70,93,1,3842400,3786644,241027,4083427,4027671,85.0976520047123,83.9357101639068,294
-7.6926,53.28823,2021/08/30 23:00:00+00,Tue 31 Aug 2021,4076,12912,145,3504757,3196742,237580,3742337,3434322,77.9894171514169,71.5704574682313,295
-7.6926,53.28823,2021/01/27 00:00:00+00,Wed 27 Jan 2021,2186,6705,0,153726,15414,5,153731,15419,3.20371764704902,0.321328309838932,296
-7.6926,53.28823,2021/08/31 23:00:00+00,Wed 01 Sep 2021,4984,12556,184,3509741,3209298,237764,3747505,3447062,78.0971170479892,71.8359560522736,297
-7.6926,53.28823,2021/12/19 00:00:00+00,Sun 19 Dec 2021,550,890,2,3681451,3626270,240978,3922429,3867248,81.7424917979902,80.5925328210642,298
-7.6926,53.28823,2022/04/11 23:00:00+00,Tue 12 Apr 2022,197,178,0,3842597,3786822,241027,4083624,4027849,85.1017574380762,83.9394196417686,299
-7.6926,53.28823,2021/09/01 23:00:00+00,Thu 02 Sep 2021,5013,12377,249,3514754,3221675,238013,3752767,3459688,78.2067758823087,72.0990789033033,300
-7.6926,53.28823,2021/12/20 00:00:00+00,Mon 20 Dec 2021,517,617,1,3681968,3626887,240979,3922947,3867866,81.7532867953633,80.6054117947642,301
-7.6926,53.28823,2021/01/28 00:00:00+00,Thu 28 Jan 2021,1021,11542,0,154747,26956,5,154752,26961,3.22499504534628,0.561860857485403,302
-7.6926,53.28823,2022/04/12 23:00:00+00,Wed 13 Apr 2022,142,235,0,3842739,3787057,241027,4083766,4028084,85.1047166844603,83.9443169861368,303
-7.6926,53.28823,2021/12/21 00:00:00+00,Tue 21 Dec 2021,1405,1817,3,3683373,3628704,240982,3924355,3869686,81.7826291820455,80.6433401639131,304
-7.6926,53.28823,2021/09/02 23:00:00+00,Fri 03 Sep 2021,4784,16098,167,3519538,3237773,238180,3757718,3475953,78.3099535502516,72.4380376528675,305
-7.6926,53.28823,2021/01/29 00:00:00+00,Fri 29 Jan 2021,1591,11526,0,156338,38482,5,156343,38487,3.25815110870667,0.802059968919577,306
-7.6926,53.28823,2022/04/13 23:00:00+00,Thu 14 Apr 2022,359,431,0,3843098,3787488,241027,4084125,4028515,85.1121981594738,83.9532989241056,307
-7.6926,53.28823,2021/12/22 00:00:00+00,Wed 22 Dec 2021,1165,1599,2,3684538,3630303,240984,3925522,3871287,81.80694918578,80.6767046249062,308
-7.6926,53.28823,2021/09/03 23:00:00+00,Sat 04 Sep 2021,4631,10590,136,3524169,3248363,238316,3762485,3486679,78.4092967017532,72.6615649536867,309
-7.6926,53.28823,2021/01/30 00:00:00+00,Sat 30 Jan 2021,654,7793,0,156992,46275,5,156997,46280,3.27178031388435,0.964464244071973,310
-7.6926,53.28823,2022/04/14 23:00:00+00,Fri 15 Apr 2022,446,990,0,3843544,3788478,241027,4084571,4029505,85.1214926938916,83.9739302897415,311
-7.6926,53.28823,2021/12/23 00:00:00+00,Thu 23 Dec 2021,928,1399,0,3685466,3631702,240984,3926450,3872686,81.8262884860933,80.705859453719,312
-7.6926,53.28823,2021/09/04 23:00:00+00,Sun 05 Sep 2021,5310,11910,1,3529479,3260273,238317,3767796,3498590,78.5199766844729,72.9097873739794,313
-7.6926,53.28823,2021/01/31 00:00:00+00,Sun 31 Jan 2021,237,4086,0,157229,50361,5,157234,50366,3.27671933777901,1.04961551678758,314
-7.6926,53.28823,2022/04/15 23:00:00+00,Sat 16 Apr 2022,43,88,0,3843587,3788566,241027,4084614,4029593,85.1223888037121,83.9757641889091,315
-7.6926,53.28823,2021/12/24 00:00:00+00,Fri 24 Dec 2021,101,163,0,3685567,3631865,240984,3926551,3872849,81.8283933021834,80.7092563351317,316
-7.6926,53.28823,2021/09/05 23:00:00+00,Mon 06 Sep 2021,2167,9697,76,3531646,3269970,238393,3770039,3508363,78.5667202734844,73.1134543804036,317
-7.6926,53.28823,2021/02/01 00:00:00+00,Mon 01 Feb 2021,1039,8332,1,158268,58693,6,158274,58699,3.29839269157838,1.22327326410503,318
-7.6926,53.28823,2022/04/16 23:00:00+00,Sun 17 Apr 2022,1,1,0,3843588,3788567,241027,4084615,4029594,85.1224096434754,83.9757850286724,319
-7.6926,53.28823,2021/12/25 00:00:00+00,Sat 25 Dec 2021,1,7,0,3685568,3631872,240984,3926552,3872856,81.8284141419467,80.7094022134746,320
-7.6926,53.28823,2021/09/06 23:00:00+00,Tue 07 Sep 2021,3035,10034,160,3534681,3280004,238553,3773234,3518557,78.6333033171276,73.325894927164,321
-7.6926,53.28823,2021/02/02 00:00:00+00,Tue 02 Feb 2021,841,5110,0,159109,63803,6,159115,63809,3.31591893248729,1.3297644544077,322
-7.6926,53.28823,2022/04/17 23:00:00+00,Mon 18 Apr 2022,36,62,1,3843624,3788629,241028,4084652,4029657,85.1231807147164,83.9770979337583,323
-7.6926,53.28823,2021/12/26 00:00:00+00,Sun 26 Dec 2021,12,11,0,3685580,3631883,240984,3926564,3872867,81.8286642191059,80.7096314508706,324
-7.6926,53.28823,2021/09/07 23:00:00+00,Wed 08 Sep 2021,2614,14803,191,3537295,3294807,238744,3776039,3533551,78.6917588530961,73.6383663376137,325
-7.6926,53.28823,2021/02/03 00:00:00+00,Wed 03 Feb 2021,1411,6869,0,160520,70672,6,160526,70678,3.34532383845933,1.47291278829989,326
-7.6926,53.28823,2022/04/18 23:00:00+00,Tue 19 Apr 2022,218,270,1,3843842,3788899,241029,4084871,4029928,85.1277446228722,83.9827455096041,327
-7.6926,53.28823,2021/12/27 00:00:00+00,Mon 27 Dec 2021,391,590,0,3685971,3632473,240984,3926955,3873457,81.836812566544,80.7219269111991,328
-7.6926,53.28823,2021/09/08 23:00:00+00,Thu 09 Sep 2021,3125,14823,138,3540420,3309630,238882,3779302,3548512,78.7597590006417,73.9501500358757,329
-7.6926,53.28823,2021/02/04 00:00:00+00,Thu 04 Feb 2021,1453,10541,1,161973,81213,7,161980,81220,3.37562485425191,1.69260557267774,330
-7.6926,53.28823,2022/04/19 23:00:00+00,Wed 20 Apr 2022,250,607,0,3844092,3789506,241029,4085121,4030535,85.1329545636893,83.9953952459082,331
-7.6926,53.28823,2021/12/28 00:00:00+00,Tue 28 Dec 2021,467,749,0,3686438,3633222,240984,3927422,3874206,81.8465447359904,80.7375358938873,332
-7.6926,53.28823,2021/09/09 23:00:00+00,Fri 10 Sep 2021,3389,13950,116,3543809,3323580,238998,3782807,3562578,78.8328023708982,74.2432821460121,333
-7.6926,53.28823,2021/02/05 00:00:00+00,Fri 05 Feb 2021,3403,8616,0,165376,89829,7,165383,89836,3.44654256865504,1.87216097300021,334
-7.6926,53.28823,2022/04/20 23:00:00+00,Thu 21 Apr 2022,170,236,0,3844262,3789742,241029,4085291,4030771,85.136497323445,84.0003134300396,335
-7.6926,53.28823,2021/12/29 00:00:00+00,Wed 29 Dec 2021,1058,1312,0,3687496,3634534,240984,3928480,3875518,81.8685932055286,80.7648776632957,336
-7.6926,53.28823,2021/09/10 23:00:00+00,Sat 11 Sep 2021,2564,11347,62,3546373,3334927,239060,3785433,3573987,78.8875275892416,74.4810430051439,337
-7.6926,53.28823,2021/02/06 00:00:00+00,Sat 06 Feb 2021,912,3870,0,166288,93699,7,166295,93706,3.46554843275602,1.95281085684979,338
-7.6926,53.28823,2022/04/21 23:00:00+00,Fri 22 Apr 2022,194,254,0,3844456,3789996,241029,4085485,4031025,85.1405402375191,84.0056067299098,339
-7.6926,53.28823,2021/12/30 00:00:00+00,Thu 30 Dec 2021,1049,1199,1,3688545,3635733,240985,3929530,3876718,81.8904749569607,80.789885379218,340
-7.6926,53.28823,2021/09/11 23:00:00+00,Sun 12 Sep 2021,2043,12885,1,3548416,3347812,239061,3787477,3586873,78.9301240653627,74.7495841946234,341
-7.6926,53.28823,2021/09/12 23:00:00+00,Mon 13 Sep 2021,1623,7750,52,3550039,3355562,239113,3789152,3594675,78.9650306688376,74.9121760276452,342
-7.6926,53.28823,2021/09/13 23:00:00+00,Tue 14 Sep 2021,1554,10794,82,3551593,3366356,239195,3790788,3605551,78.9991245215451,75.1388292929548,343
-7.6926,53.28823,2021/09/14 23:00:00+00,Wed 15 Sep 2021,3291,12379,138,3554884,3378735,239333,3794217,3618068,79.0705840697932,75.3996806097881,344
-7.6926,53.28823,2021/09/15 23:00:00+00,Thu 16 Sep 2021,1919,10581,115,3556803,3389316,239448,3796251,3628764,79.1129721482816,75.6225827177094,345
-7.6926,53.28823,2021/09/16 23:00:00+00,Fri 17 Sep 2021,2563,14624,95,3559366,3403940,239543,3798909,3643483,79.1683642390496,75.9293231932603,346
-7.6926,53.28823,2021/09/17 23:00:00+00,Sat 18 Sep 2021,2291,11242,48,3561657,3415182,239591,3801248,3654773,79.2171084453349,76.164604120563,347
-7.6926,53.28823,2021/09/18 23:00:00+00,Sun 19 Sep 2021,1864,8495,16,3563521,3423677,239607,3803128,3663284,79.2562872002799,76.3419713457423,348
-7.6926,53.28823,2021/09/19 23:00:00+00,Mon 20 Sep 2021,964,5634,35,3564485,3429311,239642,3804127,3668953,79.2771061237853,76.4601119637121,349
-7.6926,53.28823,2021/09/20 23:00:00+00,Tue 21 Sep 2021,1476,6680,90,3565961,3435991,239732,3805693,3675723,79.3097411930639,76.6011971610407,350
-7.6926,53.28823,2021/09/21 23:00:00+00,Wed 22 Sep 2021,1902,8159,97,3567863,3444150,239829,3807692,3683979,79.3513998798379,76.7732502465865,351
-7.6926,53.28823,2021/09/22 23:00:00+00,Thu 23 Sep 2021,1690,8738,89,3569553,3452888,239918,3809471,3692806,79.3884738186928,76.9572028369586,352
-7.6926,53.28823,2021/09/23 23:00:00+00,Fri 24 Sep 2021,1914,7398,80,3571467,3460286,239998,3811465,3700284,79.4300283066504,77.1130425866814,353
-7.6926,53.28823,2021/09/24 23:00:00+00,Sat 25 Sep 2021,2422,6609,53,3573889,3466895,240051,3813940,3706946,79.4816067207403,77.251877089577,354
-7.6926,53.28823,2021/09/25 23:00:00+00,Sun 26 Sep 2021,1549,7101,0,3575438,3473996,240051,3815489,3714047,79.5138875140434,77.3998602485475,355
-7.6926,53.28823,2021/09/26 23:00:00+00,Mon 27 Sep 2021,1179,3830,45,3576617,3477826,240096,3816713,3717922,79.5393953842842,77.4806143312134,356
-7.6926,53.28823,2021/09/27 23:00:00+00,Tue 28 Sep 2021,1455,5150,93,3578072,3482976,240189,3818261,3723165,79.571655337824,77.5898772100308,357
-7.6926,53.28823,2021/09/28 23:00:00+00,Wed 29 Sep 2021,1654,3631,80,3579726,3486607,240269,3819995,3726876,79.6077914873318,77.6672135715207,358
-7.6926,53.28823,2021/09/29 23:00:00+00,Thu 30 Sep 2021,1275,3984,78,3581001,3490591,240347,3821348,3730938,79.6359876870343,77.7518646899179,359
-7.6926,53.28823,2021/09/30 23:00:00+00,Fri 01 Oct 2021,1870,5193,42,3582871,3495784,240389,3823260,3736173,79.6758333144039,77.8609608506291,360
-7.6926,53.28823,2021/10/01 23:00:00+00,Sat 02 Oct 2021,1684,4102,41,3584555,3499886,240430,3824985,3740316,79.7117819060423,77.947299989851,361
-7.6926,53.28823,2021/10/02 23:00:00+00,Sun 03 Oct 2021,1197,3022,9,3585752,3502908,240439,3826191,3743347,79.7369146605442,78.0104653123182,362
-7.6926,53.28823,2021/10/03 23:00:00+00,Mon 04 Oct 2021,348,1240,18,3586100,3504148,240457,3826557,3744605,79.7445420139005,78.0366817345102,363
-7.6926,53.28823,2021/10/04 23:00:00+00,Tue 05 Oct 2021,960,2837,70,3587060,3506985,240527,3827587,3747512,79.7660069700672,78.0972629263321,364
-7.6926,53.28823,2021/10/05 23:00:00+00,Wed 06 Oct 2021,971,2581,40,3588031,3509566,240567,3828598,3750133,79.7870759707318,78.1518839458591,365
-7.6926,53.28823,2021/10/06 23:00:00+00,Thu 07 Oct 2021,1213,2713,44,3589244,3512279,240611,3829855,3752890,79.8132715531605,78.2093391731907,366
-7.6926,53.28823,2021/10/07 23:00:00+00,Fri 08 Oct 2021,916,2746,48,3590160,3515025,240659,3830819,3755684,79.8333610849514,78.2675654717633,367
-7.6926,53.28823,2021/10/08 23:00:00+00,Sat 09 Oct 2021,723,2368,23,3590883,3517393,240682,3831565,3758075,79.8489075483498,78.3173933457386,368
-7.6926,53.28823,2021/10/09 23:00:00+00,Sun 10 Oct 2021,1517,3927,2,3592400,3521320,240684,3833084,3762004,79.8805631487549,78.399272775621,369
-7.6926,53.28823,2021/10/10 23:00:00+00,Mon 11 Oct 2021,335,1136,19,3592735,3522456,240703,3833438,3763159,79.8879404249519,78.4233427021962,370
-7.6926,53.28823,2021/10/11 23:00:00+00,Tue 12 Oct 2021,563,1625,21,3593298,3524081,240724,3834022,3764805,79.9001108467008,78.4576449525364,371
-7.6926,53.28823,2021/10/12 23:00:00+00,Wed 13 Oct 2021,989,2080,11,3594287,3526161,240735,3835022,3766896,79.9209506099695,78.5012208975311,372
-7.6926,53.28823,2021/10/13 23:00:00+00,Thu 14 Oct 2021,654,1609,9,3594941,3527770,240744,3835685,3768514,79.9347673730165,78.5349396344997,373
-7.6926,53.28823,2021/10/14 23:00:00+00,Fri 15 Oct 2021,957,2080,9,3595898,3529850,240753,3836651,3770603,79.954898584334,78.5784738999679,374
-7.6926,53.28823,2021/10/15 23:00:00+00,Sat 16 Oct 2021,1383,2651,14,3597281,3532501,240767,3838048,3773268,79.9840117336203,78.6340118690788,375
-7.6926,53.28823,2021/10/16 23:00:00+00,Sun 17 Oct 2021,1704,2892,2,3598985,3535393,240769,3839754,3776162,80.0195643697566,78.6943221439782,376
-7.6926,53.28823,2021/10/17 23:00:00+00,Mon 18 Oct 2021,679,1255,6,3599664,3536648,240775,3840439,3777423,80.0338396075956,78.7206010854599,377
-7.6926,53.28823,2021/10/18 23:00:00+00,Tue 19 Oct 2021,1341,1808,13,3601005,3538456,240788,3841793,3779244,80.0620566470613,78.7585502943721,378
-7.6926,53.28823,2021/10/19 23:00:00+00,Wed 20 Oct 2021,2262,2337,0,3603267,3540793,240788,3844055,3781581,80.1091961915749,78.8072528211309,379
-7.6926,53.28823,2021/10/20 23:00:00+00,Thu 21 Oct 2021,1729,1854,11,3604996,3542647,240799,3845795,3783446,80.1454573796624,78.8461189796268,380
-7.6926,53.28823,2021/10/21 23:00:00+00,Fri 22 Oct 2021,1507,1936,3,3606503,3544583,240802,3847305,3785385,80.176925422198,78.8865272806047,381
-7.6926,53.28823,2021/10/22 23:00:00+00,Sat 23 Oct 2021,2018,1706,1,3608521,3546289,240803,3849324,3787092,80.2190009042373,78.9221007565042,382
-7.6926,53.28823,2021/10/23 23:00:00+00,Sun 24 Oct 2021,1955,2189,2,3610476,3548478,240805,3851281,3789283,80.259784320954,78.9677606778258,383
-7.6926,53.28823,2021/10/24 23:00:00+00,Mon 25 Oct 2021,1234,863,2,3611710,3549341,240807,3852517,3790148,80.285542268354,78.9857870730532,384
-7.6926,53.28823,2021/10/25 23:00:00+00,Tue 26 Oct 2021,1246,1237,6,3612956,3550578,240813,3853769,3791391,80.3116336519664,79.0116908987961,385
-7.6926,53.28823,2021/10/26 23:00:00+00,Wed 27 Oct 2021,1567,1431,6,3614523,3552009,240819,3855342,3792828,80.3444145995879,79.0416376386131,386
-7.6926,53.28823,2021/10/27 23:00:00+00,Thu 28 Oct 2021,2159,1697,5,3616682,3553706,240824,3857506,3794530,80.3895118473012,79.0771069156963,387
-7.6926,53.28823,2021/10/28 23:00:00+00,Fri 29 Oct 2021,2145,1377,2,3618827,3555083,240826,3859653,3795909,80.434254819039,79.1058449492437,388
-7.6926,53.28823,2021/10/29 23:00:00+00,Sat 30 Oct 2021,2020,1455,1,3620847,3556538,240827,3861674,3797365,80.4763719806048,79.1361876445628,389
-7.6926,53.28823,2021/10/30 23:00:00+00,Sun 31 Oct 2021,1597,1320,0,3622444,3557858,240827,3863271,3798685,80.5096530825448,79.1636961320774,390
-7.6926,53.28823,2021/11/01 00:00:00+00,Mon 01 Nov 2021,289,297,2,3622733,3558155,240829,3863562,3798984,80.515717453656,79.1699272212947,391
-7.6926,53.28823,2021/11/02 00:00:00+00,Tue 02 Nov 2021,1100,1098,10,3623833,3559253,240839,3864672,3800092,80.5388495908842,79.1930176789964,392
-7.6926,53.28823,2021/11/03 00:00:00+00,Wed 03 Nov 2021,2538,1883,7,3626371,3561136,240846,3867217,3801982,80.5918867884028,79.2324048315741,393
-7.6926,53.28823,2021/11/04 00:00:00+00,Thu 04 Nov 2021,1536,1287,2,3627907,3562423,240848,3868755,3803271,80.62393834431,79.2592672864273,394
-7.6926,53.28823,2021/11/05 00:00:00+00,Fri 05 Nov 2021,1631,1102,4,3629538,3563525,240852,3870390,3804377,80.6580113572542,79.2823160646024,395
-7.6926,53.28823,2021/11/06 00:00:00+00,Sat 06 Nov 2021,1821,1359,6,3631359,3564884,240858,3872217,3805742,80.696085604746,79.3107623414641,396
-7.6926,53.28823,2021/11/07 00:00:00+00,Sun 07 Nov 2021,697,776,0,3632056,3565660,240858,3872914,3806518,80.7106109197442,79.3269339977606,397
-7.6926,53.28823,2021/11/08 00:00:00+00,Mon 08 Nov 2021,516,534,4,3632572,3566194,240862,3873434,3807056,80.7214475966439,79.3381457903991,398
-7.6926,53.28823,2021/11/09 00:00:00+00,Tue 09 Nov 2021,1372,1070,4,3633944,3567264,240866,3874810,3808130,80.7501231109015,79.3605276961496,399
-7.6926,53.28823,2021/11/10 00:00:00+00,Wed 10 Nov 2021,1601,1368,2,3635545,3568632,240868,3876413,3809500,80.7835292514211,79.3890781718276,400
-7.6926,53.28823,2021/11/11 00:00:00+00,Thu 11 Nov 2021,1394,1124,2,3636939,3569756,240870,3877809,3810626,80.8126215609441,79.4125437452681,401
-7.6926,53.28823,2021/11/12 00:00:00+00,Fri 12 Nov 2021,1143,1160,6,3638082,3570916,240876,3878958,3811792,80.8365664489398,79.4368429092393,402
-7.6926,53.28823,2021/11/13 00:00:00+00,Sat 13 Nov 2021,1395,1384,0,3639477,3572300,240876,3880353,3813176,80.8656379186995,79.4656851416031,403
-7.6926,53.28823,2021/11/14 00:00:00+00,Sun 14 Nov 2021,1646,1808,1,3641123,3574108,240877,3882000,3814985,80.8999610088029,79.503384273356,404
-7.6926,53.28823,2021/11/15 00:00:00+00,Mon 15 Nov 2021,1241,597,1,3642364,3574705,240878,3883242,3815583,80.9258439947826,79.5158464517907,405
-7.6926,53.28823,2021/11/16 00:00:00+00,Tue 16 Nov 2021,1315,1079,5,3643679,3575784,240883,3884562,3816667,80.9533524822971,79.5384367551738,406
-7.6926,53.28823,2021/11/17 00:00:00+00,Wed 17 Nov 2021,1504,1122,3,3645183,3576906,240886,3886069,3817792,80.984758005543,79.561881488851,407
-7.6926,53.28823,2021/11/18 00:00:00+00,Thu 18 Nov 2021,1639,2510,5,3646822,3579416,240891,3887713,3820307,81.0190185763566,79.6142934934716,408
-7.6926,53.28823,2021/11/19 00:00:00+00,Fri 19 Nov 2021,1165,1559,0,3647987,3580975,240891,3888878,3821866,81.0432969005645,79.6467826844074,409
-7.6926,53.28823,2021/11/20 00:00:00+00,Sat 20 Nov 2021,1547,2946,12,3649534,3583921,240903,3890437,3824824,81.0757860915003,79.708426704156,410
-7.6926,53.28823,2021/11/21 00:00:00+00,Sun 21 Nov 2021,1789,2769,0,3651323,3586690,240903,3892226,3827593,81.1130684279879,79.7661320086468,411
-7.6926,53.28823,2021/11/22 00:00:00+00,Mon 22 Nov 2021,725,522,3,3652048,3587212,240906,3892954,3828118,81.1282397756474,79.7770728843629,412
-7.6926,53.28823,2021/11/23 00:00:00+00,Tue 23 Nov 2021,2155,1598,8,3654203,3588810,240914,3895117,3829724,81.1733161835975,79.8105415441723,413
-7.6926,53.28823,2021/11/24 00:00:00+00,Wed 24 Nov 2021,1613,3151,2,3655816,3591961,240916,3896732,3832877,81.2069724012763,79.8762493177583,414
-7.6926,53.28823,2021/11/25 00:00:00+00,Thu 25 Nov 2021,981,1188,2,3656797,3593149,240918,3897715,3834067,81.2274578885694,79.9010486360479,415
-7.6926,53.28823,2021/11/26 00:00:00+00,Fri 26 Nov 2021,1279,1111,12,3658076,3594260,240930,3899006,3835190,81.2543620229492,79.9244516901986,416
-7.6926,53.28823,2021/11/27 00:00:00+00,Sat 27 Nov 2021,1201,1567,6,3659277,3595827,240936,3900213,3836763,81.2795156172144,79.9572326378201,417
-7.6926,53.28823,2021/11/28 00:00:00+00,Sun 28 Nov 2021,1962,2262,1,3661239,3598089,240937,3902176,3839026,81.3204240725107,80.004393022097,418
-7.6926,53.28823,2021/11/29 00:00:00+00,Mon 29 Nov 2021,536,999,2,3661775,3599088,240939,3902714,3840027,81.3316358651492,80.0252536251289,419
-7.6926,53.28823,2021/11/30 00:00:00+00,Tue 30 Nov 2021,1895,1649,6,3663670,3600737,240945,3904615,3841682,81.3712522551229,80.0597434333385,420
-7.6926,53.28823,2021/12/01 00:00:00+00,Wed 01 Dec 2021,1070,1388,4,3664740,3602125,240949,3905689,3843074,81.3936341608734,80.0887523838084,421
-7.6926,53.28823,2021/12/02 00:00:00+00,Thu 02 Dec 2021,1737,1414,0,3666477,3603539,240949,3907426,3844488,81.429832829671,80.1182198090703,422
-7.6926,53.28823,2021/12/03 00:00:00+00,Fri 03 Dec 2021,1015,1198,2,3667492,3604737,240951,3908443,3845688,81.4510268689152,80.1432275249926,423
-7.6926,53.28823,2021/12/04 00:00:00+00,Sat 04 Dec 2021,1204,1702,1,3668696,3606439,240952,3909648,3847391,81.4761387836539,80.1787176418391,424
-7.6926,53.28823,2021/12/05 00:00:00+00,Sun 05 Dec 2021,1347,1777,2,3670043,3608216,240954,3910997,3849170,81.5042516243033,80.215791580694,425
-7.6926,53.28823,2021/12/06 00:00:00+00,Mon 06 Dec 2021,936,1304,0,3670979,3609520,240954,3911933,3850474,81.5237576427227,80.2429666319963,426
-7.6926,53.28823,2021/12/07 00:00:00+00,Tue 07 Dec 2021,483,746,2,3671462,3610266,240956,3912418,3851222,81.533864927908,80.2585547749212,427
-7.6926,53.28823,2021/02/07 00:00:00+00,Sun 07 Feb 2021,337,1301,2,166625,95000,9,166634,95009,3.47261311250409,1.97996506838881,428
-7.6926,53.28823,2022/04/22 23:00:00+00,Sat 23 Apr 2022,322,1010,0,3844778,3791006,241029,4085807,4032035,85.1472506412916,84.0266548908111,429
-7.6926,53.28823,2021/12/31 00:00:00+00,Fri 31 Dec 2021,712,1682,0,3689257,3637415,240985,3930242,3878400,81.9053128684079,80.8249378610359,430
-7.6926,53.28823,2022/04/23 23:00:00+00,Sun 24 Apr 2022,181,252,0,3844959,3791258,241029,4085988,4032287,85.1510226384432,84.0319065111548,431
-7.6926,53.28823,2021/02/08 00:00:00+00,Mon 08 Feb 2021,1196,881,0,167821,95881,9,167830,95890,3.49753746937336,1.99832489982847,432
-7.6926,53.28823,2022/01/01 00:00:00+00,Sat 01 Jan 2022,69,100,0,3689326,3637515,240985,3930311,3878500,81.9067508120735,80.8270218373627,433
-7.6926,53.28823,2022/04/24 23:00:00+00,Mon 25 Apr 2022,41,59,1,3845000,3791317,241030,4086030,4032347,85.1518979085005,84.0331568969509,434
-7.6926,53.28823,2021/02/09 00:00:00+00,Tue 09 Feb 2021,4274,552,3,172095,96433,12,172107,96445,3.58666913687327,2.00989096844255,435
-7.6926,53.28823,2022/01/02 00:00:00+00,Sun 02 Jan 2022,271,629,0,3689597,3638144,240985,3930582,3879129,81.9123983879193,80.8401300484587,436
-7.6926,53.28823,2022/04/25 23:00:00+00,Tue 26 Apr 2022,144,238,0,3845144,3791555,241030,4086174,4032585,85.1548988344112,84.0381167606088,437
-7.6926,53.28823,2022/04/26 23:00:00+00,Wed 27 Apr 2022,122,208,0,3845266,3791763,241030,4086296,4032793,85.15744128553,84.0424514313687,438
-7.6926,53.28823,2022/04/27 23:00:00+00,Thu 28 Apr 2022,101,130,0,3845367,3791893,241030,4086397,4032923,85.1595461016201,84.0451606005936,439
-7.6926,53.28823,2022/04/28 23:00:00+00,Fri 29 Apr 2022,168,222,0,3845535,3792115,241030,4086565,4033145,85.1630471818492,84.0497870280393,440
-7.6926,53.28823,2022/04/29 23:00:00+00,Sat 30 Apr 2022,281,723,0,3845816,3792838,241030,4086846,4033868,85.1689031553277,84.0648541768825,441
-7.6926,53.28823,2022/04/30 23:00:00+00,Sun 01 May 2022,187,746,0,3846003,3793584,241030,4087033,4034614,85.172800191059,84.0804006402809,442
-7.6926,53.28823,2022/05/01 23:00:00+00,Mon 02 May 2022,12,26,0,3846015,3793610,241030,4087045,4034640,85.1730502682182,84.0809424741259,443
-7.6926,53.28823,2022/05/02 23:00:00+00,Tue 03 May 2022,96,118,0,3846111,3793728,241030,4087141,4034758,85.175050885492,84.0834015661916,444
-7.6926,53.28823,2022/05/03 23:00:00+00,Wed 04 May 2022,113,128,0,3846224,3793856,241030,4087254,4034886,85.1774057787413,84.08606905589,445
-7.6926,53.28823,2022/05/04 23:00:00+00,Thu 05 May 2022,112,165,0,3846336,3794021,241030,4087366,4035051,85.1797398322274,84.0895076168293,446
-7.6926,53.28823,2022/05/05 23:00:00+00,Fri 06 May 2022,138,257,0,3846474,3794278,241030,4087504,4035308,85.1826157195585,84.0948634359893,447
-7.6926,53.28823,2022/05/06 23:00:00+00,Sat 07 May 2022,441,1088,0,3846915,3795366,241030,4087945,4036396,85.1918060551599,84.1175370984256,448
-7.6926,53.28823,2022/05/07 23:00:00+00,Sun 08 May 2022,274,437,0,3847189,3795803,241030,4088219,4036833,85.1975161502955,84.126644074974,449
-7.6926,53.28823,2022/05/08 23:00:00+00,Mon 09 May 2022,24,32,0,3847213,3795835,241030,4088243,4036865,85.198016304614,84.1273109473986,450
-7.6926,53.28823,2022/05/09 23:00:00+00,Tue 10 May 2022,80,98,1,3847293,3795933,241031,4088324,4036964,85.1997043254387,84.1293740839622,451
-7.6926,53.28823,2022/05/10 23:00:00+00,Wed 11 May 2022,112,132,0,3847405,3796065,241031,4088436,4037096,85.2020383789248,84.1321249327136,452
-7.6926,53.28823,2022/05/11 23:00:00+00,Thu 12 May 2022,207,398,0,3847612,3796463,241031,4088643,4037494,85.2063522099214,84.1404191584945,453
-7.6926,53.28823,2022/05/12 23:00:00+00,Fri 13 May 2022,173,327,0,3847785,3796790,241031,4088816,4037821,85.2099574889669,84.1472337610834,454
-7.6926,53.28823,2022/05/13 23:00:00+00,Sat 14 May 2022,333,633,0,3848118,3797423,241031,4089149,4038454,85.2168971301354,84.1604253312324,455
-7.6926,53.28823,2022/05/14 23:00:00+00,Sun 15 May 2022,168,254,0,3848286,3797677,241031,4089317,4038708,85.2203982103645,84.1657186311026,456
-7.6926,53.28823,2022/05/15 23:00:00+00,Mon 16 May 2022,31,41,0,3848317,3797718,241031,4089348,4038749,85.2210442430258,84.1665730613967,457
-7.6926,53.28823,2022/05/16 23:00:00+00,Tue 17 May 2022,97,102,0,3848414,3797820,241031,4089445,4038851,85.2230657000629,84.1686987172501,458
-7.6926,53.28823,2022/05/17 23:00:00+00,Wed 18 May 2022,98,122,0,3848512,3797942,241031,4089543,4038973,85.2251079968632,84.1712411683688,459
-7.6926,53.28823,2022/05/18 23:00:00+00,Thu 19 May 2022,74,106,0,3848586,3798048,241031,4089617,4039079,85.2266501393451,84.1734501832753,460
-7.6926,53.28823,2022/05/19 23:00:00+00,Fri 20 May 2022,127,208,0,3848713,3798256,241031,4089744,4039287,85.2292967892802,84.1777848540352,461
-7.6926,53.28823,2022/05/20 23:00:00+00,Sat 21 May 2022,392,762,0,3849105,3799018,241031,4090136,4040049,85.2374659764815,84.1936647536459,462
-7.6926,53.28823,2022/05/21 23:00:00+00,Sun 22 May 2022,234,409,0,3849339,3799427,241031,4090370,4040458,85.2423424810864,84.2021882168227,463
-7.6926,53.28823,2022/05/22 23:00:00+00,Mon 23 May 2022,26,35,0,3849365,3799462,241031,4090396,4040493,85.2428843149313,84.2029176085371,464
-7.6926,53.28823,2022/05/23 23:00:00+00,Tue 24 May 2022,64,83,0,3849429,3799545,241031,4090460,4040576,85.2442180597805,84.2046473088884,465
-7.6926,53.28823,2022/05/24 23:00:00+00,Wed 25 May 2022,86,134,1,3849515,3799679,241032,4090547,4040711,85.2460311191849,84.2074606769297,466
-7.6926,53.28823,2022/05/25 23:00:00+00,Thu 26 May 2022,98,155,0,3849613,3799834,241032,4090645,4040866,85.2480734159852,84.2106908402363,467
-7.6926,53.28823,2022/05/26 23:00:00+00,Fri 27 May 2022,95,152,0,3849708,3799986,241032,4090740,4041018,85.2500531934957,84.2138584842532,468
-7.6926,53.28823,2022/05/27 23:00:00+00,Sat 28 May 2022,334,580,0,3850042,3800566,241032,4091074,4041598,85.2570136744275,84.225945546949,469
-7.6926,53.28823,2022/05/28 23:00:00+00,Sun 29 May 2022,182,349,0,3850224,3800915,241032,4091256,4041947,85.2608065113424,84.2332186243297,470
-7.6926,53.28823,2022/05/29 23:00:00+00,Mon 30 May 2022,8,23,0,3850232,3800938,241032,4091264,4041970,85.2609732294485,84.2336979388849,471
-7.6926,53.28823,2022/05/30 23:00:00+00,Tue 31 May 2022,65,79,2,3850297,3801017,241034,4091331,4042051,85.2623694935875,84.2353859597096,472
-7.6926,53.28823,2022/05/31 23:00:00+00,Wed 01 Jun 2022,68,102,0,3850365,3801119,241034,4091399,4042153,85.2637865974898,84.2375116155631,473
-7.6926,53.28823,2022/06/01 23:00:00+00,Thu 02 Jun 2022,91,140,0,3850456,3801259,241034,4091490,4042293,85.2656830159472,84.2404291824207,474
-7.6926,53.28823,2022/06/02 23:00:00+00,Fri 03 Jun 2022,60,143,0,3850516,3801402,241034,4091550,4042436,85.2669334017433,84.2434092685681,475
-7.6926,53.28823,2022/06/03 23:00:00+00,Sat 04 Jun 2022,305,607,0,3850821,3802009,241034,4091855,4043043,85.2732895295403,84.2560590048721,476
-7.6926,53.28823,2022/06/04 23:00:00+00,Sun 05 Jun 2022,143,273,0,3850964,3802282,241034,4091998,4043316,85.2762696156877,84.2617482602445,477
-7.6926,53.28823,2022/06/05 23:00:00+00,Mon 06 Jun 2022,4,7,1,3850968,3802289,241035,4092003,4043324,85.276373814504,84.2619149783506,478
-7.6926,53.28823,2022/06/06 23:00:00+00,Tue 07 Jun 2022,29,51,0,3850997,3802340,241035,4092032,4043375,85.2769781676388,84.2629778062773,479
-7.6926,53.28823,2022/06/07 23:00:00+00,Wed 08 Jun 2022,36,76,0,3851033,3802416,241035,4092068,4043451,85.2777283991165,84.2645616282857,480
-7.6926,53.28823,2022/06/08 23:00:00+00,Thu 09 Jun 2022,73,122,0,3851106,3802538,241035,4092141,4043573,85.2792497018351,84.2671040794045,481
-7.6926,53.28823,2022/06/09 23:00:00+00,Fri 10 Jun 2022,56,108,0,3851162,3802646,241035,4092197,4043681,85.2804167285781,84.2693547738375,482
-7.6926,53.28823,2022/06/10 23:00:00+00,Sat 11 Jun 2022,189,561,0,3851351,3803207,241035,4092386,4044242,85.2843554438359,84.2810458810312,483
-7.6926,53.28823,2022/06/11 23:00:00+00,Sun 12 Jun 2022,143,288,0,3851494,3803495,241035,4092529,4044530,85.2873355299833,84.2870477328526,484
-7.6926,53.28823,2022/06/12 23:00:00+00,Mon 13 Jun 2022,17,44,0,3851511,3803539,241035,4092546,4044574,85.2876898059589,84.2879646824364,485
-7.6926,53.28823,2022/06/13 23:00:00+00,Tue 14 Jun 2022,37,55,0,3851548,3803594,241035,4092583,4044629,85.2884608771998,84.2891108694162,486
-7.6926,53.28823,2022/06/14 23:00:00+00,Wed 15 Jun 2022,66,123,0,3851614,3803717,241035,4092649,4044752,85.2898363015755,84.2916741602982,487
-7.6926,53.28823,2022/06/15 23:00:00+00,Thu 16 Jun 2022,42,85,0,3851656,3803802,241035,4092691,4044837,85.2907115716328,84.293445540176,488
-7.6926,53.28823,2022/06/16 23:00:00+00,Fri 17 Jun 2022,58,95,0,3851714,3803897,241035,4092749,4044932,85.2919202779024,84.2954253176866,489
-7.6926,53.28823,2022/06/17 23:00:00+00,Sat 18 Jun 2022,223,488,0,3851937,3804385,241035,4092972,4045420,85.2965675451113,84.3055951221616,490
-7.6926,53.28823,2022/06/18 23:00:00+00,Sun 19 Jun 2022,80,129,0,3852017,3804514,241035,4093052,4045549,85.2982347261728,84.3082834516233,491
-7.6926,53.28823,2022/06/19 23:00:00+00,Mon 20 Jun 2022,9,28,0,3852026,3804542,241035,4093061,4045577,85.2984222840422,84.3088669649948,492
-7.6926,53.28823,2022/06/20 23:00:00+00,Tue 21 Jun 2022,74,169,1,3852100,3804711,241036,4093136,4045747,85.2999852662874,84.3124097247505,493
-7.6926,53.28823,2022/06/21 23:00:00+00,Wed 22 Jun 2022,60,94,0,3852160,3804805,241036,4093196,4045841,85.3012356520835,84.3143686624977,494
-7.6926,53.28823,2022/06/22 23:00:00+00,Thu 23 Jun 2022,64,114,0,3852224,3804919,241036,4093260,4045955,85.3025693969327,84.3167443955104,495
-7.6926,53.28823,2022/06/23 23:00:00+00,Fri 24 Jun 2022,55,93,1,3852279,3805012,241037,4093316,4046049,85.3037364236757,84.3187033332576,496
-7.6926,53.28823,2022/06/24 23:00:00+00,Sat 25 Jun 2022,210,293,0,3852489,3805305,241037,4093526,4046342,85.3081127739621,84.3248093838953,497
-7.6926,53.28823,2022/06/25 23:00:00+00,Sun 26 Jun 2022,174,402,0,3852663,3805707,241037,4093700,4046744,85.3117388927709,84.3331869687293,498
-7.6926,53.28823,2022/06/26 23:00:00+00,Mon 27 Jun 2022,4,33,0,3852667,3805740,241037,4093704,4046777,85.3118222518239,84.3338746809172,499
-7.6926,53.28823,2022/06/27 23:00:00+00,Tue 28 Jun 2022,48,60,0,3852715,3805800,241037,4093752,4046837,85.3128225604608,84.3351250667133,500
-7.6926,53.28823,2022/06/28 23:00:00+00,Wed 29 Jun 2022,63,81,3,3852778,3805881,241040,4093818,4046921,85.3141979848366,84.3368756068279,501
-7.6926,53.28823,2022/06/29 23:00:00+00,Thu 30 Jun 2022,49,88,0,3852827,3805969,241040,4093867,4047009,85.3152191332367,84.3387095059955,502
-7.6926,53.28823,2022/06/30 23:00:00+00,Fri 01 Jul 2022,46,64,0,3852873,3806033,241040,4093913,4047073,85.3161777623471,84.3400432508447,503
-7.6926,53.28823,2022/07/01 23:00:00+00,Sat 02 Jul 2022,182,228,0,3853055,3806261,241040,4094095,4047301,85.319970599262,84.3447947168699,504
-7.6926,53.28823,2022/07/02 23:00:00+00,Sun 03 Jul 2022,108,273,0,3853163,3806534,241040,4094203,4047574,85.322221293695,84.3504839722423,505
-7.6926,53.28823,2022/07/03 23:00:00+00,Mon 04 Jul 2022,13,15,0,3853176,3806549,241040,4094216,4047589,85.3224922106175,84.3507965686913,506
-7.6926,53.28823,2022/07/04 23:00:00+00,Tue 05 Jul 2022,51,69,0,3853227,3806618,241040,4094267,4047658,85.3235550385442,84.3522345123568,507
-7.6926,53.28823,2022/07/05 23:00:00+00,Wed 06 Jul 2022,60,83,0,3853287,3806701,241040,4094327,4047741,85.3248054243403,84.3539642127081,508
-7.6926,53.28823,2022/07/06 23:00:00+00,Thu 07 Jul 2022,76,76,0,3853363,3806777,241040,4094403,4047817,85.3263892463487,84.3555480347165,509
-7.6926,53.28823,2022/07/07 23:00:00+00,Fri 08 Jul 2022,99,90,0,3853462,3806867,241040,4094502,4047907,85.3284523829123,84.3574236134107,510
-7.6926,53.28823,2022/07/08 23:00:00+00,Sat 09 Jul 2022,119,143,0,3853581,3807010,241040,4094621,4048050,85.3309323147413,84.3604036995581,511
-7.6926,53.28823,2022/07/09 23:00:00+00,Sun 10 Jul 2022,132,219,0,3853713,3807229,241040,4094753,4048269,85.3336831634927,84.364967607714,512
-7.6926,53.28823,2022/07/10 23:00:00+00,Mon 11 Jul 2022,11,16,0,3853724,3807245,241040,4094764,4048285,85.3339124008887,84.3653010439263,513
-7.6926,53.28823,2022/07/11 23:00:00+00,Tue 12 Jul 2022,44,81,0,3853768,3807326,241040,4094808,4048366,85.3348293504725,84.366989064751,514
-7.6926,53.28823,2022/07/12 23:00:00+00,Wed 13 Jul 2022,99,74,0,3853867,3807400,241040,4094907,4048440,85.3368924870361,84.3685312072329,515
-7.6926,53.28823,2022/07/13 23:00:00+00,Thu 14 Jul 2022,71,39,0,3853938,3807439,241040,4094978,4048479,85.3383721102282,84.3693439580004,516
-7.6926,53.28823,2022/07/14 23:00:00+00,Fri 15 Jul 2022,80,118,1,3854018,3807557,241041,4095059,4048598,85.3400601310529,84.3718238898293,517
-7.6926,53.28823,2022/07/15 23:00:00+00,Sat 16 Jul 2022,124,210,0,3854142,3807767,241041,4095183,4048808,85.3426442616982,84.3762002401158,518
-7.6926,53.28823,2022/07/16 23:00:00+00,Sun 17 Jul 2022,119,165,0,3854261,3807932,241041,4095302,4048973,85.3451241935272,84.3796388010551,519
-7.6926,53.28823,2022/07/17 23:00:00+00,Mon 18 Jul 2022,14,18,0,3854275,3807950,241041,4095316,4048991,85.345415950213,84.3800139167939,520
-7.6926,53.28823,2022/07/18 23:00:00+00,Tue 19 Jul 2022,30,33,0,3854305,3807983,241041,4095346,4049024,85.346041143111,84.3807016289818,521
-7.6926,53.28823,2022/07/19 23:00:00+00,Wed 20 Jul 2022,78,66,0,3854383,3808049,241041,4095424,4049090,85.347666644646,84.3820770533575,522
-7.6926,53.28823,2022/07/20 23:00:00+00,Thu 21 Jul 2022,52,30,0,3854435,3808079,241041,4095476,4049120,85.348750312336,84.3827022462556,523
-7.6926,53.28823,2022/07/21 23:00:00+00,Fri 22 Jul 2022,73,70,0,3854508,3808149,241041,4095549,4049190,85.3502716150546,84.3841610296844,524
-7.6926,53.28823,2022/07/22 23:00:00+00,Sat 23 Jul 2022,99,175,0,3854607,3808324,241041,4095648,4049365,85.3523347516182,84.3878079882564,525
-7.6926,53.28823,2022/07/23 23:00:00+00,Sun 24 Jul 2022,108,231,0,3854715,3808555,241041,4095756,4049596,85.3545854460512,84.3926219735714,526
-7.6926,53.28823,2022/07/24 23:00:00+00,Mon 25 Jul 2022,14,23,0,3854729,3808578,241041,4095770,4049619,85.3548772027369,84.3931012881266,527
-7.6926,53.28823,2022/07/25 23:00:00+00,Tue 26 Jul 2022,18,16,0,3854747,3808594,241041,4095788,4049635,85.3552523184758,84.3934347243389,528
-7.6926,53.28823,2021/02/10 00:00:00+00,Wed 10 Feb 2021,8832,584,0,180927,97017,12,180939,97029,3.77072592606177,2.02206139019143,529
-7.6926,53.28823,2022/01/03 00:00:00+00,Mon 03 Jan 2022,3632,728,1,3693229,3638872,240986,3934215,3879858,81.9881092478742,80.8553222358815,530
-7.6926,53.28823,2021/02/11 00:00:00+00,Thu 11 Feb 2021,6198,448,0,187125,97465,12,187137,97477,3.89989077880071,2.03139760413578,531
-7.6926,53.28823,2021/02/12 00:00:00+00,Fri 12 Feb 2021,4401,526,0,191526,97991,12,191538,98003,3.99160657694593,2.04235931961507,532
-7.6926,53.28823,2021/02/13 00:00:00+00,Sat 13 Feb 2021,1220,1917,0,192746,99908,12,192758,99920,4.01703108813365,2.08230914580103,533
-7.6926,53.28823,2021/02/14 00:00:00+00,Sun 14 Feb 2021,2704,27,0,195450,99935,12,195462,99947,4.07338180801201,2.08287181940928,534
-7.6926,53.28823,2021/02/15 00:00:00+00,Mon 15 Feb 2021,1968,7894,0,197418,107829,12,197430,107841,4.11439446212467,2.24738091065181,535
-7.6926,53.28823,2021/02/16 00:00:00+00,Tue 16 Feb 2021,5659,8165,0,203077,115994,12,203089,116006,4.23232668246182,2.41753757774013,536
-7.6926,53.28823,2021/02/17 00:00:00+00,Wed 17 Feb 2021,9757,8465,0,212834,124459,12,212846,124471,4.43566025267379,2.59394617380904,537
-7.6926,53.28823,2021/02/18 00:00:00+00,Thu 18 Feb 2021,8471,8358,1,221305,132817,13,221318,132830,4.61221472708559,2.76814575497148,538
-7.6926,53.28823,2021/02/19 00:00:00+00,Fri 19 Feb 2021,9400,6589,1,230705,139406,14,230719,139420,4.80812934157393,2.90547979491172,539
-7.6926,53.28823,2021/02/20 00:00:00+00,Sat 20 Feb 2021,5898,3574,2,236603,142980,16,236619,142996,4.93108394485882,2.98000278836033,540
-7.6926,53.28823,2021/02/21 00:00:00+00,Sun 21 Feb 2021,1116,1025,6,237719,144005,22,237741,144027,4.95446615924622,3.00148858429028,541
-7.6926,53.28823,2021/02/22 00:00:00+00,Mon 22 Feb 2021,3953,1125,2,241672,145130,24,241696,145154,5.03688742297363,3.02497499749402,542
-7.6926,53.28823,2021/02/23 00:00:00+00,Tue 23 Feb 2021,13369,1074,1,255041,146204,25,255066,146229,5.31551505787515,3.04737774300779,543
-7.6926,53.28823,2021/02/24 00:00:00+00,Wed 24 Feb 2021,16950,2108,5,271991,148312,30,272021,148342,5.66885324409469,3.0914121627944,544
-7.6926,53.28823,2021/02/25 00:00:00+00,Thu 25 Feb 2021,18106,1763,3,290097,150075,33,290130,150108,6.04624051712622,3.12821518472679,545
-7.6926,53.28823,2021/02/26 00:00:00+00,Fri 26 Feb 2021,16088,2773,1,306185,152848,34,306219,152882,6.38153146835513,3.18602468803395,546
-7.6926,53.28823,2021/02/27 00:00:00+00,Sat 27 Feb 2021,9007,706,1,315192,153554,35,315227,153589,6.56925605587891,3.20075840066487,547
-7.6926,53.28823,2021/02/28 00:00:00+00,Sun 28 Feb 2021,2451,59,2,317643,153613,37,317680,153650,6.62037599517685,3.20202962622426,548
-7.6926,53.28823,2021/03/01 00:00:00+00,Mon 01 Mar 2021,5613,805,0,323256,154418,37,323293,154455,6.73734958640364,3.2188056356555,549
-7.6926,53.28823,2021/03/02 00:00:00+00,Tue 02 Mar 2021,12197,1615,0,335453,156033,37,335490,156070,6.99153217899106,3.25246185333433,550
-7.6926,53.28823,2021/03/03 00:00:00+00,Wed 03 Mar 2021,12917,1510,1,348370,157543,38,348408,157581,7.26074024089516,3.28395073563322,551
-7.6926,53.28823,2021/03/04 00:00:00+00,Thu 04 Mar 2021,18734,1697,5,367104,159240,43,367147,159283,7.65125656478593,3.31942001271642,552
-7.6926,53.28823,2021/03/05 00:00:00+00,Fri 05 Mar 2021,18463,2403,6,385567,161643,49,385616,161692,8.03614615259417,3.36962300243054,553
-7.6926,53.28823,2021/03/06 00:00:00+00,Sat 06 Mar 2021,10411,149,5,395978,161792,54,396032,161846,8.25321312680016,3.37283232597391,554
-7.6926,53.28823,2021/03/07 00:00:00+00,Sun 07 Mar 2021,1534,14,3,397512,161806,57,397569,161863,8.28524384294404,3.37318660194948,555
-7.6926,53.28823,2021/03/08 00:00:00+00,Mon 08 Mar 2021,6681,1508,5,404193,163314,62,404255,163376,8.42457850015807,3.40471716377491,556
-7.6926,53.28823,2021/03/09 00:00:00+00,Tue 09 Mar 2021,13851,3113,6,418044,166427,68,418112,166495,8.71335509977141,3.46971638540975,557
-7.6926,53.28823,2021/03/10 00:00:00+00,Wed 10 Mar 2021,13753,3997,3,431797,170424,71,431868,170495,9.00002688329462,3.55307543848425,558
-7.6926,53.28823,2021/03/11 00:00:00+00,Thu 11 Mar 2021,18502,2107,3,450299,172531,74,450373,172605,9.38566670258053,3.59704733898105,559
-7.6926,53.28823,2021/03/12 00:00:00+00,Fri 12 Mar 2021,17344,1348,4,467643,173879,78,467721,173957,9.74719491576463,3.62522269892023,560
-7.6926,53.28823,2021/03/13 00:00:00+00,Sat 13 Mar 2021,8329,178,0,475972,174057,78,476050,174135,9.92076930402902,3.62893217678204,561
-7.6926,53.28823,2021/03/14 00:00:00+00,Sun 14 Mar 2021,392,23,2,476364,174080,80,476444,174160,9.92898017075685,3.62945317086376,562
-7.6926,53.28823,2021/03/15 00:00:00+00,Mon 15 Mar 2021,2671,1000,0,479035,175080,80,479115,175160,9.98464317844735,3.65029293413239,563
-7.6926,53.28823,2021/03/16 00:00:00+00,Tue 16 Mar 2021,8964,3829,2,487999,178909,82,488081,178991,10.1714924959138,3.73013006721449,564
-7.6926,53.28823,2021/03/17 00:00:00+00,Wed 17 Mar 2021,4895,2426,7,492894,181335,89,492983,181424,10.2736490154566,3.78083321124705,565
-7.6926,53.28823,2021/03/18 00:00:00+00,Thu 18 Mar 2021,11741,4688,5,504635,186023,94,504729,186117,10.5184328748099,3.87863422026671,566
-7.6926,53.28823,2021/03/19 00:00:00+00,Fri 19 Mar 2021,10389,6140,2,515024,192163,96,515120,192259,10.7349788549342,4.00663204626261,567
-7.6926,53.28823,2021/03/20 00:00:00+00,Sat 20 Mar 2021,5258,3126,4,520282,195289,100,520382,195389,10.8446376892537,4.0718605052934,568
-7.6926,53.28823,2021/03/21 00:00:00+00,Sun 21 Mar 2021,3652,58,3,523934,195347,103,524037,195450,10.9208070240005,4.07313173085279,569
-7.6926,53.28823,2021/03/22 00:00:00+00,Mon 22 Mar 2021,7427,2416,1,531361,197763,104,531465,197867,11.0756047855599,4.12350143867306,570
-7.6926,53.28823,2021/03/23 00:00:00+00,Tue 23 Mar 2021,12574,7406,4,543935,205169,108,544043,205277,11.3377273279526,4.27792408449357,571
-7.6926,53.28823,2021/03/24 00:00:00+00,Wed 24 Mar 2021,13641,9784,2,557576,214953,110,557686,215063,11.6220442182265,4.48186200784034,572
-7.6926,53.28823,2021/03/25 00:00:00+00,Thu 25 Mar 2021,20882,10229,3,578458,225182,113,578571,225295,12.0572826740917,4.69509446560491,573
-7.6926,53.28823,2021/03/26 00:00:00+00,Fri 26 Mar 2021,19711,9507,1,598169,234689,114,598283,234803,12.4680760876429,4.893238934763,574
-7.6926,53.28823,2021/03/27 00:00:00+00,Sat 27 Mar 2021,11764,5362,3,609933,240051,117,610050,240168,12.7132975820248,5.00504426469917,575
-7.6926,53.28823,2021/03/28 00:00:00+00,Sun 28 Mar 2021,2496,488,0,612429,240539,117,612546,240656,12.7653136311433,5.01521406917426,576
-7.6926,53.28823,2021/03/28 23:00:00+00,Mon 29 Mar 2021,9287,3128,3,621716,243667,120,621836,243787,12.9589150319088,5.08046336796833,577
-7.6926,53.28823,2021/03/29 23:00:00+00,Tue 30 Mar 2021,13344,8676,4,635060,252343,124,635184,252467,13.2370841920184,5.26135251313999,578
-7.6926,53.28823,2021/03/30 23:00:00+00,Wed 31 Mar 2021,15844,10507,4,650904,262850,128,651032,262978,13.5673527602996,5.48039926485651,579
-7.6926,53.28823,2021/03/31 23:00:00+00,Thu 01 Apr 2021,19715,11584,9,670619,274434,137,670756,274571,13.9783962510099,5.72199464042968,580
-7.6926,53.28823,2021/04/01 23:00:00+00,Fri 02 Apr 2021,20161,13727,9,690780,288161,146,690926,288307,14.3987342761381,6.00824962868752,581
-7.6926,53.28823,2021/04/02 23:00:00+00,Sat 03 Apr 2021,7553,4639,7,698333,292800,153,698486,292953,14.5562828864489,6.10507116883355,582
-7.6926,53.28823,2021/04/03 23:00:00+00,Sun 04 Apr 2021,3046,172,3,701379,292972,156,701535,293128,14.619823324655,6.10871812740556,583
-7.6926,53.28823,2021/04/04 23:00:00+00,Mon 05 Apr 2021,3445,613,6,704824,293585,162,704986,293747,14.691741347695,6.12161794086884,584
-7.6926,53.28823,2021/04/05 23:00:00+00,Tue 06 Apr 2021,12007,8157,12,716831,301742,174,717005,301916,14.9422144624206,6.29185796701024,585
-7.6926,53.28823,2021/04/06 23:00:00+00,Wed 07 Apr 2021,18375,10489,12,735206,312231,186,735392,312417,15.3253951896408,6.51069632109407,586
-7.6926,53.28823,2021/04/07 23:00:00+00,Thu 08 Apr 2021,20198,10571,17,755404,322802,203,755607,323005,15.7466710041161,6.73134773458227,587
-7.6926,53.28823,2021/04/08 23:00:00+00,Fri 09 Apr 2021,20684,9167,16,776088,331969,219,776307,332188,16.1780541037766,6.92271928067806,588
-7.6926,53.28823,2021/04/09 23:00:00+00,Sat 10 Apr 2021,11186,4184,12,787274,336153,231,787505,336384,16.4114177728587,7.01016292735321,589
-7.6926,53.28823,2021/04/10 23:00:00+00,Sun 11 Apr 2021,2869,368,9,790143,336521,240,790383,336761,16.4713946115458,7.01801951810548,590
-7.6926,53.28823,2021/04/11 23:00:00+00,Mon 12 Apr 2021,7787,2803,13,797930,339324,253,798183,339577,16.633944765041,7.07670429146993,591
-7.6926,53.28823,2021/04/12 23:00:00+00,Tue 13 Apr 2021,11527,8593,1,809457,347917,254,809711,348171,16.8741855560018,7.2558012170005,592
-7.6926,53.28823,2021/04/13 23:00:00+00,Wed 14 Apr 2021,20352,6597,2,829809,354514,256,830065,354770,17.2983580975714,7.39332281481015,593
-7.6926,53.28823,2021/04/14 23:00:00+00,Thu 15 Apr 2021,27112,10819,1,856921,365333,257,857178,365590,17.8633865990736,7.61880905337668,594
-7.6926,53.28823,2021/04/15 23:00:00+00,Fri 16 Apr 2021,27968,9841,1,884889,375174,258,885147,375432,18.4462539379338,7.82391400346649,595
-7.6926,53.28823,2021/04/16 23:00:00+00,Sat 17 Apr 2021,15855,4562,3,900744,379736,261,901005,379997,18.7767309038476,7.91904752278776,596
-7.6926,53.28823,2021/04/17 23:00:00+00,Sun 18 Apr 2021,1077,486,0,901821,380222,261,902082,380483,18.7991753288879,7.92917564773631,597
-7.6926,53.28823,2021/04/18 23:00:00+00,Mon 19 Apr 2021,6756,2264,0,908577,382486,261,908838,382747,18.9399687695308,7.97635687177648,598
-7.6926,53.28823,2021/04/19 23:00:00+00,Tue 20 Apr 2021,15097,7323,1,923674,389809,262,923936,390071,19.2546075153605,8.12898729795589,599
-7.6926,53.28823,2021/04/20 23:00:00+00,Wed 21 Apr 2021,26736,9896,4,950410,399705,266,950676,399971,19.8118627851635,8.33530095431528,600
-7.6926,53.28823,2022/01/04 00:00:00+00,Tue 04 Jan 2022,1187,783,1,3694416,3639655,240987,3935403,3880642,82.0128668866373,80.8716606102841,601
-7.6926,53.28823,2022/01/05 00:00:00+00,Wed 05 Jan 2022,2139,911,0,3696555,3640566,240987,3937542,3881553,82.0574431402689,80.8906456346218,602
-7.6926,53.28823,2022/01/06 00:00:00+00,Thu 06 Jan 2022,2455,1697,1,3699010,3642263,240988,3939998,3883251,82.1086255988566,80.926031552652,603
-7.6926,53.28823,2022/01/07 00:00:00+00,Fri 07 Jan 2022,4854,782,2,3703864,3643045,240990,3944854,3884035,82.2098234892891,80.9423699270546,604
-7.6926,53.28823,2022/01/08 00:00:00+00,Sat 08 Jan 2022,9789,744,2,3713653,3643789,240992,3954645,3884781,82.4138656114522,80.957916390453,605
-7.6926,53.28823,2022/01/09 00:00:00+00,Sun 09 Jan 2022,7116,667,0,3720769,3644456,240992,3961761,3885448,82.5621613668717,80.9718165125531,606
-7.6926,53.28823,2022/01/10 00:00:00+00,Mon 10 Jan 2022,6663,509,1,3727432,3644965,240993,3968425,3885958,82.7010375492939,80.9824447918201,607
-7.6926,53.28823,2022/01/11 00:00:00+00,Tue 11 Jan 2022,4781,1368,1,3732213,3646333,240994,3973207,3887327,82.8006932972444,81.0109744277349,608
-7.6926,53.28823,2022/01/12 00:00:00+00,Wed 12 Jan 2022,7558,927,1,3739771,3647260,240995,3980766,3888255,82.958221067792,81.0303137280482,609
-7.6926,53.28823,2022/01/13 00:00:00+00,Thu 13 Jan 2022,7321,816,0,3747092,3648076,240995,3988087,3889071,83.1107889746816,81.0473189748754,610
-7.6926,53.28823,2022/01/14 00:00:00+00,Fri 14 Jan 2022,10723,835,0,3757815,3648911,240995,3998810,3889906,83.334253756211,81.0647201772047,611
-7.6926,53.28823,2022/01/15 00:00:00+00,Sat 15 Jan 2022,8363,652,2,3766178,3649563,240997,4007175,3890560,83.5085783759531,81.0783493823824,612
-7.6926,53.28823,2022/01/16 00:00:00+00,Sun 16 Jan 2022,6965,1215,1,3773143,3650778,240998,4014141,3891776,83.6537481668823,81.103690534517,613
-7.6926,53.28823,2022/01/17 00:00:00+00,Mon 17 Jan 2022,2562,561,0,3775705,3651339,240998,4016703,3892337,83.7071396403765,81.1153816417107,614
-7.6926,53.28823,2022/01/18 00:00:00+00,Tue 18 Jan 2022,4056,452,3,3779761,3651791,241001,4020762,3892792,83.7917282394839,81.1248637339979,615
-7.6926,53.28823,2022/01/19 00:00:00+00,Wed 19 Jan 2022,3486,622,0,3783247,3652413,241001,4024248,3893414,83.8643756542383,81.137826066751,616
-7.6926,53.28823,2022/01/20 00:00:00+00,Thu 20 Jan 2022,3698,938,0,3786945,3653351,241001,4027946,3894352,83.9414410988057,81.157373764697,617
-7.6926,53.28823,2022/01/21 00:00:00+00,Fri 21 Jan 2022,3252,977,0,3790197,3654328,241001,4031198,3895329,84.0092120089553,81.1777342134104,618
-7.6926,53.28823,2022/01/22 00:00:00+00,Sat 22 Jan 2022,4272,644,0,3794469,3654972,241001,4035470,3895973,84.0982394776388,81.1911550209554,619
-7.6926,53.28823,2022/01/23 00:00:00+00,Sun 23 Jan 2022,3092,680,0,3797561,3655652,241001,4038562,3896653,84.1626760256654,81.2053260599781,620
-7.6926,53.28823,2022/01/24 00:00:00+00,Mon 24 Jan 2022,646,467,0,3798207,3656119,241001,4039208,3897120,84.176138512737,81.2150582294245,621
-7.6926,53.28823,2022/01/25 00:00:00+00,Tue 25 Jan 2022,692,1836,0,3798899,3657955,241001,4039900,3898956,84.1905596289188,81.2533200347857,622
-7.6926,53.28823,2022/01/26 00:00:00+00,Wed 26 Jan 2022,700,897,0,3799599,3658852,241001,4040600,3899853,84.2051474632069,81.2720133024377,623
-7.6926,53.28823,2022/01/27 00:00:00+00,Thu 27 Jan 2022,1274,1178,0,3800873,3660030,241001,4041874,3901031,84.2316973216111,81.2965625435681,624
-7.6926,53.28823,2022/01/28 00:00:00+00,Fri 28 Jan 2022,1028,3095,1,3801901,3663125,241002,4042903,3904127,84.2531414380145,81.3610824506478,625
-7.6926,53.28823,2022/01/29 00:00:00+00,Sat 29 Jan 2022,2328,3445,0,3804229,3666570,241002,4045231,3907572,84.3016564069039,81.4328754351082,626
-7.6926,53.28823,2022/01/30 00:00:00+00,Sun 30 Jan 2022,1639,7536,0,3805868,3674106,241002,4046870,3915108,84.3358127789012,81.5899238911006,627
-7.6926,53.28823,2022/01/31 00:00:00+00,Mon 31 Jan 2022,481,1394,0,3806349,3675500,241002,4047351,3916502,84.3458367050334,81.618974521097,628
-7.6926,53.28823,2022/02/01 00:00:00+00,Tue 01 Feb 2022,749,3418,1,3807098,3678918,241003,4048101,3919921,84.3614665274848,81.6902256717125,629
-7.6926,53.28823,2022/02/02 00:00:00+00,Wed 02 Feb 2022,650,2996,0,3807748,3681914,241003,4048751,3922917,84.3750123736094,81.7526616024653,630
-7.6926,53.28823,2022/02/03 00:00:00+00,Thu 03 Feb 2022,907,2436,1,3808655,3684350,241004,4049659,3925354,84.3939348786573,81.8034481055509,631
-7.6926,53.28823,2022/02/04 00:00:00+00,Fri 04 Feb 2022,1172,6523,0,3809827,3690873,241004,4050831,3931877,84.4183590812082,81.9393858813521,632
-7.6926,53.28823,2022/02/05 00:00:00+00,Sat 05 Feb 2022,1777,5750,0,3811604,3696623,241004,4052608,3937627,84.4553913405365,82.0592145201467,633
-7.6926,53.28823,2022/02/06 00:00:00+00,Sun 06 Feb 2022,1407,7555,0,3813011,3704178,241004,4054015,3945182,84.4847128874555,82.2166589316412,634
-7.6926,53.28823,2022/02/07 00:00:00+00,Mon 07 Feb 2022,439,1351,0,3813450,3705529,241004,4054454,3946533,84.4938615435304,82.2448134518171,635
-7.6926,53.28823,2022/02/08 00:00:00+00,Tue 08 Feb 2022,899,1238,0,3814349,3706767,241004,4055353,3947771,84.5125964907089,82.2706130787437,636
-7.6926,53.28823,2022/02/09 00:00:00+00,Wed 09 Feb 2022,1335,1784,0,3815684,3708551,241004,4056688,3949555,84.5404175746725,82.3077912164149,637
-7.6926,53.28823,2022/02/10 00:00:00+00,Thu 10 Feb 2022,686,2552,0,3816370,3711103,241004,4057374,3952107,84.5547136522748,82.3609742922764,638
-7.6926,53.28823,2022/02/11 00:00:00+00,Fri 11 Feb 2022,546,4920,0,3816916,3716023,241004,4057920,3957027,84.5660921630195,82.4635059275581,639
-7.6926,53.28823,2022/02/12 00:00:00+00,Sat 12 Feb 2022,1397,5462,0,3818313,3721485,241004,4059317,3962489,84.5952053123057,82.5773327145313,640
-7.6926,53.28823,2022/02/13 00:00:00+00,Sun 13 Feb 2022,1566,4706,0,3819879,3726191,241004,4060883,3967195,84.6278403815844,82.6754046404734,641
-7.6926,53.28823,2022/02/14 00:00:00+00,Mon 14 Feb 2022,174,954,0,3820053,3727145,241004,4061057,3968149,84.6314665003931,82.6952857746317,642
-7.6926,53.28823,2022/02/15 00:00:00+00,Tue 15 Feb 2022,649,818,1,3820702,3727963,241005,4061707,3968968,84.6450123465177,82.7123535407487,643
-7.6926,53.28823,2022/02/16 00:00:00+00,Wed 16 Feb 2022,798,1786,0,3821500,3729749,241005,4062505,3970754,84.6616424776061,82.7495733579465,644
-7.6926,53.28823,2022/02/17 00:00:00+00,Thu 17 Feb 2022,790,1193,2,3822290,3730942,241007,4063297,3971949,84.6781475701149,82.7744768750525,645
-7.6926,53.28823,2022/02/18 00:00:00+00,Fri 18 Feb 2022,790,3295,0,3823080,3734237,241007,4064087,3975244,84.6946109830971,82.8431438950226,646
-7.6926,53.28823,2022/02/19 00:00:00+00,Sat 19 Feb 2022,980,3555,0,3824060,3737792,241007,4065067,3978799,84.7150339511003,82.9172292534426,647
-7.6926,53.28823,2022/02/20 00:00:00+00,Sun 20 Feb 2022,1366,3588,0,3825426,3741380,241007,4066433,3982387,84.7435010677253,82.9920023240504,648
-7.6926,53.28823,2022/02/21 00:00:00+00,Mon 21 Feb 2022,254,995,1,3825680,3742375,241008,4066688,3983383,84.7488152073588,83.012758728266,649
-7.6926,53.28823,2022/02/22 00:00:00+00,Tue 22 Feb 2022,476,981,1,3826156,3743356,241009,4067165,3984365,84.7587557744379,83.0332233757957,650
-7.6926,53.28823,2022/02/23 00:00:00+00,Wed 23 Feb 2022,829,1273,1,3826985,3744629,241010,4067995,3985639,84.7760527779509,83.0597732342,651
-7.6926,53.28823,2022/02/24 00:00:00+00,Thu 24 Feb 2022,655,1232,0,3827640,3745861,241010,4068650,3986871,84.7897028228918,83.0854478225469,652
-7.6926,53.28823,2022/02/25 00:00:00+00,Fri 25 Feb 2022,692,1227,0,3828332,3747088,241010,4069342,3988098,84.8041239390737,83.1110182120775,653
-7.6926,53.28823,2022/02/26 00:00:00+00,Sat 26 Feb 2022,960,2092,0,3829292,3749180,241010,4070302,3990190,84.8241301118116,83.1546149968355,654
-7.6926,53.28823,2022/02/27 00:00:00+00,Sun 27 Feb 2022,671,1783,0,3829963,3750963,241010,4070973,3991973,84.8381135929648,83.1917722947434,655
-7.6926,53.28823,2022/02/28 00:00:00+00,Mon 28 Feb 2022,80,432,0,3830043,3751395,241010,4071053,3992405,84.8397807740263,83.2007750724755,656
-7.6926,53.28823,2022/03/01 00:00:00+00,Tue 01 Mar 2022,132,936,0,3830175,3752331,241010,4071185,3993341,84.8425316227778,83.2202810908949,657
-7.6926,53.28823,2022/03/02 00:00:00+00,Wed 02 Mar 2022,206,997,2,3830381,3753328,241012,4071393,3994340,84.8468662935376,83.2411000144003,658
-7.6926,53.28823,2022/03/03 00:00:00+00,Thu 03 Mar 2022,278,1277,0,3830659,3754605,241012,4071671,3995617,84.8526597477263,83.2677123920943,659
-7.6926,53.28823,2022/03/04 00:00:00+00,Fri 04 Mar 2022,735,1508,1,3831394,3756113,241013,4072407,3997126,84.867997813492,83.2991595948667,660
-7.6926,53.28823,2022/03/05 00:00:00+00,Sat 05 Mar 2022,962,3341,0,3832356,3759454,241013,4073369,4000467,84.8880456657565,83.3687852439471,661
-7.6926,53.28823,2022/03/06 00:00:00+00,Sun 06 Mar 2022,455,1915,0,3832811,3761369,241013,4073824,4002382,84.8975277580437,83.4086933906066,662
-7.6926,53.28823,2022/03/07 00:00:00+00,Mon 07 Mar 2022,115,124,1,3832926,3761493,241014,4073940,4002507,84.8999451705828,83.4112983610151,663
-7.6926,53.28823,2022/03/08 00:00:00+00,Tue 08 Mar 2022,120,493,0,3833046,3761986,241014,4074060,4003000,84.9024459421751,83.4215723643066,664
-7.6926,53.28823,2022/03/09 00:00:00+00,Wed 09 Mar 2022,129,345,1,3833175,3762331,241015,4074190,4003346,84.9051551114,83.4287829223975,665
-7.6926,53.28823,2022/03/10 00:00:00+00,Thu 10 Mar 2022,259,508,0,3833434,3762839,241015,4074449,4003854,84.9105526100866,83.439369522138,666
-7.6926,53.28823,2022/03/11 00:00:00+00,Fri 11 Mar 2022,492,2182,0,3833926,3765021,241015,4074941,4006036,84.9208057736147,83.4848418855901,667
-7.6926,53.28823,2022/03/12 00:00:00+00,Sat 12 Mar 2022,473,2391,2,3834399,3767412,241017,4075416,4008429,84.9307046611673,83.5347114390919,668
-7.6926,53.28823,2022/03/13 00:00:00+00,Sun 13 Mar 2022,358,1082,0,3834757,3768494,241017,4075774,4009511,84.9381652964175,83.5572600629486,669
-7.6926,53.28823,2022/03/14 00:00:00+00,Mon 14 Mar 2022,109,122,0,3834866,3768616,241017,4075883,4009633,84.9404368306138,83.5598025140674,670
-7.6926,53.28823,2022/03/15 00:00:00+00,Tue 15 Mar 2022,222,755,1,3835088,3769371,241018,4076106,4010389,84.9450840978227,83.5755573750984,671
-7.6926,53.28823,2022/03/16 00:00:00+00,Wed 16 Mar 2022,195,798,0,3835283,3770169,241018,4076301,4011187,84.9491478516601,83.5921875061868,672
-7.6926,53.28823,2022/03/18 00:00:00+00,Fri 18 Mar 2022,3,6,0,3835286,3770175,241018,4076304,4011193,84.9492103709499,83.5923125447664,673
-7.6926,53.28823,2022/03/19 00:00:00+00,Sat 19 Mar 2022,743,2778,0,3836029,3772953,241018,4077047,4013971,84.9646943150585,83.6502054071266,674
-7.6926,53.28823,2022/03/20 00:00:00+00,Sun 20 Mar 2022,395,1402,0,3836424,3774355,241018,4077442,4015373,84.9729260215496,83.6794227552293,675
-7.6926,53.28823,2022/03/21 00:00:00+00,Mon 21 Mar 2022,56,112,0,3836480,3774467,241018,4077498,4015485,84.9740930482926,83.6817568087154,676
-7.6926,53.28823,2022/03/22 00:00:00+00,Tue 22 Mar 2022,141,575,0,3836621,3775042,241018,4077639,4016060,84.9770314549135,83.6937396725948,677
-7.6926,53.28823,2022/03/23 00:00:00+00,Wed 23 Mar 2022,102,221,0,3836723,3775263,241018,4077741,4016281,84.9791571107669,83.6983452602772,678
-7.6926,53.28823,2022/03/24 00:00:00+00,Thu 24 Mar 2022,147,246,0,3836870,3775509,241018,4077888,4016527,84.9822205559674,83.7034718420413,679
-7.6926,53.28823,2022/03/25 00:00:00+00,Fri 25 Mar 2022,434,1625,0,3837304,3777134,241018,4078322,4018152,84.991265013226,83.7373364573528,680
-7.6926,53.28823,2022/03/26 00:00:00+00,Sat 26 Mar 2022,874,1848,1,3838178,3778982,241019,4079197,4020001,85.009499806086,83.7758691796365,681
-7.6926,53.28823,2022/03/27 00:00:00+00,Sun 27 Mar 2022,380,803,0,3838558,3779785,241019,4079577,4020804,85.0174189161281,83.7926035095412,682
-7.6926,53.28823,2022/03/27 23:00:00+00,Mon 28 Mar 2022,44,53,1,3838602,3779838,241020,4079622,4020858,85.0183567054752,83.7937288567577,683
-7.6926,53.28823,2022/03/28 23:00:00+00,Tue 29 Mar 2022,137,193,3,3838739,3780031,241023,4079762,4021054,85.0212742723328,83.7978134503583,684
-7.6926,53.28823,2022/03/29 23:00:00+00,Wed 30 Mar 2022,109,135,0,3838848,3780166,241023,4079871,4021189,85.0235458065291,83.8006268183996,685
-7.6926,53.28823,2022/03/30 23:00:00+00,Thu 31 Mar 2022,227,360,0,3839075,3780526,241023,4080098,4021549,85.028276432791,83.8081291331763,686
-7.6926,53.28823,2022/03/31 23:00:00+00,Fri 01 Apr 2022,306,905,0,3839381,3781431,241023,4080404,4022454,85.0346534003512,83.8269891189344,687
-7.6926,53.28823,2022/04/01 23:00:00+00,Sat 02 Apr 2022,729,1538,1,3840110,3782969,241024,4081134,4023993,85.0498664275373,83.8590615146048,688
