X,Y,VaccinationDate,VaccineText,Dose1,Dose2,SingleDose,Dose1Cum,Dose2Cum,SingleDoseCum,PartiallyVacc,FullyVacc,PartialPercent,FullyPercent,ObjectId
-7.6926,53.28823,2021/07/31 23:00:00+00,Sun 01 Aug 2021,11042,9241,360,3160564,2615294,220590,3381154,2835884,71.8033717803303,60.2238268880655,1
-7.6926,53.28823,2021/08/01 23:00:00+00,Mon 02 Aug 2021,14950,15882,419,3175514,2631176,221009,3396523,2852185,72.1297532527187,60.5700006392142,2
-7.6926,53.28823,2021/08/02 23:00:00+00,Tue 03 Aug 2021,17275,25312,1095,3192789,2656488,222104,3414893,2878592,72.519865013261,61.1307889495376,3
-7.6926,53.28823,2021/08/03 23:00:00+00,Wed 04 Aug 2021,22037,17156,1569,3214826,2673644,223673,3438499,2897317,73.0211703055507,61.5284396145433,4
-7.6926,53.28823,2021/08/04 23:00:00+00,Thu 05 Aug 2021,13461,29910,1415,3228287,2703554,225088,3453375,2928642,73.3370822570928,62.1936682971229,5
-7.6926,53.28823,2021/08/05 23:00:00+00,Fri 06 Aug 2021,12125,24631,938,3240412,2728185,226026,3466438,2954211,73.614492704995,62.7366605456425,6
-7.6926,53.28823,2021/08/06 23:00:00+00,Sat 07 Aug 2021,6301,8359,573,3246713,2736544,226599,3473312,2963143,73.760471379027,62.9263436292116,7
-7.6926,53.28823,2021/08/07 23:00:00+00,Sun 08 Aug 2021,8584,11895,151,3255297,2748439,226750,3482047,2975189,73.9459709015277,63.1821567085525,8
-7.6926,53.28823,2021/08/08 23:00:00+00,Mon 09 Aug 2021,5492,22898,594,3260789,2771337,227344,3488133,2998681,74.075215331286,63.6810410568737,9
-7.6926,53.28823,2021/08/09 23:00:00+00,Tue 10 Aug 2021,9276,25872,700,3270065,2797209,228044,3498109,3025253,74.2870691648826,64.2453333650463,10
-7.6926,53.28823,2021/08/10 23:00:00+00,Wed 11 Aug 2021,6954,31094,650,3277019,2828303,228694,3505713,3056997,74.4485503748534,64.9194600785278,11
-7.6926,53.28823,2021/08/11 23:00:00+00,Thu 12 Aug 2021,6708,38180,855,3283727,2866483,229549,3513276,3096032,74.6091608944496,65.7484210242419,12
-7.6926,53.28823,2021/08/12 23:00:00+00,Fri 13 Aug 2021,10859,28128,854,3294586,2894611,230403,3524989,3125014,74.8579022690404,66.3638929373632,13
-7.6926,53.28823,2021/08/13 23:00:00+00,Sat 14 Aug 2021,18082,5768,274,3312668,2900379,230677,3543345,3131056,75.2477167206742,66.4922029676951,14
-7.6926,53.28823,2021/08/14 23:00:00+00,Sun 15 Aug 2021,16972,3676,43,3329640,2904055,230720,3560360,3134775,75.6090532261521,66.5711809555806,15
-7.6926,53.28823,2021/08/15 23:00:00+00,Mon 16 Aug 2021,10143,23039,376,3339783,2927094,231096,3570879,3158190,75.8324383981251,67.0684301049054,16
-7.6926,53.28823,2021/08/16 23:00:00+00,Tue 17 Aug 2021,12847,26777,522,3352630,2953871,231618,3584248,3185489,76.1163471693113,67.648161239965,17
-7.6926,53.28823,2021/08/17 23:00:00+00,Wed 18 Aug 2021,15185,25677,651,3367815,2979548,232269,3600084,3211817,76.4526460174304,68.2072718785909,18
-7.6926,53.28823,2021/08/18 23:00:00+00,Thu 19 Aug 2021,11331,25602,536,3379146,3005150,232805,3611951,3237955,76.7046577900137,68.7623476106026,19
-7.6926,53.28823,2021/08/19 23:00:00+00,Fri 20 Aug 2021,14800,22147,680,3393946,3027297,233485,3627431,3260782,77.0333964973188,69.2471097857741,20
-7.6926,53.28823,2021/08/20 23:00:00+00,Sat 21 Aug 2021,11835,7905,238,3405781,3035202,233723,3639504,3268925,77.289782958126,69.4200373887189,21
-7.6926,53.28823,2021/08/21 23:00:00+00,Sun 22 Aug 2021,7991,12210,159,3413772,3047412,233882,3647654,3281294,77.462859215525,69.6827098093039,22
-7.6926,53.28823,2021/08/22 23:00:00+00,Mon 23 Aug 2021,10833,15279,280,3424605,3062691,234162,3658767,3296853,77.698858779755,70.0131261883065,23
-7.6926,53.28823,2021/08/23 23:00:00+00,Tue 24 Aug 2021,9721,22838,382,3434326,3085529,234544,3668870,3320073,77.913409629878,70.5062342492642,24
-7.6926,53.28823,2021/08/24 23:00:00+00,Wed 25 Aug 2021,9386,19422,308,3443712,3104951,234852,3678564,3339803,78.1192748126051,70.925227446624,25
-7.6926,53.28823,2021/08/25 23:00:00+00,Thu 26 Aug 2021,8545,19343,363,3452257,3124294,235215,3687472,3359509,78.3084482237598,71.3437109715694,26
-7.6926,53.28823,2021/08/26 23:00:00+00,Fri 27 Aug 2021,9684,19124,429,3461941,3143418,235644,3697585,3379062,78.5232114373888,71.7589453348728,27
-7.6926,53.28823,2021/08/27 23:00:00+00,Sat 28 Aug 2021,9903,7853,151,3471844,3151271,235795,3707639,3387066,78.7367217063323,71.9289210850841,28
-7.6926,53.28823,2021/08/28 23:00:00+00,Sun 29 Aug 2021,8786,9157,27,3480630,3160428,235822,3716452,3396250,78.9238776641798,72.1239557290046,29
-7.6926,53.28823,2021/08/29 23:00:00+00,Mon 30 Aug 2021,5037,11047,80,3485667,3171475,235902,3721569,3407377,79.0325440702057,72.3602526021431,30
-7.6926,53.28823,2021/08/30 23:00:00+00,Tue 31 Aug 2021,4040,12797,140,3489707,3184272,236042,3725749,3420314,79.1213120157183,72.6349872698696,31
-7.6926,53.28823,2021/08/31 23:00:00+00,Wed 01 Sep 2021,4922,12466,179,3494629,3196738,236221,3730850,3432959,79.2296386401345,72.9035209232206,32
-7.6926,53.28823,2021/09/01 23:00:00+00,Thu 02 Sep 2021,4987,12300,246,3499616,3209038,236467,3736083,3445505,79.3407684628301,73.1699521778621,33
-7.6926,53.28823,2021/09/02 23:00:00+00,Fri 03 Sep 2021,4745,15990,163,3504361,3225028,236630,3740991,3461658,79.4449964715803,73.5129829491217,34
-7.6926,53.28823,2021/09/03 23:00:00+00,Sat 04 Sep 2021,4610,10536,132,3508971,3235564,236762,3745733,3472326,79.5456992461308,73.7395323373343,35
-7.6926,53.28823,2021/09/04 23:00:00+00,Sun 05 Sep 2021,5301,11871,1,3514272,3247435,236763,3751035,3484198,79.6582943770179,73.9916502916707,36
-7.6926,53.28823,2021/09/05 23:00:00+00,Mon 06 Sep 2021,2133,9635,73,3516405,3257070,236836,3753241,3493906,79.7051417664439,74.1978127833062,37
-7.6926,53.28823,2021/09/06 23:00:00+00,Tue 07 Sep 2021,3020,9944,153,3519425,3267014,236989,3756414,3504003,79.7725247069012,74.4122362153255,38
-7.6926,53.28823,2021/09/07 23:00:00+00,Wed 08 Sep 2021,2585,14753,184,3522010,3281767,237173,3759183,3518940,79.8313281617157,74.7294435842543,39
-7.6926,53.28823,2021/09/08 23:00:00+00,Thu 09 Sep 2021,3097,14751,136,3525107,3296518,237309,3762416,3533827,79.899985283209,75.0455891356529,40
-7.6926,53.28823,2021/09/09 23:00:00+00,Fri 10 Sep 2021,3360,13901,114,3528467,3310419,237423,3765890,3547842,79.9737603651973,75.3432165893274,41
-7.6926,53.28823,2021/09/10 23:00:00+00,Sat 11 Sep 2021,2544,11285,60,3531011,3321704,237483,3768494,3559187,80.0290598221626,75.584142986897,42
-7.6926,53.28823,2021/09/11 23:00:00+00,Sun 12 Sep 2021,2028,12857,1,3533039,3334561,237484,3770523,3572045,80.0721483775322,75.857199982926,43
-7.6926,53.28823,2021/09/12 23:00:00+00,Mon 13 Sep 2021,1595,7696,50,3534634,3342257,237534,3772168,3579791,80.107082174271,76.0216967546821,44
-7.6926,53.28823,2021/09/13 23:00:00+00,Tue 14 Sep 2021,1531,10736,81,3536165,3352993,237615,3773780,3590608,80.14131517144,76.2514103591343,45
-7.6926,53.28823,2021/09/14 23:00:00+00,Wed 15 Sep 2021,3262,12366,134,3539427,3365359,237749,3777176,3603108,80.2134338180813,76.5168647416481,46
-7.6926,53.28823,2021/09/15 23:00:00+00,Thu 16 Sep 2021,1895,10564,112,3541322,3375923,237861,3779183,3613784,80.2560551737378,76.7435840206655,47
-7.6926,53.28823,2021/09/16 23:00:00+00,Fri 17 Sep 2021,2550,14576,90,3543872,3390499,237951,3781823,3628450,80.3121191393247,77.0550363385813,48
-7.6926,53.28823,2021/09/17 23:00:00+00,Sat 18 Sep 2021,2277,11204,43,3546149,3401703,237994,3784143,3639697,80.3613874727192,77.293881573792,49
-7.6926,53.28823,2021/09/18 23:00:00+00,Sun 19 Sep 2021,1856,8479,12,3548005,3410182,238006,3786011,3648188,80.4010569756421,77.474199426746,50
-7.6926,53.28823,2021/09/19 23:00:00+00,Mon 20 Sep 2021,943,5587,32,3548948,3415769,238038,3786986,3653807,80.4217624174782,77.5935264807736,51
-7.6926,53.28823,2021/09/20 23:00:00+00,Tue 21 Sep 2021,1455,6635,90,3550403,3422404,238128,3788531,3660532,80.4545725791569,77.736340938566,52
-7.6926,53.28823,2021/09/21 23:00:00+00,Wed 22 Sep 2021,1886,8112,96,3552289,3430516,238224,3790513,3668740,80.4966630260483,77.9106489042999,53
-7.6926,53.28823,2021/09/22 23:00:00+00,Thu 23 Sep 2021,1686,8733,87,3553975,3439249,238311,3792286,3677560,80.5343150756641,78.0979535166016,54
-7.6926,53.28823,2021/09/23 23:00:00+00,Fri 24 Sep 2021,1903,7361,79,3555878,3446610,238390,3794268,3685000,80.5764055225554,78.2559519650738,55
-7.6926,53.28823,2021/09/24 23:00:00+00,Sat 25 Sep 2021,2407,6564,51,3558285,3453174,238441,3796726,3691615,80.628604472333,78.3964304243001,56
-7.6926,53.28823,2021/09/25 23:00:00+00,Sun 26 Sep 2021,1537,7086,0,3559822,3460260,238441,3798263,3698701,80.6612447432069,78.5469112046596,57
-7.6926,53.28823,2021/09/26 23:00:00+00,Mon 27 Sep 2021,1166,3769,45,3560988,3464029,238486,3799474,3702515,80.6869619637848,78.6279066458522,58
-7.6926,53.28823,2021/09/27 23:00:00+00,Tue 28 Sep 2021,1437,5094,91,3562425,3469123,238577,3801002,3707700,80.7194111075033,78.7380171237189,59
-7.6926,53.28823,2021/09/28 23:00:00+00,Wed 29 Sep 2021,1641,3582,77,3564066,3472705,238654,3802720,3711359,80.755895157836,78.8157209305684,60
-7.6926,53.28823,2021/09/29 23:00:00+00,Thu 30 Sep 2021,1280,3929,77,3565346,3476634,238731,3804077,3715365,80.7847128856017,78.9007937510764,61
-7.6926,53.28823,2021/09/30 23:00:00+00,Fri 01 Oct 2021,1836,5136,41,3567182,3481770,238772,3805954,3720542,80.82457351568,79.0107343381383,62
-7.6926,53.28823,2021/10/01 23:00:00+00,Sat 02 Oct 2021,1705,4064,39,3568887,3485834,238811,3807698,3724645,80.8616097111283,79.0978670846547,63
-7.6926,53.28823,2021/10/02 23:00:00+00,Sun 03 Oct 2021,1194,3002,9,3570081,3488836,238820,3808901,3727656,80.8871570409014,79.1618097363146,64
-7.6926,53.28823,2021/10/03 23:00:00+00,Mon 04 Oct 2021,333,1204,17,3570414,3490040,238837,3809251,3728877,80.8945897636118,79.1877393203985,65
-7.6926,53.28823,2021/10/04 23:00:00+00,Tue 05 Oct 2021,958,2792,69,3571372,3492832,238906,3810278,3731738,80.9163994956791,79.2484965194683,66
-7.6926,53.28823,2021/10/05 23:00:00+00,Wed 06 Oct 2021,971,2529,35,3572343,3495361,238941,3811284,3734302,80.9377632643839,79.3029465224096,67
-7.6926,53.28823,2021/10/06 23:00:00+00,Thu 07 Oct 2021,1197,2665,44,3573540,3498026,238985,3812525,3737011,80.9641175754798,79.3604757961879,68
-7.6926,53.28823,2021/10/07 23:00:00+00,Fri 08 Oct 2021,974,2750,45,3574514,3500776,239030,3813544,3739806,80.9857574167424,79.419831396118,69
-7.6926,53.28823,2021/10/08 23:00:00+00,Sat 09 Oct 2021,729,2349,21,3575243,3503125,239051,3814294,3742176,81.0016846796932,79.4701615470427,70
-7.6926,53.28823,2021/10/09 23:00:00+00,Sun 10 Oct 2021,1499,3903,0,3576742,3507028,239051,3815793,3746079,81.0335179692442,79.5530470234388,71
-7.6926,53.28823,2021/10/10 23:00:00+00,Mon 11 Oct 2021,330,1089,15,3577072,3508117,239066,3816138,3747183,81.0408445102016,79.5764919545024,72
-7.6926,53.28823,2021/10/11 23:00:00+00,Tue 12 Oct 2021,561,1580,20,3577633,3509697,239086,3816719,3748783,81.0531828299009,79.6104701154642,73
-7.6926,53.28823,2021/10/12 23:00:00+00,Wed 13 Oct 2021,1027,2015,9,3578660,3511712,239095,3817755,3750807,81.0751836891236,79.6534524890808,74
-7.6926,53.28823,2021/10/13 23:00:00+00,Thu 14 Oct 2021,687,1550,7,3579347,3513262,239102,3818449,3752364,81.0899217164408,79.6865174869667,75
-7.6926,53.28823,2021/10/14 23:00:00+00,Fri 15 Oct 2021,952,2036,7,3580299,3515298,239109,3819408,3754407,81.1102873766672,79.7299033512448,76
-7.6926,53.28823,2021/10/15 23:00:00+00,Sat 16 Oct 2021,1373,2608,12,3581672,3517906,239121,3820793,3757027,81.1396997222498,79.7855425898197,77
-7.6926,53.28823,2021/10/16 23:00:00+00,Sun 17 Oct 2021,1698,2882,2,3583370,3520788,239123,3822493,3759911,81.1758015182717,79.8467882249533,78
-7.6926,53.28823,2021/10/17 23:00:00+00,Mon 18 Oct 2021,666,1201,4,3584036,3521989,239127,3823163,3761116,81.1900298731744,79.8723780274276,79
-7.6926,53.28823,2021/10/18 23:00:00+00,Tue 19 Oct 2021,1329,1759,12,3585365,3523748,239139,3824504,3762887,81.2185078193305,79.9099876043422,80
-7.6926,53.28823,2021/10/19 23:00:00+00,Wed 20 Oct 2021,2242,2282,0,3587607,3526030,239139,3826746,3765169,81.2661197173781,79.9584489564139,81
-7.6926,53.28823,2021/10/20 23:00:00+00,Thu 21 Oct 2021,1744,1788,10,3589351,3527818,239149,3828500,3766967,81.3033682763325,79.9966319147947,82
-7.6926,53.28823,2021/10/21 23:00:00+00,Fri 22 Oct 2021,1491,1891,1,3590842,3529709,239150,3829992,3768859,81.3350529114293,80.0368110901319,83
-7.6926,53.28823,2021/10/22 23:00:00+00,Sat 23 Oct 2021,2007,1673,0,3592849,3531382,239150,3831999,3770532,81.3776742670858,80.0723395046876,84
-7.6926,53.28823,2021/10/23 23:00:00+00,Sun 24 Oct 2021,1943,2177,2,3594792,3533559,239152,3833944,3772711,81.4189789690049,80.1186135126474,85
-7.6926,53.28823,2021/10/24 23:00:00+00,Mon 25 Oct 2021,1214,819,2,3596006,3534378,239154,3835160,3773532,81.4448023713359,80.1360485564909,86
-7.6926,53.28823,2021/10/25 23:00:00+00,Tue 26 Oct 2021,1236,1187,6,3597242,3535565,239160,3836402,3774725,81.4711779187824,80.161383522758,87
-7.6926,53.28823,2021/10/26 23:00:00+00,Wed 27 Oct 2021,1549,1393,5,3598791,3536958,239165,3837956,3776123,81.5041792076165,80.1910719408984,88
-7.6926,53.28823,2021/10/27 23:00:00+00,Thu 28 Oct 2021,2144,1660,2,3600935,3538618,239167,3840102,3777785,81.5497524160065,80.2263667555974,89
-7.6926,53.28823,2021/10/28 23:00:00+00,Fri 29 Oct 2021,2131,1333,0,3603066,3539951,239167,3842233,3779118,81.5950070791375,80.2546748109487,90
-7.6926,53.28823,2021/10/29 23:00:00+00,Sat 30 Oct 2021,2006,1430,0,3605072,3541381,239167,3844239,3780548,81.6376071984433,80.2850427923083,91
-7.6926,53.28823,2021/10/30 23:00:00+00,Sun 31 Oct 2021,1624,1313,0,3606696,3542694,239167,3845863,3781861,81.6720950318195,80.3129261206475,92
-7.6926,53.28823,2021/11/01 00:00:00+00,Mon 01 Nov 2021,259,258,2,3606955,3542952,239169,3846124,3782121,81.6776377193264,80.3184475718038,93
-7.6926,53.28823,2021/11/02 00:00:00+00,Tue 02 Nov 2021,1087,1071,9,3608042,3544023,239178,3847220,3783201,81.7009127595852,80.341382830453,94
-7.6926,53.28823,2021/11/03 00:00:00+00,Wed 03 Nov 2021,2532,1830,5,3610574,3545853,239183,3849757,3785036,81.7547893810602,80.380351533806,95
-7.6926,53.28823,2021/11/04 00:00:00+00,Thu 04 Nov 2021,1541,1250,1,3612115,3547103,239184,3851299,3786287,81.7875358336871,80.406918208408,96
-7.6926,53.28823,2021/11/05 00:00:00+00,Fri 05 Nov 2021,1627,1056,2,3613742,3548159,239186,3852928,3787345,81.8221298488163,80.429386267344,97
-7.6926,53.28823,2021/11/06 00:00:00+00,Sat 06 Nov 2021,1818,1337,5,3615560,3549496,239191,3854751,3788687,81.8608437159621,80.4578854498507,98
-7.6926,53.28823,2021/11/07 00:00:00+00,Sun 07 Nov 2021,725,765,0,3616285,3550261,239191,3855476,3789452,81.8762400701479,80.4741312580605,99
-7.6926,53.28823,2021/11/08 00:00:00+00,Mon 08 Nov 2021,511,510,1,3616796,3550771,239192,3855988,3789963,81.8871130816557,80.4849830332177,100
-7.6926,53.28823,2021/11/09 00:00:00+00,Tue 09 Nov 2021,1376,1025,1,3618172,3551796,239193,3857365,3790989,81.9163555364334,80.5067715289344,101
-7.6926,53.28823,2021/11/10 00:00:00+00,Wed 10 Nov 2021,1625,1313,0,3619797,3553109,239193,3858990,3792302,81.9508646061602,80.5346548572737,102
-7.6926,53.28823,2021/11/11 00:00:00+00,Thu 11 Nov 2021,1398,1079,1,3621195,3554188,239194,3860389,3793382,81.9805742606511,80.5575901159229,103
-7.6926,53.28823,2021/11/12 00:00:00+00,Fri 12 Nov 2021,1154,1096,5,3622349,3555284,239199,3861548,3794483,82.0051871909978,80.5809713379347,104
-7.6926,53.28823,2021/11/13 00:00:00+00,Sat 13 Nov 2021,1412,1351,0,3623761,3556635,239199,3862960,3795834,82.0351729180466,80.6096616475968,105
-7.6926,53.28823,2021/11/14 00:00:00+00,Sun 14 Nov 2021,1649,1799,0,3625410,3558434,239199,3864609,3797633,82.0701916601878,80.6478658423282,106
-7.6926,53.28823,2021/11/15 00:00:00+00,Mon 15 Nov 2021,1245,562,0,3626655,3558996,239199,3865854,3798195,82.0966309166862,80.659800671366,107
-7.6926,53.28823,2021/11/16 00:00:00+00,Tue 16 Nov 2021,1320,1044,5,3627975,3560040,239204,3867179,3799244,82.1247690812327,80.6820776031466,108
-7.6926,53.28823,2021/11/17 00:00:00+00,Wed 17 Nov 2021,1518,1078,0,3629493,3561118,239204,3868697,3800322,82.1570058614451,80.7049703890945,109
-7.6926,53.28823,2021/11/18 00:00:00+00,Thu 18 Nov 2021,1665,2457,5,3631158,3563575,239209,3870367,3802784,82.192470566949,80.7572542842745,110
-7.6926,53.28823,2021/11/19 00:00:00+00,Fri 19 Nov 2021,1184,1513,0,3632342,3565088,239209,3871551,3804297,82.2176144060607,80.7893848827339,111
-7.6926,53.28823,2021/11/20 00:00:00+00,Sat 20 Nov 2021,1541,2919,10,3633883,3568007,239219,3873102,3807226,82.250551985843,80.8515861536446,112
-7.6926,53.28823,2021/11/21 00:00:00+00,Sun 21 Nov 2021,1786,2751,0,3635669,3570758,239219,3874888,3809977,82.2884801080166,80.9100073541482,113
-7.6926,53.28823,2021/11/22 00:00:00+00,Mon 22 Nov 2021,712,486,2,3636381,3571244,239221,3875602,3810465,82.3036428623458,80.9203706932416,114
-7.6926,53.28823,2021/11/23 00:00:00+00,Tue 23 Nov 2021,2161,1550,6,3638542,3572794,239227,3877769,3812021,82.3496620340984,80.9534144547769,115
-7.6926,53.28823,2021/11/24 00:00:00+00,Wed 24 Nov 2021,1622,3110,2,3640164,3575904,239229,3879393,3815133,82.3841498674745,81.0195019778475,116
-7.6926,53.28823,2021/11/25 00:00:00+00,Thu 25 Nov 2021,1002,1153,1,3641166,3577057,239230,3880396,3816287,82.4054499271275,81.0440087264412,117
-7.6926,53.28823,2021/11/26 00:00:00+00,Fri 26 Nov 2021,1290,1071,12,3642456,3578128,239242,3881698,3817370,82.4330996556101,81.0670076941422,118
-7.6926,53.28823,2021/11/27 00:00:00+00,Sat 27 Nov 2021,1225,1546,5,3643681,3579674,239247,3882928,3818921,82.4592203668495,81.0999452739245,119
-7.6926,53.28823,2021/11/28 00:00:00+00,Sun 28 Nov 2021,1969,2249,0,3645650,3581923,239247,3884897,3821170,82.501034741183,81.1477058264264,120
-7.6926,53.28823,2021/11/29 00:00:00+00,Mon 29 Nov 2021,551,970,1,3646201,3582893,239248,3885449,3822141,82.5127572067149,81.1683263228601,121
-7.6926,53.28823,2021/11/30 00:00:00+00,Tue 30 Nov 2021,1928,1616,6,3648129,3584509,239254,3887383,3823763,82.5538283087774,81.2027716835351,122
-7.6926,53.28823,2021/12/01 00:00:00+00,Wed 01 Dec 2021,1087,1352,1,3649216,3585861,239255,3888471,3825116,82.5769334582314,81.2315044658984,123
-7.6926,53.28823,2021/12/02 00:00:00+00,Thu 02 Dec 2021,1776,1393,0,3650992,3587254,239255,3890247,3826509,82.614649216899,81.2610867022857,124
-7.6926,53.28823,2021/12/03 00:00:00+00,Fri 03 Dec 2021,1042,1161,3,3652034,3588415,239258,3891292,3827673,82.6368412032771,81.2858058143854,125
-7.6926,53.28823,2021/12/04 00:00:00+00,Sat 04 Dec 2021,1203,1690,0,3653237,3590105,239258,3892495,3829363,82.6623885330502,81.3216952469012,126
-7.6926,53.28823,2021/12/05 00:00:00+00,Sun 05 Dec 2021,1349,1769,0,3654586,3591874,239258,3893844,3831132,82.6910363700111,81.3592623511146,127
-7.6926,53.28823,2021/12/06 00:00:00+00,Mon 06 Dec 2021,934,1270,0,3655520,3593144,239258,3894778,3832402,82.7108711214726,81.386232516378,128
-7.6926,53.28823,2021/12/07 00:00:00+00,Tue 07 Dec 2021,483,727,1,3656003,3593871,239259,3895262,3833130,82.7211495151635,81.4016925796156,129
-7.6926,53.28823,2021/12/08 00:00:00+00,Wed 08 Dec 2021,815,1485,0,3656818,3595356,239259,3896077,3834615,82.7384571409034,81.4332285602583,130
-7.6926,53.28823,2021/12/09 00:00:00+00,Thu 09 Dec 2021,791,1177,0,3657609,3596533,239259,3896868,3835792,82.7552550942289,81.4582237449157,131
-7.6926,53.28823,2021/12/10 00:00:00+00,Fri 10 Dec 2021,888,1592,1,3658497,3598125,239260,3897757,3837385,82.7741342099133,81.4920532514233,132
-7.6926,53.28823,2021/12/11 00:00:00+00,Sat 11 Dec 2021,640,833,0,3659137,3598958,239260,3898397,3838218,82.787725474298,81.509743131474,133
-7.6926,53.28823,2020/12/28 00:00:00+00,Mon 28 Dec 2020,182,23,0,182,23,0,182,23,0.0038650158094012,0.000488436063825427,134
-7.6926,53.28823,2021/12/12 00:00:00+00,Sun 12 Dec 2021,690,1188,0,3659827,3600146,239260,3899087,3839406,82.8023785562127,81.5349719159882,135
-7.6926,53.28823,2020/12/29 00:00:00+00,Tue 29 Dec 2020,72,1,0,254,24,0,254,24,0.0053940330526808,0.000509672414426533,136
-7.6926,53.28823,2021/04/14 23:00:00+00,Thu 15 Apr 2021,27096,10773,1,853205,364144,179,853384,364323,18.1227618213738,7.73689096004657,137
-7.6926,53.28823,2021/12/13 00:00:00+00,Mon 13 Dec 2021,720,1042,0,3660547,3601188,239260,3899807,3840448,82.8176687286455,81.5571001933145,138
-7.6926,53.28823,2020/12/30 00:00:00+00,Wed 30 Dec 2020,1053,1,0,1307,25,0,1307,25,0.0277559102356449,0.000530908765027638,139
-7.6926,53.28823,2021/12/14 00:00:00+00,Tue 14 Dec 2021,627,1175,1,3661174,3602363,239261,3900435,3841624,82.831005156823,81.5820741416214,140
-7.6926,53.28823,2021/04/15 23:00:00+00,Fri 16 Apr 2021,27940,9814,1,881145,373958,180,881325,374138,18.7161266935193,7.94532574119642,141
-7.6926,53.28823,2020/12/31 00:00:00+00,Thu 31 Dec 2020,1027,1,0,2334,26,0,2334,26,0.0495656423029803,0.000552145115628744,142
-7.6926,53.28823,2021/12/15 00:00:00+00,Wed 15 Dec 2021,791,1215,1,3661965,3603578,239262,3901227,3842840,82.8478243464991,81.6078975439523,143
-7.6926,53.28823,2021/04/16 23:00:00+00,Sat 17 Apr 2021,15825,4533,2,896970,378491,182,897152,378673,19.052234414483,8.04163259117243,144
-7.6926,53.28823,2021/01/01 00:00:00+00,Fri 01 Jan 2021,807,0,0,3141,26,0,3141,26,0.0667033772380724,0.000552145115628744,145
-7.6926,53.28823,2021/01/02 00:00:00+00,Sat 02 Jan 2021,1014,0,0,4155,26,0,4155,26,0.0882370367475934,0.000552145115628744,146
-7.6926,53.28823,2021/01/03 00:00:00+00,Sun 03 Jan 2021,18,2,0,4173,28,0,4173,28,0.0886192910584133,0.000594617816830955,147
-7.6926,53.28823,2021/01/04 00:00:00+00,Mon 04 Jan 2021,1186,3,0,5359,31,0,5359,31,0.113805602871325,0.000658326868634271,148
-7.6926,53.28823,2021/01/05 00:00:00+00,Tue 05 Jan 2021,3515,7,0,8874,38,0,8874,38,0.18845137523421,0.00080698132284201,149
-7.6926,53.28823,2021/01/06 00:00:00+00,Wed 06 Jan 2021,6765,8,0,15639,46,0,15639,46,0.332115287050689,0.000976872127650854,150
-7.6926,53.28823,2021/01/07 00:00:00+00,Thu 07 Jan 2021,11714,7,0,27353,53,0,27353,53,0.580877897992039,0.00112552658185859,151
-7.6926,53.28823,2021/01/08 00:00:00+00,Fri 08 Jan 2021,12671,5,0,40024,58,0,40024,58,0.849963696458647,0.00123170833486412,152
-7.6926,53.28823,2021/01/09 00:00:00+00,Sat 09 Jan 2021,8071,5,0,48095,63,0,48095,63,1.02136228216017,0.00133789008786965,153
-7.6926,53.28823,2021/01/10 00:00:00+00,Sun 10 Jan 2021,4770,3,1,52865,66,1,52866,67,1.12268091087804,0.00142283549027407,154
-7.6926,53.28823,2021/01/11 00:00:00+00,Mon 11 Jan 2021,8334,7,0,61199,73,1,61200,74,1.29966465678766,0.00157148994448181,155
-7.6926,53.28823,2021/01/12 00:00:00+00,Tue 12 Jan 2021,8866,8,0,70065,81,1,70066,82,1.48794614121706,0.00174138074929065,156
-7.6926,53.28823,2021/01/13 00:00:00+00,Wed 13 Jan 2021,9868,5,0,79933,86,1,79934,87,1.69750644894877,0.00184756250229618,157
-7.6926,53.28823,2021/01/14 00:00:00+00,Thu 14 Jan 2021,8066,4,0,87999,90,1,88000,91,1.86879885289729,0.0019325079047006,158
-7.6926,53.28823,2021/01/15 00:00:00+00,Fri 15 Jan 2021,7673,2,0,95672,92,1,95673,93,2.03174537105957,0.00197498060590281,159
-7.6926,53.28823,2021/01/16 00:00:00+00,Sat 16 Jan 2021,5215,2,0,100887,94,1,100888,95,2.14249293944433,0.00201745330710502,160
-7.6926,53.28823,2021/01/17 00:00:00+00,Sun 17 Jan 2021,1107,4,0,101994,98,1,101995,99,2.16600157955976,0.00210239870950945,161
-7.6926,53.28823,2021/01/18 00:00:00+00,Mon 18 Jan 2021,8693,7,0,110687,105,1,110688,106,2.35060917533517,0.00225105316371719,162
-7.6926,53.28823,2021/01/19 00:00:00+00,Tue 19 Jan 2021,8364,17,0,119051,122,1,119052,123,2.52823001176281,0.00261207112393598,163
-7.6926,53.28823,2021/01/20 00:00:00+00,Wed 20 Jan 2021,8435,958,0,127486,1080,1,127487,1081,2.70735862908314,0.0229564949997951,164
-7.6926,53.28823,2021/01/21 00:00:00+00,Thu 21 Jan 2021,8977,958,0,136463,2038,1,136464,2039,2.89799734842926,0.0433009188756542,165
-7.6926,53.28823,2021/01/22 00:00:00+00,Fri 22 Jan 2021,6760,965,0,143223,3003,1,143224,3004,3.04155507849274,0.063793997205721,166
-7.6926,53.28823,2021/01/23 00:00:00+00,Sat 23 Jan 2021,4169,460,0,147392,3463,1,147393,3464,3.13008942414875,0.0735627184822295,167
-7.6926,53.28823,2021/01/24 00:00:00+00,Sun 24 Jan 2021,1177,397,0,148569,3860,1,148570,3861,3.15508460880625,0.0819935496708684,168
-7.6926,53.28823,2021/01/25 00:00:00+00,Mon 25 Jan 2021,1344,1284,0,149913,5144,1,149914,5145,3.18362626401413,0.109261023842688,169
-7.6926,53.28823,2021/01/26 00:00:00+00,Tue 26 Jan 2021,997,3495,0,150910,8639,1,150911,8640,3.20479890556344,0.183482069193552,170
-7.6926,53.28823,2021/01/27 00:00:00+00,Wed 27 Jan 2021,2151,6699,0,153061,15338,1,153062,15339,3.25047829570641,0.325744381870358,171
-7.6926,53.28823,2021/01/28 00:00:00+00,Thu 28 Jan 2021,977,11535,0,154038,26873,1,154039,26874,3.27122621024369,0.57070568605411,172
-7.6926,53.28823,2021/01/29 00:00:00+00,Fri 29 Jan 2021,1554,11524,0,155592,38397,1,155593,38398,3.30422749907781,0.81543339038125,173
-7.6926,53.28823,2021/01/30 00:00:00+00,Sat 30 Jan 2021,614,7793,0,156206,46190,1,156207,46191,3.31726661834689,0.980928270615665,174
-7.6926,53.28823,2021/01/31 00:00:00+00,Sun 31 Jan 2021,213,4085,0,156419,50275,1,156420,50276,3.32178996102493,1.06767876282118,175
-7.6926,53.28823,2021/02/01 00:00:00+00,Mon 01 Feb 2021,1000,8336,0,157419,58611,1,157420,58612,3.34302631162603,1.244704981432,176
-7.6926,53.28823,2021/02/02 00:00:00+00,Tue 02 Feb 2021,817,5104,0,158236,63715,1,158237,63716,3.36037641006713,1.35309531490004,177
-7.6926,53.28823,2021/02/03 00:00:00+00,Wed 03 Feb 2021,1383,6861,0,159619,70576,1,159620,70577,3.38974628294846,1.49879791637422,178
-7.6926,53.28823,2021/02/04 00:00:00+00,Thu 04 Feb 2021,1411,10536,1,161030,81112,2,161032,81114,3.41973200999722,1.72256534265807,179
-7.6926,53.28823,2021/02/05 00:00:00+00,Fri 05 Feb 2021,3370,8609,0,164400,89721,2,164402,89723,3.49129851152295,1.90538908498299,180
-7.6926,53.28823,2021/02/06 00:00:00+00,Sat 06 Feb 2021,885,3864,0,165285,93585,2,165287,93587,3.51009268180493,1.98744634370566,181
-7.6926,53.28823,2021/02/07 00:00:00+00,Sun 07 Feb 2021,320,1295,1,165605,94880,3,165608,94883,3.51690955034788,2.0149686540847,182
-7.6926,53.28823,2021/02/08 00:00:00+00,Mon 08 Feb 2021,1152,874,0,166757,95754,3,166760,95757,3.54137382624036,2.03352922451006,183
-7.6926,53.28823,2021/02/09 00:00:00+00,Tue 09 Feb 2021,4230,533,2,170987,96287,5,170992,96292,3.63124606198424,2.04489067208165,184
-7.6926,53.28823,2021/02/10 00:00:00+00,Wed 10 Feb 2021,8804,578,0,179791,96865,5,179796,96870,3.81821089267637,2.05716528272909,185
-7.6926,53.28823,2021/02/11 00:00:00+00,Thu 11 Feb 2021,6162,440,0,185953,97305,5,185958,97310,3.94906928508038,2.06650927699358,186
-7.6926,53.28823,2021/02/12 00:00:00+00,Fri 12 Feb 2021,4373,520,0,190326,97825,5,190331,97830,4.04193584625902,2.07755217930615,187
-7.6926,53.28823,2021/02/13 00:00:00+00,Sat 13 Feb 2021,1198,1911,0,191524,99736,5,191529,99741,4.06737699427914,2.11813484530487,188
-7.6926,53.28823,2021/02/14 00:00:00+00,Sun 14 Feb 2021,2686,24,0,194210,99760,5,194215,99765,4.12441783199371,2.11864451771929,189
-7.6926,53.28823,2021/02/15 00:00:00+00,Mon 15 Feb 2021,1949,7879,0,196159,107639,5,196164,107644,4.16580747931526,2.2859657241054,190
-7.6926,53.28823,2021/02/16 00:00:00+00,Tue 16 Feb 2021,5622,8156,0,201781,115795,5,201786,115800,4.28519824239468,2.45916939960802,191
-7.6926,53.28823,2021/02/17 00:00:00+00,Wed 17 Feb 2021,9719,8460,0,211500,124255,5,211505,124260,4.49159433388682,2.63882892569337,192
-7.6926,53.28823,2021/02/18 00:00:00+00,Thu 18 Feb 2021,8447,8344,0,219947,132599,5,219952,132604,4.67097778741436,2.816025035109,193
-7.6926,53.28823,2021/02/19 00:00:00+00,Fri 19 Feb 2021,9372,6578,0,229319,139177,5,229324,139182,4.87000486524792,2.95571774936307,194
-7.6926,53.28823,2021/02/20 00:00:00+00,Sat 20 Feb 2021,5878,3566,2,235197,142743,7,235204,142750,4.99487460678242,3.03148904830781,195
-7.6926,53.28823,2021/02/21 00:00:00+00,Sun 21 Feb 2021,1101,1020,4,236298,143763,11,236309,143774,5.01834077419664,3.05323507132335,196
-7.6926,53.28823,2021/02/22 00:00:00+00,Mon 22 Feb 2021,3932,1114,1,240230,144877,12,240242,144889,5.10186334111079,3.07691360224358,197
-7.6926,53.28823,2021/02/23 00:00:00+00,Tue 23 Feb 2021,13342,1058,0,253572,145935,12,253584,145947,5.38519873083074,3.09938166117955,198
-7.6926,53.28823,2021/02/24 00:00:00+00,Wed 24 Feb 2021,16920,2093,2,270492,148028,14,270506,148042,5.74456025570265,3.14387181568886,199
-7.6926,53.28823,2021/02/25 00:00:00+00,Thu 25 Feb 2021,18066,1746,2,288558,149774,16,288574,149790,6.12825863836342,3.1809929565396,200
-7.6926,53.28823,2021/02/26 00:00:00+00,Fri 26 Feb 2021,16067,2757,0,304625,152531,16,304641,152547,6.46946308347139,3.23954157514684,201
-7.6926,53.28823,2021/02/27 00:00:00+00,Sat 27 Feb 2021,8977,702,1,313602,153233,17,313619,153250,6.66012303916811,3.25447072961942,202
-7.6926,53.28823,2021/02/28 00:00:00+00,Sun 28 Feb 2021,2432,49,1,316034,153282,18,316052,153300,6.7117910801806,3.25553254714948,203
-7.6926,53.28823,2021/03/01 00:00:00+00,Mon 01 Mar 2021,5569,782,0,321603,154064,18,321621,154082,6.83005631667816,3.27213937331954,204
-7.6926,53.28823,2021/03/02 00:00:00+00,Tue 02 Mar 2021,12162,1602,0,333765,155666,18,333783,155684,7.08833281268881,3.30616000698251,205
-7.6926,53.28823,2021/03/03 00:00:00+00,Wed 03 Mar 2021,12868,1497,1,346633,157163,19,346652,157182,7.36162340857443,3.33797206018297,206
-7.6926,53.28823,2021/03/04 00:00:00+00,Thu 04 Mar 2021,18710,1681,3,365343,158844,22,365365,158866,7.75901923737292,3.37373407459523,207
-7.6926,53.28823,2021/03/05 00:00:00+00,Fri 05 Mar 2021,18417,2387,6,383760,161231,28,383788,161259,8.15025652449709,3.42455266158368,208
-7.6926,53.28823,2021/03/06 00:00:00+00,Sat 06 Mar 2021,10425,134,4,394185,161365,32,394217,161397,8.37173042491602,3.42748327796663,209
-7.6926,53.28823,2021/03/07 00:00:00+00,Sun 07 Mar 2021,1506,9,2,395691,161374,34,395725,161408,8.40375484162248,3.42771687782324,210
-7.6926,53.28823,2021/03/08 00:00:00+00,Mon 08 Mar 2021,6641,1490,3,402332,162864,37,402369,162901,8.54484915501623,3.45942274927069,211
-7.6926,53.28823,2021/03/09 00:00:00+00,Tue 09 Mar 2021,13795,3092,3,416127,165956,40,416167,165996,8.83786832061028,3.52514925438111,212
-7.6926,53.28823,2021/03/10 00:00:00+00,Wed 10 Mar 2021,13698,3973,3,429825,169929,43,429868,169972,9.12882756019603,3.60958498437111,213
-7.6926,53.28823,2021/03/11 00:00:00+00,Thu 11 Mar 2021,18442,2094,2,448267,172023,45,448312,172068,9.52051081068282,3.65409637523102,214
-7.6926,53.28823,2021/03/12 00:00:00+00,Fri 12 Mar 2021,17296,1327,3,465563,173350,48,465611,173398,9.88787843973134,3.68234072153049,215
-7.6926,53.28823,2021/03/13 00:00:00+00,Sat 13 Mar 2021,8267,167,0,473830,173517,48,473878,173565,10.0634393501507,3.68588719208088,216
-7.6926,53.28823,2021/03/14 00:00:00+00,Sun 14 Mar 2021,368,16,1,474198,173533,49,474247,173582,10.0712755635225,3.6862482100411,217
-7.6926,53.28823,2021/03/15 00:00:00+00,Mon 15 Mar 2021,2616,984,0,476814,174517,49,476863,174566,10.126829856695,3.70714477903259,218
-7.6926,53.28823,2021/03/16 00:00:00+00,Tue 16 Mar 2021,8916,3808,2,485730,178325,51,485781,178376,10.3162156313556,3.7880552748228,219
-7.6926,53.28823,2021/03/17 00:00:00+00,Wed 17 Mar 2021,4867,2406,6,490597,180731,57,490654,180788,10.4197003678348,3.83927735247266,220
-7.6926,53.28823,2021/03/18 00:00:00+00,Thu 18 Mar 2021,11689,4674,2,502286,185405,59,502345,185464,10.6679745427124,3.93857852788343,221
-7.6926,53.28823,2021/03/19 00:00:00+00,Fri 19 Mar 2021,10324,6108,2,512610,191513,61,512671,191574,10.8872610990194,4.06833263005619,222
-7.6926,53.28823,2021/03/20 00:00:00+00,Sat 20 Mar 2021,5210,3111,2,517820,194624,63,517883,194687,10.9979449583523,4.13444138947743,223
-7.6926,53.28823,2021/03/21 00:00:00+00,Sun 21 Mar 2021,3615,50,3,521435,194674,66,521501,194740,11.0747780748271,4.13556691605929,224
-7.6926,53.28823,2021/03/22 00:00:00+00,Mon 22 Mar 2021,7375,2393,1,528810,197067,67,528877,197134,11.2314173968609,4.18640673939834,225
-7.6926,53.28823,2021/03/23 00:00:00+00,Tue 23 Mar 2021,12540,7378,3,541350,204445,70,541420,204515,11.4977849424506,4.3431522431851,226
-7.6926,53.28823,2021/03/24 00:00:00+00,Wed 24 Mar 2021,13582,9769,1,554932,214214,71,555003,214285,11.7862382926654,4.5506313885579,227
-7.6926,53.28823,2021/03/25 00:00:00+00,Thu 25 Mar 2021,20823,10208,3,575755,224422,74,575829,224496,12.228506530284,4.76747576454579,228
-7.6926,53.28823,2021/03/26 00:00:00+00,Fri 26 Mar 2021,19671,9483,1,595426,233905,75,595501,233980,12.6462680193089,4.96888131364667,229
-7.6926,53.28823,2021/03/27 00:00:00+00,Sat 27 Mar 2021,11712,5331,1,607138,239236,76,607214,239312,12.8950093938997,5.08211353505176,230
-7.6926,53.28823,2021/03/28 00:00:00+00,Sun 28 Mar 2021,2469,479,0,609607,239715,76,609683,239791,12.9474419435338,5.09228574698969,231
-7.6926,53.28823,2021/03/28 23:00:00+00,Mon 29 Mar 2021,9226,3101,3,618833,242816,79,618912,242895,13.1434322232314,5.15820337925553,232
-7.6926,53.28823,2021/03/29 23:00:00+00,Tue 30 Mar 2021,13295,8653,4,632128,251469,83,632211,251552,13.4258544498755,5.3420464664093,233
-7.6926,53.28823,2021/03/30 23:00:00+00,Wed 31 Mar 2021,15778,10492,3,647906,261961,86,647992,262047,13.7609852987116,5.5649219659679,234
-7.6926,53.28823,2021/03/31 23:00:00+00,Thu 01 Apr 2021,19649,11612,7,667555,273573,93,667648,273666,14.1784070061269,5.81166712360214,235
-7.6926,53.28823,2021/04/01 23:00:00+00,Fri 02 Apr 2021,20102,13710,7,687657,287283,100,687757,287383,14.6054487803645,6.10296614479751,236
-7.6926,53.28823,2021/04/02 23:00:00+00,Sat 03 Apr 2021,7518,4635,5,695175,291918,105,695280,292023,14.7652098459366,6.20150281158664,237
-7.6926,53.28823,2021/04/03 23:00:00+00,Sun 04 Apr 2021,3004,166,2,698179,292084,107,698286,292191,14.8290463158436,6.20507051848762,238
-7.6926,53.28823,2021/04/04 23:00:00+00,Mon 05 Apr 2021,3399,593,3,701578,292677,110,701688,292787,14.9012923805885,6.21772738344588,239
-7.6926,53.28823,2021/04/05 23:00:00+00,Tue 06 Apr 2021,11939,8145,6,713517,300822,116,713633,300938,15.1549605885187,6.39082487719549,240
-7.6926,53.28823,2021/04/06 23:00:00+00,Wed 07 Apr 2021,18312,10444,5,731829,311266,121,731950,311387,15.5439468224792,6.61272350462645,241
-7.6926,53.28823,2021/04/07 23:00:00+00,Thu 08 Apr 2021,20142,10551,13,751971,321817,134,752105,321951,15.9719654688445,6.83706431237652,242
-7.6926,53.28823,2021/04/08 23:00:00+00,Fri 09 Apr 2021,20665,9142,15,772636,330959,149,772785,331108,16.4111331992753,7.03152557483085,243
-7.6926,53.28823,2021/04/09 23:00:00+00,Sat 10 Apr 2021,11130,4145,12,783766,335104,161,783927,335265,16.6477486176728,7.11980508427964,244
-7.6926,53.28823,2021/04/10 23:00:00+00,Sun 11 Apr 2021,2832,344,6,786598,335448,167,786765,335615,16.7080173806788,7.12723780699003,245
-7.6926,53.28823,2021/04/11 23:00:00+00,Mon 12 Apr 2021,7733,2774,8,794331,338222,175,794506,338397,16.8724079706819,7.1863173343623,246
-7.6926,53.28823,2021/04/12 23:00:00+00,Tue 13 Apr 2021,11461,8575,1,805792,346797,176,805968,346973,17.1158190212718,7.36844027711739,247
-7.6926,53.28823,2021/04/13 23:00:00+00,Wed 14 Apr 2021,20317,6574,2,826109,353371,178,826287,353549,17.5473204291357,7.50809051867026,248
-7.6926,53.28823,2021/12/16 00:00:00+00,Thu 16 Dec 2021,1058,1503,7,3663023,3605081,239269,3902292,3844350,82.8704410598893,81.63996443336,249
-7.6926,53.28823,2021/12/17 00:00:00+00,Fri 17 Dec 2021,1203,2421,1,3664226,3607502,239270,3903496,3846772,82.896009626013,81.6913988745159,250
-7.6926,53.28823,2021/04/17 23:00:00+00,Sun 18 Apr 2021,1045,468,0,898015,378959,182,898197,379141,19.0744264008612,8.05157120325375,251
-7.6926,53.28823,2021/12/18 00:00:00+00,Sat 18 Dec 2021,1265,1164,0,3665491,3608666,239270,3904761,3847936,82.9228736095234,81.7161179866156,252
-7.6926,53.28823,2021/12/19 00:00:00+00,Sun 19 Dec 2021,558,877,0,3666049,3609543,239270,3905319,3848813,82.9347234931588,81.7347422660928,253
-7.6926,53.28823,2021/04/18 23:00:00+00,Mon 19 Apr 2021,6713,2230,0,904728,381189,182,904910,381371,19.2169860224464,8.09892826509421,254
-7.6926,53.28823,2021/12/20 00:00:00+00,Mon 20 Dec 2021,533,578,0,3666582,3610121,239270,3905852,3849391,82.9460424680292,81.7470168767402,255
-7.6926,53.28823,2021/04/19 23:00:00+00,Tue 20 Apr 2021,15045,7286,1,919773,388475,183,919956,388658,19.5365081535906,8.25367755192447,256
-7.6926,53.28823,2021/12/21 00:00:00+00,Tue 21 Dec 2021,1460,1767,3,3668042,3611888,239273,3907315,3851161,82.9771112489586,81.7846052173041,257
-7.6926,53.28823,2021/04/20 23:00:00+00,Wed 21 Apr 2021,26664,9839,2,946437,398314,185,946622,398499,20.1027966787197,8.46266447818995,258
-7.6926,53.28823,2021/12/22 00:00:00+00,Wed 22 Dec 2021,1238,1540,2,3669280,3613428,239275,3908555,3852703,83.003444323704,81.817351669931,259
-7.6926,53.28823,2021/04/21 23:00:00+00,Thu 22 Apr 2021,31584,12158,1,978021,410472,186,978207,410658,20.7735468124556,8.72087726514879,260
-7.6926,53.28823,2021/12/23 00:00:00+00,Thu 23 Dec 2021,959,1324,0,3670239,3614752,239275,3909514,3854027,83.0238099839304,81.8454685981269,261
-7.6926,53.28823,2021/04/22 23:00:00+00,Fri 23 Apr 2021,33558,12349,1,1011579,422821,187,1011766,423008,21.4862175022781,8.98314619507244,262
-7.6926,53.28823,2021/12/24 00:00:00+00,Fri 24 Dec 2021,100,135,0,3670339,3614887,239275,3909614,3854162,83.0259336189906,81.8483355054581,263
-7.6926,53.28823,2021/04/23 23:00:00+00,Sat 24 Apr 2021,23658,6976,1,1035237,429797,188,1035425,429985,21.9886483211497,9.13131221321636,264
-7.6926,53.28823,2021/12/25 00:00:00+00,Sat 25 Dec 2021,1,0,0,3670340,3614887,239275,3909615,3854162,83.0259548553412,81.8483355054581,265
-7.6926,53.28823,2021/04/24 23:00:00+00,Sun 25 Apr 2021,9720,282,2,1044957,430079,190,1045147,430269,22.1951081216936,9.13734333678707,266
-7.6926,53.28823,2021/12/26 00:00:00+00,Sun 26 Dec 2021,10,6,0,3670350,3614893,239275,3909625,3854168,83.0261672188472,81.8484629235617,267
-7.6926,53.28823,2021/04/25 23:00:00+00,Mon 26 Apr 2021,15535,3031,1,1060492,433110,191,1060683,433301,22.5250360646324,9.20173195180962,268
-7.6926,53.28823,2021/12/27 00:00:00+00,Mon 27 Dec 2021,386,581,0,3670736,3615474,239275,3910011,3854749,83.0343644501792,81.8608012432609,269
-7.6926,53.28823,2021/04/26 23:00:00+00,Tue 27 Apr 2021,25874,7783,6,1086366,440893,197,1086563,441090,23.074632818189,9.36714188664163,270
-7.6926,53.28823,2021/12/28 00:00:00+00,Tue 28 Dec 2021,462,734,0,3671198,3616208,239275,3910473,3855483,83.0441756441569,81.8763887246021,271
-7.6926,53.28823,2021/04/27 23:00:00+00,Wed 28 Apr 2021,25991,8572,5,1112357,449465,202,1112559,449667,23.6266929884154,9.54928606574732,272
-7.6926,53.28823,2021/12/29 00:00:00+00,Wed 29 Dec 2021,1082,1271,0,3672280,3617479,239275,3911555,3856754,83.0671533755073,81.9033801262161,273
-7.6926,53.28823,2021/04/28 23:00:00+00,Thu 29 Apr 2021,31648,11317,4,1144005,460782,206,1144211,460988,24.2988659576415,9.78970279090243,274
-7.6926,53.28823,2021/12/30 00:00:00+00,Thu 30 Dec 2021,1066,1161,1,3673346,3618640,239276,3912622,3857916,83.0898125615987,81.9280567656146,275
-7.6926,53.28823,2021/04/29 23:00:00+00,Fri 30 Apr 2021,36077,13501,7,1180082,474283,213,1180295,474496,25.0651584327318,10.0765634148222,276
-7.6926,53.28823,2021/12/31 00:00:00+00,Fri 31 Dec 2021,720,1663,0,3674066,3620303,239276,3913342,3859579,83.1051027340315,81.9633728166642,277
-7.6926,53.28823,2021/04/30 23:00:00+00,Sat 01 May 2021,16510,6664,16,1196592,480947,229,1196821,481176,25.4161103627657,10.2184222368376,278
-7.6926,53.28823,2022/01/01 00:00:00+00,Sat 01 Jan 2022,68,95,0,3674134,3620398,239276,3913410,3859674,83.1065468058724,81.9653902699714,279
-7.6926,53.28823,2021/05/01 23:00:00+00,Sun 02 May 2021,12406,893,11,1208998,481840,240,1209238,482080,25.6798021281796,10.237619897781,280
-7.6926,53.28823,2022/01/02 00:00:00+00,Sun 02 Jan 2022,270,620,0,3674404,3621018,239276,3913680,3860294,83.1122806205347,81.978556807344,281
-7.6926,53.28823,2021/05/02 23:00:00+00,Mon 03 May 2021,14215,902,16,1223213,482742,256,1223469,482998,25.982016633584,10.2571148676328,282
-7.6926,53.28823,2022/01/03 00:00:00+00,Mon 03 Jan 2022,3631,715,0,3678035,3621733,239276,3917311,3861009,83.1893898095673,81.9937407980238,283
-7.6926,53.28823,2021/05/03 23:00:00+00,Tue 04 May 2021,26585,6754,7,1249798,489496,263,1250061,489759,26.5467336687686,10.4006938340468,284
-7.6926,53.28823,2022/01/04 00:00:00+00,Tue 04 Jan 2022,1193,751,0,3679228,3622484,239276,3918504,3861760,83.2147247758344,82.0096892973253,285
-7.6926,53.28823,2021/05/04 23:00:00+00,Wed 05 May 2021,32025,13422,68,1281823,502918,331,1282154,503249,27.2282718686098,10.6871722036558,286
-7.6926,53.28823,2022/01/05 00:00:00+00,Wed 05 Jan 2022,2142,863,0,3681370,3623347,239276,3920646,3862623,83.260213038822,82.028016267894,287
-7.6926,53.28823,2022/01/06 00:00:00+00,Thu 06 Jan 2022,2463,1641,0,3683833,3624988,239276,3923109,3864264,83.3125181703525,82.0628651192304,288
-7.6926,53.28823,2022/01/07 00:00:00+00,Fri 07 Jan 2022,4841,744,0,3688674,3625732,239276,3927950,3865008,83.4153233436124,82.0786649640776,289
-7.6926,53.28823,2022/01/08 00:00:00+00,Sat 08 Jan 2022,9790,726,1,3698464,3626458,239277,3937741,3865735,83.6232484523479,82.0941037909647,290
-7.6926,53.28823,2022/01/09 00:00:00+00,Sun 09 Jan 2022,7117,662,0,3705581,3627120,239277,3944858,3866397,83.7743875595759,82.1081622550626,291
-7.6926,53.28823,2022/01/10 00:00:00+00,Mon 10 Jan 2022,6652,476,0,3712233,3627596,239277,3951510,3866873,83.9156517637745,82.1182707579487,292
-7.6926,53.28823,2022/01/11 00:00:00+00,Tue 11 Jan 2022,4767,1318,1,3717000,3628914,239278,3956278,3868192,84.0169066834406,82.1462815043916,293
-7.6926,53.28823,2022/01/12 00:00:00+00,Wed 12 Jan 2022,7552,862,1,3724552,3629776,239279,3963831,3869055,84.1773048395307,82.1646084749603,294
-7.6926,53.28823,2022/01/13 00:00:00+00,Thu 13 Jan 2022,7319,767,0,3731871,3630543,239279,3971150,3869822,84.3327336895802,82.1808967558714,295
-7.6926,53.28823,2022/01/14 00:00:00+00,Fri 14 Jan 2022,10722,793,0,3742593,3631336,239279,3981872,3870615,84.5604298407252,82.197737181898,296
-7.6926,53.28823,2022/01/15 00:00:00+00,Sat 15 Jan 2022,8349,635,0,3750942,3631971,239279,3990221,3871250,84.7377321318939,82.2112222645298,297
-7.6926,53.28823,2022/01/16 00:00:00+00,Sun 16 Jan 2022,6966,1209,1,3757908,3633180,239280,3997188,3872460,84.8856857865318,82.2369182487571,298
-7.6926,53.28823,2022/01/17 00:00:00+00,Mon 17 Jan 2022,2558,539,0,3760466,3633719,239280,3999746,3872999,84.9400083713694,82.2483646417311,299
-7.6926,53.28823,2022/01/18 00:00:00+00,Tue 18 Jan 2022,4058,414,3,3764524,3634133,239283,4003807,3873416,85.0262491911605,82.2572201999318,300
-7.6926,53.28823,2022/01/19 00:00:00+00,Wed 19 Jan 2022,3479,595,0,3768003,3634728,239283,4007286,3874011,85.1001304549017,82.2698558285394,301
-7.6926,53.28823,2022/01/20 00:00:00+00,Thu 20 Jan 2022,3686,909,0,3771689,3635637,239283,4010972,3874920,85.1784076432174,82.2891596712358,302
-7.6926,53.28823,2022/01/21 00:00:00+00,Fri 21 Jan 2022,3246,951,0,3774935,3636588,239283,4014218,3875871,85.2473408372686,82.3093554406575,303
-7.6926,53.28823,2022/01/22 00:00:00+00,Sat 22 Jan 2022,4272,630,0,3779207,3637218,239283,4018490,3876501,85.3380625270365,82.3227343415361,304
-7.6926,53.28823,2022/01/23 00:00:00+00,Sun 23 Jan 2022,3092,676,0,3782299,3637894,239283,4021582,3877177,85.4037253230951,82.3370901145425,305
-7.6926,53.28823,2022/01/24 00:00:00+00,Mon 24 Jan 2022,643,454,0,3782942,3638348,239283,4022225,3877631,85.4173802965316,82.3467314177154,306
-7.6926,53.28823,2022/01/25 00:00:00+00,Tue 25 Jan 2022,696,1821,0,3783638,3640169,239283,4022921,3879452,85.43216079655,82.38540281216,307
-7.6926,53.28823,2022/01/26 00:00:00+00,Wed 26 Jan 2022,700,876,0,3784338,3641045,239283,4023621,3880328,85.4470262419708,82.4040058552866,308
-7.6926,53.28823,2022/01/27 00:00:00+00,Thu 27 Jan 2022,1273,1151,0,3785611,3642196,239283,4024894,3881479,85.474060116286,82.4284488948285,309
-7.6926,53.28823,2022/01/28 00:00:00+00,Fri 28 Jan 2022,1025,3076,0,3786636,3645272,239283,4025919,3884555,85.4958273756521,82.4937719092775,310
-7.6926,53.28823,2022/01/29 00:00:00+00,Sat 29 Jan 2022,2325,3440,0,3788961,3648712,239283,4028244,3887995,85.5452018907997,82.5668249553453,311
-7.6926,53.28823,2022/01/30 00:00:00+00,Sun 30 Jan 2022,1635,7533,0,3790596,3656245,239283,4029879,3895528,85.5799233240325,82.7267983844234,312
-7.6926,53.28823,2022/01/31 00:00:00+00,Mon 31 Jan 2022,478,1376,1,3791074,3657621,239284,4030358,3896905,85.5900955359704,82.7560408392011,313
-7.6926,53.28823,2022/02/01 00:00:00+00,Tue 01 Feb 2022,748,3402,1,3791822,3661023,239285,4031107,3900308,85.6060015625707,82.8283081402967,314
-7.6926,53.28823,2022/02/02 00:00:00+00,Wed 02 Feb 2022,642,2978,0,3792464,3664001,239285,4031749,3903286,85.6196352996566,82.8915499923868,315
-7.6926,53.28823,2022/02/03 00:00:00+00,Thu 03 Feb 2022,908,2416,1,3793372,3666417,239286,4032658,3905703,85.638939142353,82.9428782517896,316
-7.6926,53.28823,2022/02/04 00:00:00+00,Fri 04 Feb 2022,1167,6494,0,3794539,3672911,239286,4033825,3912197,85.6637219635045,83.0807871125932,317
-7.6926,53.28823,2022/02/05 00:00:00+00,Sat 05 Feb 2022,1777,5744,0,3796316,3678655,239286,4035602,3917941,85.7014589585227,83.202768710446,318
-7.6926,53.28823,2022/02/06 00:00:00+00,Sun 06 Feb 2022,1407,7555,0,3797723,3686210,239286,4037009,3925496,85.7313385038184,83.3632093392373,319
-7.6926,53.28823,2022/02/07 00:00:00+00,Mon 07 Feb 2022,432,1336,0,3798155,3687546,239286,4037441,3926832,85.7405126072781,83.3915811036404,320
-7.6926,53.28823,2022/02/08 00:00:00+00,Tue 08 Feb 2022,894,1215,0,3799049,3688761,239286,4038335,3928047,85.7594979047155,83.4173832696207,321
-7.6926,53.28823,2022/02/09 00:00:00+00,Wed 09 Feb 2022,1334,1745,0,3800383,3690506,239286,4039669,3929792,85.7878271964173,83.4544407014197,322
-7.6926,53.28823,2022/02/10 00:00:00+00,Thu 10 Feb 2022,688,2531,0,3801071,3693037,239286,4040357,3932323,85.8024378056309,83.5081899047911,323
-7.6926,53.28823,2022/02/11 00:00:00+00,Fri 11 Feb 2022,549,4895,0,3801620,3697932,239286,4040906,3937218,85.8140965621109,83.6121418409835,324
-7.6926,53.28823,2022/02/12 00:00:00+00,Sat 12 Feb 2022,1395,5455,0,3803015,3703387,239286,4042301,3942673,85.8437212711995,83.7279861335125,325
-7.6926,53.28823,2022/02/13 00:00:00+00,Sun 13 Feb 2022,1567,4705,0,3804582,3708092,239286,4043868,3947378,85.8769986325914,83.8279031630907,326
-7.6926,53.28823,2022/02/14 00:00:00+00,Mon 14 Feb 2022,169,937,1,3804751,3709029,239287,4044038,3948316,85.8806088121936,83.8478228599545,327
-7.6926,53.28823,2022/02/15 00:00:00+00,Tue 15 Feb 2022,645,793,1,3805396,3709822,239288,4044684,3949110,85.8943274946819,83.8646845223318,328
-7.6926,53.28823,2022/02/16 00:00:00+00,Wed 16 Feb 2022,788,1767,0,3806184,3711589,239288,4045472,3950877,85.9110617389556,83.902209153844,329
-7.6926,53.28823,2022/02/17 00:00:00+00,Thu 17 Feb 2022,780,1151,2,3806964,3712740,239290,4046254,3952030,85.9276685651256,83.9266946660871,330
-7.6926,53.28823,2022/02/18 00:00:00+00,Fri 18 Feb 2022,790,3246,0,3807754,3715986,239290,4047044,3955276,85.9444452821005,83.9956278601382,331
-7.6926,53.28823,2022/02/19 00:00:00+00,Sat 19 Feb 2022,975,3528,0,3808729,3719514,239290,4048019,3958804,85.9651507239366,84.070549705059,332
-7.6926,53.28823,2022/02/20 00:00:00+00,Sun 20 Feb 2022,1362,3586,0,3810091,3723100,239290,4049381,3962390,85.9940746334553,84.1467032583145,333
-7.6926,53.28823,2022/02/21 00:00:00+00,Mon 21 Feb 2022,250,982,1,3810341,3724082,239291,4049632,3963373,85.9994049574562,84.1675785909554,334
-7.6926,53.28823,2022/02/22 00:00:00+00,Tue 22 Feb 2022,472,947,1,3810813,3725029,239292,4050105,3964321,86.0094497512905,84.1877106513252,335
-7.6926,53.28823,2022/02/23 00:00:00+00,Wed 23 Feb 2022,821,1233,1,3811634,3726262,239293,4050927,3965555,86.0269060314846,84.213916307967,336
-7.6926,53.28823,2022/02/24 00:00:00+00,Thu 24 Feb 2022,657,1189,0,3812291,3727451,239293,4051584,3966744,86.0408583138295,84.2391663288317,337
-7.6926,53.28823,2022/02/25 00:00:00+00,Fri 25 Feb 2022,683,1179,0,3812974,3728630,239293,4052267,3967923,86.0553627412901,84.2642039861904,338
-7.6926,53.28823,2022/02/26 00:00:00+00,Sat 26 Feb 2022,956,2067,0,3813930,3730697,239293,4053223,3969990,86.0756646924647,84.3080995228829,339
-7.6926,53.28823,2022/02/27 00:00:00+00,Sun 27 Feb 2022,668,1781,0,3814598,3732478,239293,4053891,3971771,86.0898505746663,84.3459214633035,340
-7.6926,53.28823,2022/02/28 00:00:00+00,Mon 28 Feb 2022,85,400,0,3814683,3732878,239293,4053976,3972171,86.0916556644674,84.3544160035439,341
-7.6926,53.28823,2022/03/01 00:00:00+00,Tue 01 Mar 2022,122,906,0,3814805,3733784,239293,4054098,3973077,86.0942464992407,84.3736561371885,342
-7.6926,53.28823,2022/03/02 00:00:00+00,Wed 02 Mar 2022,191,950,2,3814996,3734734,239295,4054291,3974029,86.0983451149067,84.3938731429608,343
-7.6926,53.28823,2021/05/05 23:00:00+00,Thu 06 May 2021,37217,14357,130,1319040,517275,461,1319501,517736,28.0213858545093,10.994823214814,344
-7.6926,53.28823,2021/05/06 23:00:00+00,Fri 07 May 2021,40539,15044,93,1359579,532319,554,1360133,532873,28.8842612521335,11.3162778538629,345
-7.6926,53.28823,2021/05/07 23:00:00+00,Sat 08 May 2021,25551,7014,9,1385130,539333,563,1385693,539896,29.4270623734977,11.4654207441345,346
-7.6926,53.28823,2021/05/08 23:00:00+00,Sun 09 May 2021,19625,902,1,1404755,540235,564,1405319,540799,29.843846990395,11.4845971687273,347
-7.6926,53.28823,2021/05/09 23:00:00+00,Mon 10 May 2021,28764,4606,167,1433519,544841,731,1434250,545572,30.4582358496356,11.5859582701463,348
-7.6926,53.28823,2021/05/10 23:00:00+00,Tue 11 May 2021,33863,14787,149,1467382,559628,880,1468262,560508,31.1805266062804,11.9031444027245,349
-7.6926,53.28823,2021/05/11 23:00:00+00,Wed 12 May 2021,31225,20910,164,1498607,580538,1044,1499651,581582,31.8471144152985,12.3506792552922,350
-7.6926,53.28823,2021/05/12 23:00:00+00,Thu 13 May 2021,35926,25458,146,1534533,605996,1190,1535723,607186,32.6131520541816,12.8944147760829,351
-7.6926,53.28823,2021/05/13 23:00:00+00,Fri 14 May 2021,38137,27945,231,1572670,633941,1421,1574091,635362,33.4279483540448,13.4927701906196,352
-7.6926,53.28823,2021/05/14 23:00:00+00,Sat 15 May 2021,28795,12418,14,1601465,646359,1435,1602900,647794,34.039746378512,13.7567805012926,353
-7.6926,53.28823,2021/05/15 23:00:00+00,Sun 16 May 2021,23115,1150,8,1624580,647509,1443,1626023,648952,34.5307945134614,13.7813721952886,354
-7.6926,53.28823,2021/05/16 23:00:00+00,Mon 17 May 2021,35328,3920,110,1659908,651429,1553,1661461,652982,35.2833683060634,13.8669546882111,355
-7.6926,53.28823,2021/05/17 23:00:00+00,Tue 18 May 2021,38979,12466,120,1698887,663895,1673,1700560,665568,36.113688378216,14.1342353968766,356
-7.6926,53.28823,2021/05/18 23:00:00+00,Wed 19 May 2021,36946,17570,202,1735833,681465,1875,1737708,683340,36.9025763303459,14.5116478197594,357
-7.6926,53.28823,2021/05/19 23:00:00+00,Thu 20 May 2021,39008,19639,128,1774841,701104,2003,1776844,703107,37.7336821474707,14.9314267620915,358
-7.6926,53.28823,2021/05/20 23:00:00+00,Fri 21 May 2021,25756,23219,14929,1800597,724323,16932,1817529,741255,38.5976830716767,15.7415510648225,359
-7.6926,53.28823,2021/05/21 23:00:00+00,Sat 22 May 2021,16521,10231,13514,1817118,734554,30446,1847564,765000,39.2355168619809,16.2458082098457,360
-7.6926,53.28823,2021/05/22 23:00:00+00,Sun 23 May 2021,8170,5513,10200,1825288,740067,40646,1865934,780713,39.6256286225232,16.5794949868409,361
-7.6926,53.28823,2021/05/23 23:00:00+00,Mon 24 May 2021,22470,8177,8443,1847758,748244,49089,1896847,797333,40.2821079286552,16.9324431338313,362
-7.6926,53.28823,2021/05/24 23:00:00+00,Tue 25 May 2021,30226,16480,3216,1877984,764724,52305,1930289,817029,40.9922939654574,17.3507142952706,363
-7.6926,53.28823,2021/05/25 23:00:00+00,Wed 26 May 2021,19868,25398,3043,1897852,790122,55348,1953200,845470,41.4788399940793,17.9546973427167,364
-7.6926,53.28823,2021/05/26 23:00:00+00,Thu 27 May 2021,16931,35966,546,1914783,826088,55894,1970677,881982,41.8499876935348,18.7300789758643,365
-7.6926,53.28823,2021/05/27 23:00:00+00,Fri 28 May 2021,26916,31783,1549,1941699,857871,57443,1999142,915314,42.4544804133953,19.4379290141003,366
-7.6926,53.28823,2021/05/28 23:00:00+00,Sat 29 May 2021,24392,7363,524,1966091,865234,57967,2024058,923201,42.9836053249724,19.6054201112912,367
-7.6926,53.28823,2021/05/29 23:00:00+00,Sun 30 May 2021,24178,1656,204,1990269,866890,58171,2048440,925061,43.5013900253286,19.6449197234093,368
-7.6926,53.28823,2021/05/30 23:00:00+00,Mon 31 May 2021,22469,7298,3434,2012738,874188,61605,2074343,935793,44.051475214949,19.8728282380603,369
-7.6926,53.28823,2021/05/31 23:00:00+00,Tue 01 Jun 2021,27411,11467,3637,2040149,885655,65242,2105391,950897,44.7108214284122,20.1935820775394,370
-7.6926,53.28823,2021/06/01 23:00:00+00,Wed 02 Jun 2021,18584,20848,3992,2058733,906503,69234,2127967,975737,45.1902532795827,20.7210930264709,371
-7.6926,53.28823,2021/06/02 23:00:00+00,Thu 03 Jun 2021,16583,30657,1968,2075316,937160,71202,2146518,1008362,45.5842088195838,21.413928964832,372
-7.6926,53.28823,2021/06/03 23:00:00+00,Fri 04 Jun 2021,28926,23313,144,2104242,960473,71346,2175588,1031819,46.201549531558,21.9120700408821,373
-7.6926,53.28823,2021/06/04 23:00:00+00,Sat 05 Jun 2021,20864,11448,26,2125106,971921,71372,2196478,1043293,46.6451768956151,22.1557359276792,374
-7.6926,53.28823,2021/06/05 23:00:00+00,Sun 06 Jun 2021,19862,3869,33,2144968,975790,71405,2216373,1047195,47.067674090824,22.2386001677247,375
-7.6926,53.28823,2021/06/06 23:00:00+00,Mon 07 Jun 2021,19710,4528,36,2164678,980318,71441,2236119,1051759,47.4870070697935,22.3355228718681,376
-7.6926,53.28823,2021/06/07 23:00:00+00,Tue 08 Jun 2021,26327,18282,35,2191005,998600,71476,2262481,1070076,48.0468397443398,22.7245091058286,377
-7.6926,53.28823,2021/06/08 23:00:00+00,Wed 09 Jun 2021,32687,20055,163,2223692,1018655,71639,2295331,1090294,48.7444538615861,23.1538656422817,378
-7.6926,53.28823,2021/06/09 23:00:00+00,Thu 10 Jun 2021,27585,27422,257,2251277,1046077,71896,2323173,1117973,49.3357163350221,23.7416665905697,379
-7.6926,53.28823,2021/06/10 23:00:00+00,Fri 11 Jun 2021,26342,32838,25,2277619,1078915,71921,2349540,1150836,49.8956551913215,24.4395567803739,380
-7.6926,53.28823,2021/06/11 23:00:00+00,Sat 12 Jun 2021,12115,19673,97,2289734,1098588,72018,2361752,1170606,50.1549935048622,24.8593994317577,381
-7.6926,53.28823,2021/06/12 23:00:00+00,Sun 13 Jun 2021,8498,18139,826,2298232,1116727,72844,2371076,1189571,50.3530012378669,25.2621468209077,382
-7.6926,53.28823,2021/06/13 23:00:00+00,Mon 14 Jun 2021,15943,31250,34,2314175,1147977,72878,2387053,1220855,50.6922944114207,25.9265048131127,383
-7.6926,53.28823,2021/06/14 23:00:00+00,Tue 15 Jun 2021,14606,41475,194,2328781,1189452,73072,2401853,1262524,51.0065924003171,26.8114023063101,384
-7.6926,53.28823,2021/06/15 23:00:00+00,Wed 16 Jun 2021,13335,48319,207,2342116,1237771,73279,2415395,1311050,51.2941750601573,27.8419174555794,385
-7.6926,53.28823,2021/06/16 23:00:00+00,Thu 17 Jun 2021,21489,42594,522,2363605,1280365,73801,2437406,1354166,51.7616083732382,28.7575439480967,386
-7.6926,53.28823,2021/06/17 23:00:00+00,Fri 18 Jun 2021,11943,49987,542,2375548,1330352,74343,2449891,1404695,52.026744210493,29.8305955076199,387
-7.6926,53.28823,2021/06/18 23:00:00+00,Sat 19 Jun 2021,6238,32733,423,2381786,1363085,74766,2456552,1437851,52.168199541847,30.5347079481502,388
-7.6926,53.28823,2021/06/19 23:00:00+00,Sun 20 Jun 2021,8454,26097,172,2390240,1389182,74938,2465178,1464120,52.3513843021321,31.0925656420906,389
-7.6926,53.28823,2021/06/20 23:00:00+00,Mon 21 Jun 2021,15395,32253,558,2405635,1421435,75496,2481131,1496931,52.6901678032715,31.7893515416635,390
-7.6926,53.28823,2021/06/21 23:00:00+00,Tue 22 Jun 2021,15060,43464,710,2420695,1464899,76206,2496901,1541105,53.025065052251,32.7274460931167,391
-7.6926,53.28823,2021/06/22 23:00:00+00,Wed 23 Jun 2021,19991,39313,869,2440686,1504212,77075,2517761,1581287,53.46805532579,33.5807651329703,392
-7.6926,53.28823,2021/06/23 23:00:00+00,Thu 24 Jun 2021,18931,44177,1025,2459617,1548389,78100,2537717,1626489,53.8918479383857,34.5406906528415,393
-7.6926,53.28823,2021/06/24 23:00:00+00,Fri 25 Jun 2021,15117,50063,814,2474734,1598452,78914,2553648,1677366,54.2301642398119,35.621132462374,394
-7.6926,53.28823,2021/06/25 23:00:00+00,Sat 26 Jun 2021,8976,30474,486,2483710,1628926,79400,2563110,1708326,54.4311025891996,36.2786098769842,395
-7.6926,53.28823,2021/06/26 23:00:00+00,Sun 27 Jun 2021,8670,30419,49,2492380,1659345,79449,2571829,1738794,54.6162623300906,36.9256390070987,396
-7.6926,53.28823,2021/06/27 23:00:00+00,Mon 28 Jun 2021,24141,24558,502,2516521,1683903,79951,2596472,1763854,55.1395897179537,37.4578219531624,397
-7.6926,53.28823,2021/06/28 23:00:00+00,Tue 29 Jun 2021,28066,30911,792,2544587,1714814,80743,2625330,1795557,55.7524283236004,38.1310779762692,398
-7.6926,53.28823,2021/06/29 23:00:00+00,Wed 30 Jun 2021,22460,36753,564,2567047,1751567,81307,2648354,1832874,56.2413740598402,38.9235548716507,399
-7.6926,53.28823,2021/06/30 23:00:00+00,Thu 01 Jul 2021,14847,48223,621,2581894,1799790,81928,2663822,1881718,56.5698579309381,39.9608231804111,400
-7.6926,53.28823,2021/07/01 23:00:00+00,Fri 02 Jul 2021,13551,47164,802,2595445,1846954,82730,2678175,1929684,56.8746632711158,40.9794459733437,401
-7.6926,53.28823,2021/07/02 23:00:00+00,Sat 03 Jul 2021,9236,30391,491,2604681,1877345,83221,2687902,1960566,57.0812292534127,41.635266952607,402
-7.6926,53.28823,2021/07/03 23:00:00+00,Sun 04 Jul 2021,6383,27728,222,2611064,1905073,83443,2694507,1988516,57.221495349133,42.2288229519079,403
-7.6926,53.28823,2021/07/04 23:00:00+00,Mon 05 Jul 2021,15469,33330,5322,2626533,1938403,88765,2715298,2027168,57.6630203144806,43.0496503753419,404
-7.6926,53.28823,2021/07/05 23:00:00+00,Tue 06 Jul 2021,12291,48250,5469,2638824,1986653,94234,2733058,2080887,58.0401779011563,44.1904458932827,405
-7.6926,53.28823,2021/07/06 23:00:00+00,Wed 07 Jul 2021,19596,43648,5040,2658420,2030301,99274,2757694,2129575,58.5633566345651,45.2244013313493,406
-7.6926,53.28823,2021/07/07 23:00:00+00,Thu 08 Jul 2021,17667,45489,5977,2676087,2075790,105251,2781338,2181041,59.0654689081776,46.3173513513858,407
-7.6926,53.28823,2021/07/08 23:00:00+00,Fri 09 Jul 2021,13434,45008,6515,2689521,2120798,111766,2801287,2232564,59.4891128663191,47.4115118434066,408
-7.6926,53.28823,2021/07/09 23:00:00+00,Sat 10 Jul 2021,8549,23757,4352,2698070,2144555,116118,2814188,2260673,59.7630830254239,48.008444422453,409
-7.6926,53.28823,2021/07/10 23:00:00+00,Sun 11 Jul 2021,15173,16051,2146,2713243,2160606,118264,2831507,2278870,60.1308753814845,48.3948822943413,410
-7.6926,53.28823,2021/07/11 23:00:00+00,Mon 12 Jul 2021,17027,31632,6071,2730270,2192238,124335,2854605,2316573,60.6213926076688,49.1955564210548,411
-7.6926,53.28823,2021/07/12 23:00:00+00,Tue 13 Jul 2021,20014,36434,8472,2750284,2228672,132807,2883091,2361479,61.2263312908919,50.1491959811481,412
-7.6926,53.28823,2021/07/13 23:00:00+00,Wed 14 Jul 2021,20704,35573,9316,2770988,2264245,142123,2913111,2406368,61.8638465359371,51.1024745232811,413
-7.6926,53.28823,2021/07/14 23:00:00+00,Thu 15 Jul 2021,23533,28714,9555,2794521,2292959,151678,2946199,2444637,62.5665149046265,51.9151684244348,414
-7.6926,53.28823,2021/07/15 23:00:00+00,Fri 16 Jul 2021,23466,27291,9152,2817987,2320250,160830,2978817,2481080,63.2592021885334,52.6890847493909,415
-7.6926,53.28823,2021/07/16 23:00:00+00,Sat 17 Jul 2021,11430,19336,4665,2829417,2339586,165495,2994912,2505081,63.6010012514581,53.198778400168,416
-7.6926,53.28823,2021/07/17 23:00:00+00,Sun 18 Jul 2021,16809,15735,1921,2846226,2355321,167416,3013642,2522737,63.9987580982168,53.5737274063811,417
-7.6926,53.28823,2021/07/18 23:00:00+00,Mon 19 Jul 2021,24795,18293,6224,2871021,2373614,173640,3044661,2547254,64.6574884575125,54.0943790140685,418
-7.6926,53.28823,2021/07/19 23:00:00+00,Tue 20 Jul 2021,30491,18051,7684,2901512,2391665,181324,3082836,2572989,65.4681861417097,54.6408964967879,419
-7.6926,53.28823,2021/07/20 23:00:00+00,Wed 21 Jul 2021,30249,19710,6868,2931761,2411375,188192,3119953,2599567,66.256415766971,55.2053162230641,420
-7.6926,53.28823,2021/07/21 23:00:00+00,Thu 22 Jul 2021,33446,15806,6915,2965207,2427181,195107,3160314,2622288,67.1135361135822,55.6878273450718,421
-7.6926,53.28823,2021/07/22 23:00:00+00,Fri 23 Jul 2021,27007,20691,5592,2992214,2447872,200699,3192913,2648571,67.8058199068276,56.2459823479207,422
-7.6926,53.28823,2021/07/23 23:00:00+00,Sat 24 Jul 2021,15376,14709,2256,3007590,2462581,202955,3210545,2665536,68.1802592406263,56.6062570358684,423
-7.6926,53.28823,2021/07/24 23:00:00+00,Sun 25 Jul 2021,14672,13575,1029,3022262,2476156,203984,3226246,2680140,68.5136911814143,56.916392700047,424
-7.6926,53.28823,2021/07/25 23:00:00+00,Mon 26 Jul 2021,23757,18126,3399,3046019,2494282,207383,3253402,2701665,69.0903855183379,57.3735051467357,425
-7.6926,53.28823,2021/07/26 23:00:00+00,Tue 27 Jul 2021,25397,23740,3652,3071416,2518022,211035,3282451,2729057,69.7072802669494,57.9552112624012,426
-7.6926,53.28823,2021/07/27 23:00:00+00,Wed 28 Jul 2021,23369,25133,3245,3094785,2543155,214280,3309065,2757435,70.2724645018472,58.5578564197594,427
-7.6926,53.28823,2021/07/28 23:00:00+00,Thu 29 Jul 2021,19189,27739,2944,3113974,2570894,217224,3331198,2788118,70.7424886497015,59.2094513652531,428
-7.6926,53.28823,2021/07/29 23:00:00+00,Fri 30 Jul 2021,21864,22793,2107,3135838,2593687,219331,3355169,2813018,71.2515452099606,59.7382364952207,429
-7.6926,53.28823,2021/07/30 23:00:00+00,Sat 31 Jul 2021,13684,12366,899,3149522,2606053,220230,3369752,2826283,71.5612349107765,60.0199366859443,430
