X,Y,VaccinationDate,VaccineText,Dose1,Dose2,SingleDose,Dose1Cum,Dose2Cum,SingleDoseCum,PartiallyVacc,FullyVacc,PartialPercent,FullyPercent,ObjectId
-7.6926,53.28823,2020/12/28 00:00:00+00,Mon 28 Dec 2020,202,17,0,202,17,0,202,17,0.00428974282142332,0.000361017960218794,1
-7.6926,53.28823,2020/12/29 00:00:00+00,Tue 29 Dec 2020,74,2,0,276,19,0,276,19,0.00586123276590512,0.000403490661421005,2
-7.6926,53.28823,2020/12/30 00:00:00+00,Wed 30 Dec 2020,1057,1,0,1333,20,0,1333,20,0.0283080553512737,0.00042472701202211,3
-7.6926,53.28823,2020/12/31 00:00:00+00,Thu 31 Dec 2020,1031,1,0,2364,21,0,2364,21,0.0502027328210135,0.000445963362623216,4
-7.6926,53.28823,2021/01/01 00:00:00+00,Fri 01 Jan 2021,808,0,0,3172,21,0,3172,21,0.0673617041067067,0.000445963362623216,5
-7.6926,53.28823,2021/01/02 00:00:00+00,Sat 02 Jan 2021,1015,0,0,4187,21,0,4187,21,0.0889165999668288,0.000445963362623216,6
-7.6926,53.28823,2021/01/03 00:00:00+00,Sun 03 Jan 2021,20,2,1,4207,23,1,4208,24,0.089362563329452,0.000509672414426533,7
-7.6926,53.28823,2021/01/04 00:00:00+00,Mon 04 Jan 2021,1186,3,0,5393,26,1,5394,27,0.114548875142363,0.000573381466229849,8
-7.6926,53.28823,2021/01/05 00:00:00+00,Tue 05 Jan 2021,3524,10,0,8917,36,1,8918,37,0.189385774660659,0.000785744972240904,9
-7.6926,53.28823,2021/01/06 00:00:00+00,Wed 06 Jan 2021,6772,8,0,15689,44,1,15690,45,0.333198340931346,0.000955635777049748,10
-7.6926,53.28823,2021/01/07 00:00:00+00,Thu 07 Jan 2021,11719,8,0,27408,52,1,27409,53,0.582067133625701,0.00112552658185859,11
-7.6926,53.28823,2021/01/08 00:00:00+00,Fri 08 Jan 2021,12675,5,0,40083,57,1,40084,58,0.851237877494714,0.00123170833486412,12
-7.6926,53.28823,2021/01/09 00:00:00+00,Sat 09 Jan 2021,8072,6,0,48155,63,1,48156,64,1.02265769954684,0.00135912643847075,13
-7.6926,53.28823,2021/01/10 00:00:00+00,Sun 10 Jan 2021,4777,4,1,52932,67,2,52934,69,1.12412498271892,0.00146530819147628,14
-7.6926,53.28823,2021/12/20 00:00:00+00,Mon 20 Dec 2021,541,593,0,3674139,3618192,240197,3914336,3858389,83.126211666529,81.9381015594489,15
-7.6926,53.28823,2021/01/11 00:00:00+00,Mon 11 Jan 2021,8336,7,0,61268,74,2,61270,76,1.30115120132974,0.00161396264568402,16
-7.6926,53.28823,2021/01/12 00:00:00+00,Tue 12 Jan 2021,8877,9,0,70145,83,2,70147,85,1.48966628561575,0.00180508980109397,17
-7.6926,53.28823,2021/01/13 00:00:00+00,Wed 13 Jan 2021,9876,6,0,80021,89,2,80023,91,1.69939648415227,0.0019325079047006,18
-7.6926,53.28823,2021/01/14 00:00:00+00,Thu 14 Jan 2021,8076,4,0,88097,93,2,88099,95,1.8709012516068,0.00201745330710502,19
-7.6926,53.28823,2021/12/21 00:00:00+00,Tue 21 Dec 2021,1459,1784,3,3675598,3619976,240200,3915798,3860176,83.1572592111078,81.9760509179731,20
-7.6926,53.28823,2021/01/15 00:00:00+00,Fri 15 Jan 2021,7685,2,0,95782,95,2,95784,97,2.03410260597629,0.00205992600830724,21
-7.6926,53.28823,2021/12/22 00:00:00+00,Wed 22 Dec 2021,1227,1557,2,3676825,3621533,240202,3917027,3861735,83.1833586859966,82.0091583885602,22
-7.6926,53.28823,2021/01/16 00:00:00+00,Sat 16 Jan 2021,5226,3,0,101008,98,2,101010,100,2.14508377421767,0.00212363506011055,23
-7.6926,53.28823,2021/12/23 00:00:00+00,Thu 23 Dec 2021,959,1341,0,3677784,3622874,240202,3917986,3863076,83.203724346223,82.0376363347163,24
-7.6926,53.28823,2021/01/17 00:00:00+00,Sun 17 Jan 2021,1109,5,0,102117,103,2,102119,105,2.16863488703429,0.00222981681311608,25
-7.6926,53.28823,2021/12/24 00:00:00+00,Fri 24 Dec 2021,105,140,0,3677889,3623014,240202,3918091,3863216,83.2059541630361,82.0406094238005,26
-7.6926,53.28823,2021/01/18 00:00:00+00,Mon 18 Jan 2021,8704,7,1,110821,110,3,110824,113,2.35349731901692,0.00239970761792492,27
-7.6926,53.28823,2021/01/19 00:00:00+00,Tue 19 Jan 2021,8371,18,0,119192,128,3,119195,131,2.53126680989877,0.00278196192874482,28
-7.6926,53.28823,2021/12/25 00:00:00+00,Sat 25 Dec 2021,2,0,0,3677891,3623014,240202,3918093,3863216,83.2059966357373,82.0406094238005,29
-7.6926,53.28823,2021/01/20 00:00:00+00,Wed 20 Jan 2021,8439,961,0,127631,1089,3,127634,1092,2.7104803726215,0.0231900948564072,30
-7.6926,53.28823,2021/12/26 00:00:00+00,Sun 26 Dec 2021,10,7,0,3677901,3623021,240202,3918103,3863223,83.2062089992433,82.0407580782547,31
-7.6926,53.28823,2021/01/21 00:00:00+00,Thu 21 Jan 2021,8994,962,0,136625,2051,3,136628,2054,2.90148010992785,0.0436194641346707,32
-7.6926,53.28823,2021/12/27 00:00:00+00,Mon 27 Dec 2021,388,582,0,3678289,3623603,240202,3918491,3863805,83.2144487032766,82.0531176343045,33
-7.6926,53.28823,2021/01/22 00:00:00+00,Fri 22 Jan 2021,6768,967,0,143393,3018,3,143396,3021,3.04520773079613,0.0641550151659398,34
-7.6926,53.28823,2021/01/23 00:00:00+00,Sat 23 Jan 2021,4179,460,0,147572,3478,3,147575,3481,3.13395443995815,0.0739237364424483,35
-7.6926,53.28823,2021/12/28 00:00:00+00,Tue 28 Dec 2021,465,738,0,3678754,3624341,240202,3918956,3864543,83.2243236063061,82.0687900610481,36
-7.6926,53.28823,2021/01/24 00:00:00+00,Sun 24 Jan 2021,1180,397,0,148752,3875,3,148755,3878,3.15901333366745,0.0823545676310872,37
-7.6926,53.28823,2021/12/29 00:00:00+00,Wed 29 Dec 2021,1080,1284,0,3679834,3625625,240202,3920036,3865827,83.2472588649553,82.09605753522,38
-7.6926,53.28823,2021/01/25 00:00:00+00,Mon 25 Jan 2021,1350,1285,0,150102,5160,3,150105,5163,3.18768240697894,0.109643278153508,39
-7.6926,53.28823,2021/12/30 00:00:00+00,Thu 30 Dec 2021,1072,1176,1,3680906,3626801,240203,3921109,3867004,83.2700454691503,82.1210527198775,40
-7.6926,53.28823,2021/01/26 00:00:00+00,Tue 26 Jan 2021,1000,3498,0,151102,8658,3,151105,8661,3.20891875758005,0.183928032556175,41
-7.6926,53.28823,2021/12/31 00:00:00+00,Fri 31 Dec 2021,721,1668,0,3681627,3628469,240203,3921830,3868672,83.2853568779337,82.1564749526801,42
-7.6926,53.28823,2021/01/27 00:00:00+00,Wed 27 Jan 2021,2161,6699,0,153263,15357,3,153266,15360,3.25481051122904,0.326190345232981,43
-7.6926,53.28823,2022/01/01 00:00:00+00,Sat 01 Jan 2022,69,95,0,3681696,3628564,240203,3921899,3868767,83.2868221861251,82.1584924059872,44
-7.6926,53.28823,2022/01/02 00:00:00+00,Sun 02 Jan 2022,270,623,0,3681966,3629187,240203,3922169,3869390,83.2925560007874,82.1717226524117,45
-7.6926,53.28823,2021/01/28 00:00:00+00,Thu 28 Jan 2021,994,11538,0,154257,26895,3,154260,26898,3.27591944372654,0.571215358468536,46
-7.6926,53.28823,2022/01/03 00:00:00+00,Mon 03 Jan 2022,3630,717,1,3685596,3629904,240204,3925800,3870108,83.3696651898201,82.1869703521433,47
-7.6926,53.28823,2021/01/29 00:00:00+00,Fri 29 Jan 2021,1566,11526,0,155823,38421,3,155826,38424,3.30917556876787,0.815985535496879,48
-7.6926,53.28823,2022/01/04 00:00:00+00,Tue 04 Jan 2022,1192,763,0,3686788,3630667,240204,3926992,3870871,83.3949789197366,82.2031736876519,49
-7.6926,53.28823,2021/04/25 23:00:00+00,Mon 26 Apr 2021,15564,3042,3,1062409,433741,239,1062648,433980,22.5667654935636,9.21615143386777,50
-7.6926,53.28823,2021/01/30 00:00:00+00,Sat 30 Jan 2021,625,7792,0,156448,46213,3,156451,46216,3.32244828789356,0.981459179380693,51
-7.6926,53.28823,2021/01/31 00:00:00+00,Sun 31 Jan 2021,218,4086,0,156666,50299,3,156669,50302,3.3270778123246,1.06823090793681,52
-7.6926,53.28823,2021/02/01 00:00:00+00,Mon 01 Feb 2021,1013,8334,0,157679,58633,3,157682,58636,3.34859023548352,1.24521465384642,53
-7.6926,53.28823,2021/02/02 00:00:00+00,Tue 02 Feb 2021,823,5106,0,158502,63739,3,158505,63742,3.36606775202823,1.35364746001567,54
-7.6926,53.28823,2021/02/03 00:00:00+00,Wed 03 Feb 2021,1391,6862,0,159893,70601,3,159896,70604,3.39560751571437,1.49937129784045,55
-7.6926,53.28823,2021/02/04 00:00:00+00,Thu 04 Feb 2021,1418,10541,1,161311,81142,4,161315,81146,3.42574189721734,1.72324490587731,56
-7.6926,53.28823,2021/02/05 00:00:00+00,Fri 05 Feb 2021,3380,8612,0,164691,89754,4,164695,89758,3.49752076224907,1.90613235725403,57
-7.6926,53.28823,2021/02/06 00:00:00+00,Sat 06 Feb 2021,890,3866,0,165581,93620,4,165585,93624,3.51642111428406,1.9882320886779,58
-7.6926,53.28823,2021/02/07 00:00:00+00,Sun 07 Feb 2021,324,1299,2,165905,94919,6,165911,94925,3.52334416458002,2.01586058080994,59
-7.6926,53.28823,2021/02/08 00:00:00+00,Mon 08 Feb 2021,1161,878,0,167066,95797,6,167072,95803,3.5479995676279,2.03450609663771,60
-7.6926,53.28823,2021/02/09 00:00:00+00,Tue 09 Feb 2021,4248,536,2,171314,96333,8,171322,96341,3.6382540576826,2.04593125326111,61
-7.6926,53.28823,2021/02/10 00:00:00+00,Wed 10 Feb 2021,8817,580,0,180131,96913,8,180139,96921,3.82549496093255,2.05824833660975,62
-7.6926,53.28823,2021/02/11 00:00:00+00,Thu 11 Feb 2021,6178,444,0,186309,97357,8,186317,97365,3.95669313494618,2.06767727627664,63
-7.6926,53.28823,2021/02/12 00:00:00+00,Fri 12 Feb 2021,4388,522,0,190697,97879,8,190705,97887,4.04987824138383,2.07876265129042,64
-7.6926,53.28823,2021/02/13 00:00:00+00,Sat 13 Feb 2021,1204,1914,0,191901,99793,8,191909,99801,4.07544680750756,2.11940902634093,65
-7.6926,53.28823,2021/02/14 00:00:00+00,Sun 14 Feb 2021,2692,26,0,194593,99819,8,194601,99827,4.13261506332574,2.11996117145656,66
-7.6926,53.28823,2021/02/15 00:00:00+00,Mon 15 Feb 2021,1955,7885,0,196548,107704,8,196556,107712,4.1741321287509,2.28740979594628,67
-7.6926,53.28823,2021/02/16 00:00:00+00,Tue 16 Feb 2021,5643,8157,0,202191,115861,8,202199,115869,4.29396885519294,2.4606347077995,68
-7.6926,53.28823,2021/02/17 00:00:00+00,Wed 17 Feb 2021,9735,8462,0,211926,124323,8,211934,124331,4.5007047282947,2.64033670658605,69
-7.6926,53.28823,2021/02/18 00:00:00+00,Thu 18 Feb 2021,8453,8348,1,220379,132671,9,220388,132680,4.68023683627644,2.81763899775468,70
-7.6926,53.28823,2021/02/19 00:00:00+00,Fri 19 Feb 2021,9385,6581,0,229764,139252,9,229773,139261,4.87953998666782,2.95739542106056,71
-7.6926,53.28823,2021/02/20 00:00:00+00,Sat 20 Feb 2021,5884,3567,2,235648,142819,11,235659,142830,5.00453714630593,3.0331879563559,72
-7.6926,53.28823,2021/02/21 00:00:00+00,Sun 21 Feb 2021,1107,1021,5,236755,143840,16,236771,143856,5.02815196817436,3.05497645207264,73
-7.6926,53.28823,2021/02/22 00:00:00+00,Mon 22 Feb 2021,3938,1120,1,240693,144960,17,240710,144977,5.11180195319211,3.07878240109648,74
-7.6926,53.28823,2021/02/23 00:00:00+00,Tue 23 Feb 2021,13353,1062,0,254046,146022,17,254063,146039,5.39537094276867,3.10133540543485,75
-7.6926,53.28823,2021/02/24 00:00:00+00,Wed 24 Feb 2021,16936,2101,3,270982,148123,20,271002,148143,5.7550934856008,3.14601668709958,76
-7.6926,53.28823,2021/02/25 00:00:00+00,Thu 25 Feb 2021,18080,1753,2,289062,149876,22,289084,149898,6.13908917716999,3.18328648240452,77
-7.6926,53.28823,2021/02/26 00:00:00+00,Fri 26 Feb 2021,16076,2766,0,305138,152642,22,305160,152664,6.48048474943336,3.24202622816717,78
-7.6926,53.28823,2021/02/27 00:00:00+00,Sat 27 Feb 2021,8986,703,1,314124,153345,23,314147,153368,6.6713358322855,3.25697661899035,79
-7.6926,53.28823,2021/02/28 00:00:00+00,Sun 28 Feb 2021,2440,54,2,316564,153399,25,316589,153424,6.7231950004534,3.25816585462401,80
-7.6926,53.28823,2021/03/01 00:00:00+00,Mon 01 Mar 2021,5585,787,0,322149,154186,25,322174,154211,6.84180001856057,3.27487886254708,81
-7.6926,53.28823,2021/03/02 00:00:00+00,Tue 02 Mar 2021,12172,1605,0,334321,155791,25,334346,155816,7.10028887807723,3.30896320526186,82
-7.6926,53.28823,2021/03/03 00:00:00+00,Wed 03 Mar 2021,12885,1502,1,347206,157293,26,347232,157319,7.37394049192307,3.34088144021532,83
-7.6926,53.28823,2021/03/04 00:00:00+00,Thu 04 Mar 2021,18733,1685,3,365939,158978,29,365968,159007,7.77182475678539,3.37672840002999,84
-7.6926,53.28823,2021/03/05 00:00:00+00,Fri 05 Mar 2021,18435,2392,6,384374,161370,35,384409,161405,8.16344429822037,3.42765316877144,85
-7.6926,53.28823,2021/03/06 00:00:00+00,Sat 06 Mar 2021,10392,137,4,394766,161507,39,394805,161546,8.38421739906947,3.43064749420619,86
-7.6926,53.28823,2021/03/07 00:00:00+00,Sun 07 Mar 2021,1518,10,3,396284,161517,42,396326,161559,8.41651788833375,3.43092356676401,87
-7.6926,53.28823,2021/03/08 00:00:00+00,Mon 08 Mar 2021,6661,1493,5,402945,163010,47,402992,163057,8.55807940144072,3.46273561996446,88
-7.6926,53.28823,2021/03/09 00:00:00+00,Tue 09 Mar 2021,13810,3100,5,416755,166110,52,416807,166162,8.85145958499499,3.5286744885809,89
-7.6926,53.28823,2021/03/10 00:00:00+00,Wed 10 Mar 2021,13724,3982,3,430479,170092,55,430534,170147,9.14297096969637,3.6133013457263,90
-7.6926,53.28823,2021/03/11 00:00:00+00,Thu 11 Mar 2021,18465,2094,3,448944,172186,58,449002,172244,9.53516389259758,3.65783397293682,91
-7.6926,53.28823,2021/03/12 00:00:00+00,Fri 12 Mar 2021,17322,1335,4,466266,173521,62,466328,173583,9.90310490311234,3.6862694463917,92
-7.6926,53.28823,2021/03/13 00:00:00+00,Sat 13 Mar 2021,8298,172,0,474564,173693,62,474626,173755,10.0793241404003,3.68992209869509,93
-7.6926,53.28823,2021/03/14 00:00:00+00,Sun 14 Mar 2021,379,18,2,474943,173711,64,475007,173775,10.0874151899793,3.69034682570711,94
-7.6926,53.28823,2021/03/15 00:00:00+00,Mon 15 Mar 2021,2649,989,0,477592,174700,64,477656,174764,10.1436702827217,3.7113495764516,95
-7.6926,53.28823,2021/03/16 00:00:00+00,Tue 16 Mar 2021,8932,3817,2,486524,178517,66,486590,178583,10.3333958389919,3.79245119939723,96
-7.6926,53.28823,2021/03/17 00:00:00+00,Wed 17 Mar 2021,4893,2417,6,491417,180934,72,491489,181006,10.4374327205868,3.84390687690371,97
-7.6926,53.28823,2021/03/18 00:00:00+00,Thu 18 Mar 2021,11719,4676,5,503136,185610,77,503213,185687,10.6864076950341,3.94331423406748,98
-7.6926,53.28823,2021/03/19 00:00:00+00,Fri 19 Mar 2021,10358,6123,2,513494,191733,79,513573,191812,10.9064162872616,4.07338688149925,99
-7.6926,53.28823,2021/03/20 00:00:00+00,Sat 20 Mar 2021,5236,3116,3,518730,194849,82,518812,194931,11.0176735280608,4.1396230590241,100
-7.6926,53.28823,2021/03/21 00:00:00+00,Sun 21 Mar 2021,3631,53,3,522361,194902,85,522446,194987,11.0948464261452,4.14081229465776,101
-7.6926,53.28823,2021/03/22 00:00:00+00,Mon 22 Mar 2021,7402,2398,1,529763,197300,86,529849,197386,11.2520591296452,4.19175829974981,102
-7.6926,53.28823,2021/03/23 00:00:00+00,Tue 23 Mar 2021,12558,7378,3,542321,204678,89,542410,204767,11.5188089295456,4.34850380353657,103
-7.6926,53.28823,2021/03/24 00:00:00+00,Wed 24 Mar 2021,13621,9781,2,555942,214459,91,556033,214550,11.8081117337845,4.55625902146719,104
-7.6926,53.28823,2021/03/25 00:00:00+00,Thu 25 Mar 2021,20856,10216,3,576798,224675,94,576892,224769,12.251080770973,4.77327328825989,105
-7.6926,53.28823,2021/03/26 00:00:00+00,Fri 26 Mar 2021,19692,9493,1,596490,234168,95,596585,234263,12.6692882233605,4.97489120086678,106
-7.6926,53.28823,2021/03/27 00:00:00+00,Sat 27 Mar 2021,11734,5341,3,608224,239509,98,608322,239607,12.9185392703657,5.08837825847909,107
-7.6926,53.28823,2021/03/28 00:00:00+00,Sun 28 Mar 2021,2487,482,0,610711,239991,98,610809,240089,12.9713540743107,5.09861417946882,108
-7.6926,53.28823,2021/03/28 23:00:00+00,Mon 29 Mar 2021,9253,3113,3,619964,243104,101,620065,243205,13.1679177354745,5.16478664794187,109
-7.6926,53.28823,2021/03/29 23:00:00+00,Tue 30 Mar 2021,13316,8662,4,633280,251766,105,633385,251871,13.4507859254812,5.34882086225105,110
-7.6926,53.28823,2021/03/30 23:00:00+00,Wed 31 Mar 2021,15824,10502,4,649104,262268,109,649213,262377,13.7869148827955,5.57192996166626,111
-7.6926,53.28823,2021/03/31 23:00:00+00,Thu 01 Apr 2021,19681,11578,8,668785,273846,117,668902,273963,14.2050373897807,5.81797431973067,112
-7.6926,53.28823,2021/04/01 23:00:00+00,Fri 02 Apr 2021,20125,13716,7,688910,287562,124,689034,287686,14.6325676000821,6.10940075902964,113
-7.6926,53.28823,2021/04/02 23:00:00+00,Sat 03 Apr 2021,7539,4639,5,696449,292201,129,696578,292330,14.7927746290169,6.20802237122118,114
-7.6926,53.28823,2021/04/03 23:00:00+00,Sun 04 Apr 2021,3023,168,3,699472,292369,132,699604,292501,14.8570358259358,6.21165378717397,115
-7.6926,53.28823,2021/04/04 23:00:00+00,Mon 05 Apr 2021,3422,607,4,702894,292976,136,703030,293112,14.9297915630952,6.22462919739124,116
-7.6926,53.28823,2021/04/05 23:00:00+00,Tue 06 Apr 2021,11979,8158,11,714873,301134,147,715020,301281,15.1844154068025,6.39810894545167,117
-7.6926,53.28823,2021/04/06 23:00:00+00,Wed 07 Apr 2021,18346,10461,9,733219,311595,156,733375,311751,15.5742086220858,6.62045353624525,118
-7.6926,53.28823,2021/04/07 23:00:00+00,Thu 08 Apr 2021,20172,10569,14,753391,322164,170,753561,322334,16.0028855953197,6.84519783465675,119
-7.6926,53.28823,2021/04/08 23:00:00+00,Fri 09 Apr 2021,20682,9154,16,774073,331318,186,774259,331504,16.4424355800614,7.03993516966888,120
-7.6926,53.28823,2021/04/09 23:00:00+00,Sat 10 Apr 2021,11158,4160,12,785231,335478,198,785429,335676,16.6796456162757,7.1285332243767,121
-7.6926,53.28823,2021/04/10 23:00:00+00,Sun 11 Apr 2021,2855,356,7,788086,335834,205,788291,336039,16.7404240516961,7.1362420196449,122
-7.6926,53.28823,2021/04/11 23:00:00+00,Mon 12 Apr 2021,7767,2787,13,795853,338621,218,796071,338839,16.9056428593727,7.19570380132799,123
-7.6926,53.28823,2021/04/12 23:00:00+00,Tue 13 Apr 2021,11495,8590,1,807348,347211,219,807567,347430,17.149775945883,7.37814528934209,124
-7.6926,53.28823,2021/04/13 23:00:00+00,Wed 14 Apr 2021,20340,6591,2,827688,353802,221,827909,354023,17.5817657898107,7.51815654885518,125
-7.6926,53.28823,2021/04/14 23:00:00+00,Thu 15 Apr 2021,27109,10791,1,854797,364593,222,855019,364815,18.1574832546066,7.74733924454231,126
-7.6926,53.28823,2021/04/15 23:00:00+00,Fri 16 Apr 2021,27969,9826,1,882766,374419,223,882989,374642,18.7514639809196,7.95602886189937,127
-7.6926,53.28823,2021/04/16 23:00:00+00,Sat 17 Apr 2021,15839,4548,2,898605,378967,225,898830,379192,19.0878690107917,8.0526542571344,128
-7.6926,53.28823,2021/04/17 23:00:00+00,Sun 18 Apr 2021,1064,478,0,899669,379445,225,899894,379670,19.1104644878313,8.06280523272173,129
-7.6926,53.28823,2021/04/18 23:00:00+00,Mon 19 Apr 2021,6734,2247,0,906403,381692,225,906628,381917,19.2534700727791,8.11052331252242,130
-7.6926,53.28823,2021/04/19 23:00:00+00,Tue 20 Apr 2021,15076,7311,1,921479,389003,226,921705,389229,19.573650530792,8.2658035081177,131
-7.6926,53.28823,2021/04/20 23:00:00+00,Wed 21 Apr 2021,26704,9871,4,948183,398874,230,948413,399104,20.1408309826463,8.47551247030362,132
-7.6926,53.28823,2021/04/21 23:00:00+00,Thu 22 Apr 2021,31612,12181,1,979795,411055,231,980026,411286,20.812175734199,8.73421369332629,133
-7.6926,53.28823,2021/04/22 23:00:00+00,Fri 23 Apr 2021,33616,12362,1,1013411,423417,232,1013643,423649,21.5260781323564,8.99675869580775,134
-7.6926,53.28823,2021/04/23 23:00:00+00,Sat 24 Apr 2021,23694,6984,2,1037105,430401,234,1037339,430635,22.0292946962002,9.14511584110708,135
-7.6926,53.28823,2021/04/24 23:00:00+00,Sun 25 Apr 2021,9740,298,2,1046845,430699,236,1047081,430935,22.2361792237562,9.15148674628741,136
-7.6926,53.28823,2022/01/05 00:00:00+00,Wed 05 Jan 2022,2144,884,0,3688932,3631551,240204,3929136,3871755,83.4405096554253,82.2219466215833,137
-7.6926,53.28823,2022/01/06 00:00:00+00,Thu 06 Jan 2022,2465,1668,0,3691397,3633219,240204,3931601,3873423,83.4928572596571,82.257368854386,138
-7.6926,53.28823,2022/01/07 00:00:00+00,Fri 07 Jan 2022,4858,765,0,3696255,3633984,240204,3936459,3874188,83.5960234508772,82.2736146625958,139
-7.6926,53.28823,2021/04/26 23:00:00+00,Tue 27 Apr 2021,25908,7803,9,1088317,441544,248,1088565,441792,23.1171479920924,9.38204980476361,140
-7.6926,53.28823,2022/01/08 00:00:00+00,Sat 08 Jan 2022,9792,732,1,3706047,3634716,240205,3946252,3874921,83.8039910323139,82.2891809075864,141
-7.6926,53.28823,2022/01/09 00:00:00+00,Sun 09 Jan 2022,7114,662,0,3713161,3635378,240205,3953366,3875583,83.9550664304901,82.3032393716843,142
-7.6926,53.28823,2021/04/27 23:00:00+00,Wed 28 Apr 2021,26019,8584,5,1114336,450128,253,1114589,450381,23.6698027801356,9.5644488200765,143
-7.6926,53.28823,2022/01/10 00:00:00+00,Mon 10 Jan 2022,6657,489,0,3719818,3635867,240205,3960023,3876072,84.0964368164417,82.3136239471283,144
-7.6926,53.28823,2021/04/28 23:00:00+00,Thu 29 Apr 2021,31683,11330,6,1146019,461458,259,1146278,461717,24.342761494334,9.80518409049064,145
-7.6926,53.28823,2022/01/11 00:00:00+00,Tue 11 Jan 2022,4775,1344,1,3724593,3637211,240206,3964799,3877417,84.1978616269126,82.3421868386868,146
-7.6926,53.28823,2022/01/12 00:00:00+00,Wed 12 Jan 2022,7560,887,1,3732153,3638098,240207,3972360,3878305,84.3584296738075,82.3610447180206,147
-7.6926,53.28823,2022/01/13 00:00:00+00,Thu 13 Jan 2022,7329,789,0,3739482,3638887,240207,3979689,3879094,84.514070887363,82.3778001986448,148
-7.6926,53.28823,2022/01/14 00:00:00+00,Fri 14 Jan 2022,10728,819,0,3750210,3639706,240207,3990417,3879913,84.7418944566117,82.3951927697871,149
-7.6926,53.28823,2022/01/15 00:00:00+00,Sat 15 Jan 2022,8355,637,0,3758565,3640343,240207,3998772,3880550,84.9193241658839,82.40872032512,150
-7.6926,53.28823,2022/01/16 00:00:00+00,Sun 16 Jan 2022,6966,1213,1,3765531,3641556,240208,4005739,3881764,85.0672778205218,82.4345012547498,151
-7.6926,53.28823,2022/01/17 00:00:00+00,Mon 17 Jan 2022,2565,545,0,3768096,3642101,240208,4008304,3882309,85.1217490598137,82.4460750658274,152
-7.6926,53.28823,2022/01/18 00:00:00+00,Tue 18 Jan 2022,4064,426,3,3772160,3642527,240211,4012371,3882738,85.2081172977084,82.4551854602352,153
-7.6926,53.28823,2022/01/19 00:00:00+00,Wed 19 Jan 2022,3488,611,0,3775648,3643138,240211,4015859,3883349,85.282189688605,82.4681608704525,154
-7.6926,53.28823,2022/01/20 00:00:00+00,Thu 20 Jan 2022,3698,924,1,3779346,3644062,240212,4019558,3884274,85.3607429494785,82.4878044947585,155
-7.6926,53.28823,2022/01/21 00:00:00+00,Fri 21 Jan 2022,3253,967,0,3782599,3645029,240212,4022811,3885241,85.4298247979839,82.5083400457898,156
-7.6926,53.28823,2022/01/22 00:00:00+00,Sat 22 Jan 2022,4271,637,0,3786870,3645666,240212,4027082,3885878,85.5205252514012,82.5218676011227,157
-7.6926,53.28823,2022/01/23 00:00:00+00,Sun 23 Jan 2022,3092,677,0,3789962,3646343,240212,4030174,3886555,85.5861880474598,82.5362446104797,158
-7.6926,53.28823,2022/01/24 00:00:00+00,Mon 24 Jan 2022,646,458,0,3790608,3646801,240212,4030820,3887013,85.5999067299482,82.545970859055,159
-7.6926,53.28823,2022/01/25 00:00:00+00,Tue 25 Jan 2022,697,1827,0,3791305,3648628,240212,4031517,3888840,85.6147084663171,82.5847696716032,160
-7.6926,53.28823,2022/01/26 00:00:00+00,Wed 26 Jan 2022,701,885,0,3792006,3649513,240212,4032218,3889725,85.6295951480885,82.6035638418852,161
-7.6926,53.28823,2022/01/27 00:00:00+00,Thu 27 Jan 2022,1275,1161,0,3793281,3650674,240212,4033493,3890886,85.6566714951049,82.628219244933,162
-7.6926,53.28823,2022/01/28 00:00:00+00,Fri 28 Jan 2022,1033,3090,0,3794314,3653764,240212,4034526,3893976,85.6786086452759,82.6938395682905,163
-7.6926,53.28823,2022/01/29 00:00:00+00,Sat 29 Jan 2022,2325,3441,0,3796639,3657205,240212,4036851,3897417,85.7279831604234,82.7669138507089,164
-7.6926,53.28823,2022/01/30 00:00:00+00,Sun 30 Jan 2022,1634,7537,0,3798273,3664742,240212,4038485,3904954,85.7626833573056,82.9269722251894,165
-7.6926,53.28823,2022/01/31 00:00:00+00,Mon 31 Jan 2022,480,1384,0,3798753,3666126,240212,4038965,3906338,85.7728768055942,82.9563633344213,166
-7.6926,53.28823,2022/02/01 00:00:00+00,Tue 01 Feb 2022,762,3410,1,3799515,3669536,240213,4039728,3909749,85.7890801411028,83.0288005263217,167
-7.6926,53.28823,2022/02/02 00:00:00+00,Wed 02 Feb 2022,643,2993,0,3800158,3672529,240213,4040371,3912742,85.8027351145393,83.0923609236708,168
-7.6926,53.28823,2022/02/03 00:00:00+00,Thu 03 Feb 2022,911,2429,1,3801069,3674958,240214,4041283,3915172,85.8221026662875,83.1439652556315,169
-7.6926,53.28823,2022/02/04 00:00:00+00,Fri 04 Feb 2022,1170,6517,0,3802239,3681475,240214,4042453,3921689,85.8469491964908,83.2823625524989,170
-7.6926,53.28823,2022/02/05 00:00:00+00,Sat 05 Feb 2022,1777,5746,0,3804016,3687221,240214,4044230,3927435,85.884686191509,83.4043866230529,171
-7.6926,53.28823,2022/02/06 00:00:00+00,Sun 06 Feb 2022,1408,7555,0,3805424,3694776,240214,4045638,3934990,85.9145869731553,83.5648272518442,172
-7.6926,53.28823,2022/02/07 00:00:00+00,Mon 07 Feb 2022,439,1348,0,3805863,3696124,240214,4046077,3936338,85.9239097310692,83.5934538524545,173
-7.6926,53.28823,2022/02/08 00:00:00+00,Tue 08 Feb 2022,896,1232,0,3806759,3697356,240214,4046973,3937570,85.9429375012078,83.6196170363951,174
-7.6926,53.28823,2022/02/09 00:00:00+00,Wed 09 Feb 2022,1333,1778,0,3808092,3699134,240214,4048306,3939348,85.9712455565591,83.6573752677638,175
-7.6926,53.28823,2022/02/10 00:00:00+00,Thu 10 Feb 2022,690,2540,0,3808782,3701674,240214,4048996,3941888,85.9858986384739,83.7113155982907,176
-7.6926,53.28823,2022/02/11 00:00:00+00,Fri 11 Feb 2022,557,4909,0,3809339,3706583,240214,4049553,3946797,85.9977272857587,83.8155648433915,177
-7.6926,53.28823,2022/02/12 00:00:00+00,Sat 12 Feb 2022,1396,5460,0,3810735,3712043,240214,4050949,3952257,86.0273732311978,83.9315153176735,178
-7.6926,53.28823,2022/02/13 00:00:00+00,Sun 13 Feb 2022,1567,4706,0,3812302,3716749,240214,4052516,3956963,86.0606505925898,84.0314535836023,179
-7.6926,53.28823,2022/02/14 00:00:00+00,Mon 14 Feb 2022,175,947,1,3812477,3717696,240215,4052692,3957911,86.0643881902955,84.0515856439722,180
-7.6926,53.28823,2022/02/15 00:00:00+00,Tue 15 Feb 2022,649,811,1,3813126,3718507,240216,4053342,3958723,86.0781918181863,84.0688295606602,181
-7.6926,53.28823,2022/02/16 00:00:00+00,Wed 16 Feb 2022,794,1782,0,3813920,3720289,240216,4054136,3960505,86.0950534805635,84.1066727374314,182
-7.6926,53.28823,2022/02/17 00:00:00+00,Thu 17 Feb 2022,795,1185,2,3814715,3721474,240218,4054933,3961692,86.1119788519926,84.1318802855949,183
-7.6926,53.28823,2022/02/18 00:00:00+00,Fri 18 Feb 2022,796,3289,0,3815511,3724763,240218,4055729,3964981,86.1288829870711,84.201726642722,184
-7.6926,53.28823,2022/02/19 00:00:00+00,Sat 19 Feb 2022,978,3550,0,3816489,3728313,240218,4056707,3968531,86.149652137959,84.2771156873559,185
-7.6926,53.28823,2022/02/20 00:00:00+00,Sun 20 Feb 2022,1367,3587,0,3817856,3731900,240218,4058074,3972118,86.1786822292307,84.3532904769621,186
-7.6926,53.28823,2022/02/21 00:00:00+00,Mon 21 Feb 2022,253,987,2,3818109,3732887,240220,4058329,3973107,86.184097498634,84.3742932277066,187
-7.6926,53.28823,2022/02/22 00:00:00+00,Tue 22 Feb 2022,475,971,0,3818584,3733858,240220,4058804,3974078,86.1941847651695,84.3949137241402,188
-7.6926,53.28823,2022/02/23 00:00:00+00,Wed 23 Feb 2022,829,1270,1,3819413,3735128,240221,4059634,3975349,86.2118109361684,84.4219051257542,189
-7.6926,53.28823,2022/02/24 00:00:00+00,Thu 24 Feb 2022,658,1227,0,3820071,3736355,240221,4060292,3976576,86.2257844548639,84.4479621279418,190
-7.6926,53.28823,2022/02/25 00:00:00+00,Fri 25 Feb 2022,689,1219,0,3820760,3737574,240221,4060981,3977795,86.2404163004281,84.4738492393245,191
-7.6926,53.28823,2022/02/26 00:00:00+00,Sat 26 Feb 2022,959,2088,0,3821719,3739662,240221,4061940,3979883,86.2607819606546,84.5181907393796,192
-7.6926,53.28823,2022/02/27 00:00:00+00,Sun 27 Feb 2022,670,1781,0,3822389,3741443,240221,4062610,3981664,86.2750103155573,84.5560126798002,193
-7.6926,53.28823,2022/02/28 00:00:00+00,Mon 28 Feb 2022,86,424,0,3822475,3741867,240221,4062696,3982088,86.276836641709,84.5650168924551,194
-7.6926,53.28823,2022/03/01 00:00:00+00,Tue 01 Mar 2022,125,939,0,3822600,3742806,240221,4062821,3983027,86.2794911855341,84.5849578256695,195
-7.6926,53.28823,2022/03/02 00:00:00+00,Wed 02 Mar 2022,206,988,2,3822806,3743794,240223,4063029,3984017,86.2839083464592,84.6059818127646,196
-7.6926,53.28823,2022/03/03 00:00:00+00,Thu 03 Mar 2022,273,1274,0,3823079,3745068,240223,4063302,3985291,86.2897058701733,84.6330369234304,197
-7.6926,53.28823,2022/03/04 00:00:00+00,Fri 04 Mar 2022,731,1500,2,3823810,3746568,240225,4064035,3986793,86.3052721151639,84.6649339220333,198
-7.6926,53.28823,2022/03/05 00:00:00+00,Sat 05 Mar 2022,962,3341,0,3824772,3749909,240225,4064997,3990134,86.3257014844421,84.7358845693916,199
-7.6926,53.28823,2022/03/06 00:00:00+00,Sun 06 Mar 2022,456,1914,0,3825228,3751823,240225,4065453,3992048,86.3353852603162,84.7765309444421,200
-7.6926,53.28823,2022/03/07 00:00:00+00,Mon 07 Mar 2022,112,119,0,3825340,3751942,240225,4065565,3992167,86.3377637315836,84.7790580701636,201
-7.6926,53.28823,2022/03/08 00:00:00+00,Tue 08 Mar 2022,119,492,0,3825459,3752434,240225,4065684,3992659,86.3402908573051,84.7895063546594,202
-7.6926,53.28823,2022/03/09 00:00:00+00,Wed 09 Mar 2022,125,336,0,3825584,3752770,240225,4065809,3992995,86.3429454011303,84.7966417684613,203
-7.6926,53.28823,2022/03/10 00:00:00+00,Thu 10 Mar 2022,255,507,0,3825839,3753277,240225,4066064,3993502,86.3483606705335,84.8074085982161,204
-7.6926,53.28823,2022/03/11 00:00:00+00,Fri 11 Mar 2022,495,2175,0,3826334,3755452,240225,4066559,3995677,86.3588726640811,84.8535976607735,205
-7.6926,53.28823,2022/03/12 00:00:00+00,Sat 12 Mar 2022,472,2387,2,3826806,3757839,240227,4067033,3998066,86.368938694266,84.9043313023596,206
-7.6926,53.28823,2022/03/13 00:00:00+00,Sun 13 Mar 2022,358,1082,0,3827164,3758921,240227,4067391,3999148,86.3765413077812,84.9273090337099,207
-7.6926,53.28823,2022/03/14 00:00:00+00,Mon 14 Mar 2022,107,120,0,3827271,3759041,240227,4067498,3999268,86.3788135972955,84.9298573957821,208
-7.6926,53.28823,2022/03/15 00:00:00+00,Tue 15 Mar 2022,222,755,0,3827493,3759796,240227,4067720,4000023,86.3835280671289,84.9458908404859,209
-7.6926,53.28823,2022/03/16 00:00:00+00,Wed 16 Mar 2022,196,795,0,3827689,3760591,240227,4067916,4000818,86.3876903918468,84.9627737392138,210
-7.6926,53.28823,2022/03/18 00:00:00+00,Fri 18 Mar 2022,2,6,0,3827691,3760597,240227,4067918,4000824,86.387732864548,84.9629011573174,211
-7.6926,53.28823,2022/03/19 00:00:00+00,Sat 19 Mar 2022,742,2778,0,3828433,3763375,240227,4068660,4003602,86.403490236694,85.0218957392873,212
-7.6926,53.28823,2022/03/20 00:00:00+00,Sun 20 Mar 2022,394,1400,0,3828827,3764775,240227,4069054,4005002,86.4118573588308,85.0516266301288,213
-7.6926,53.28823,2022/03/21 00:00:00+00,Mon 21 Mar 2022,52,108,0,3828879,3764883,240227,4069106,4005110,86.4129616490621,85.0539201559937,214
-7.6926,53.28823,2022/03/22 00:00:00+00,Tue 22 Mar 2022,137,569,0,3829016,3765452,240227,4069243,4005679,86.4158710290944,85.0660036394858,215
-7.6926,53.28823,2022/03/23 00:00:00+00,Wed 23 Mar 2022,95,219,0,3829111,3765671,240227,4069338,4005898,86.4178884824015,85.0706544002674,216
-7.6926,53.28823,2022/03/24 00:00:00+00,Thu 24 Mar 2022,148,237,0,3829259,3765908,240227,4069486,4006135,86.4210314622905,85.0756874153599,217
-7.6926,53.28823,2022/03/25 00:00:00+00,Fri 25 Mar 2022,436,1613,0,3829695,3767521,240227,4069922,4007748,86.4302905111526,85.1099416488795,218
-7.6926,53.28823,2022/03/26 00:00:00+00,Sat 26 Mar 2022,871,1847,0,3830566,3769368,240227,4070793,4009595,86.4487873725261,85.1491651884397,219
-7.6926,53.28823,2022/03/27 00:00:00+00,Sun 27 Mar 2022,379,801,0,3830945,3770169,240227,4071172,4010396,86.456835949404,85.1661755052712,220
-7.6926,53.28823,2022/03/27 23:00:00+00,Mon 28 Mar 2022,37,52,0,3830982,3770221,240227,4071209,4010448,86.4576216943762,85.1672797955024,221
-7.6926,53.28823,2022/03/28 23:00:00+00,Tue 29 Mar 2022,137,184,3,3831119,3770405,240230,4071349,4010635,86.4605947834604,85.1712509930648,222
-7.6926,53.28823,2022/03/29 23:00:00+00,Wed 30 Mar 2022,107,133,0,3831226,3770538,240230,4071456,4010768,86.4628670729747,85.1740754276948,223
-7.6926,53.28823,2022/03/30 23:00:00+00,Thu 31 Mar 2022,222,349,0,3831448,3770887,240230,4071678,4011117,86.4675815428081,85.1814869140546,224
-7.6926,53.28823,2022/03/31 23:00:00+00,Fri 01 Apr 2022,307,900,0,3831755,3771787,240230,4071985,4012017,86.4741011024427,85.2005996295956,225
-7.6926,53.28823,2022/04/01 23:00:00+00,Sat 02 Apr 2022,724,1538,0,3832479,3773325,240230,4072709,4013555,86.4894762202779,85.2332611368201,226
-7.6926,53.28823,2022/04/02 23:00:00+00,Sun 03 Apr 2022,534,817,0,3833013,3774142,240230,4073243,4014372,86.5008164314989,85.2506112352612,227
-7.6926,53.28823,2022/04/03 23:00:00+00,Mon 04 Apr 2022,45,49,0,3833058,3774191,240230,4073288,4014421,86.5017720672759,85.2516518164406,228
-7.6926,53.28823,2022/04/04 23:00:00+00,Tue 05 Apr 2022,128,165,0,3833186,3774356,240230,4073416,4014586,86.5044903201529,85.2551558142898,229
-7.6926,53.28823,2022/04/05 23:00:00+00,Wed 06 Apr 2022,157,202,0,3833343,3774558,240230,4073573,4014788,86.5078244271972,85.2594455571112,230
-7.6926,53.28823,2022/04/06 23:00:00+00,Thu 07 Apr 2022,117,172,0,3833460,3774730,240230,4073690,4014960,86.5103090802176,85.2630982094146,231
-7.6926,53.28823,2022/04/07 23:00:00+00,Fri 08 Apr 2022,264,408,0,3833724,3775138,240230,4073954,4015368,86.5159154767763,85.2717626404599,232
-7.6926,53.28823,2022/04/08 23:00:00+00,Sat 09 Apr 2022,558,1014,0,3834282,3776152,240230,4074512,4016382,86.5277653604117,85.2932962999694,233
-7.6926,53.28823,2022/04/09 23:00:00+00,Sun 10 Apr 2022,410,718,0,3834692,3776870,240230,4074922,4017100,86.5364722641581,85.308543999701,234
-7.6926,53.28823,2022/04/10 23:00:00+00,Mon 11 Apr 2022,66,85,0,3834758,3776955,240230,4074988,4017185,86.5378738632978,85.3103490895021,235
-7.6926,53.28823,2022/04/11 23:00:00+00,Tue 12 Apr 2022,190,170,0,3834948,3777125,240230,4075178,4017355,86.541908769912,85.3139592691043,236
-7.6926,53.28823,2022/04/12 23:00:00+00,Wed 13 Apr 2022,143,218,0,3835091,3777343,240230,4075321,4017573,86.544945568048,85.3185887935353,237
-7.6926,53.28823,2022/04/13 23:00:00+00,Thu 14 Apr 2022,349,408,0,3835440,3777751,240230,4075670,4017981,86.5523570544078,85.3272532245806,238
-7.6926,53.28823,2022/04/14 23:00:00+00,Fri 15 Apr 2022,439,978,0,3835879,3778729,240230,4076109,4018959,86.5616798123216,85.3480223754684,239
-7.6926,53.28823,2022/04/15 23:00:00+00,Sat 16 Apr 2022,42,83,0,3835921,3778812,240230,4076151,4019042,86.5625717390469,85.3497849925683,240
-7.6926,53.28823,2022/04/17 23:00:00+00,Mon 18 Apr 2022,35,61,0,3835956,3778873,240230,4076186,4019103,86.5633150113179,85.351080409955,241
-7.6926,53.28823,2022/04/18 23:00:00+00,Tue 19 Apr 2022,212,256,1,3836168,3779129,240231,4076399,4019360,86.567838353996,85.3565381520595,242
-7.6926,53.28823,2021/04/29 23:00:00+00,Fri 30 Apr 2021,36113,13518,8,1182132,474976,267,1182399,475243,25.1098397143966,10.0924269687212,243
-7.6926,53.28823,2021/04/30 23:00:00+00,Sat 01 May 2021,16557,6685,18,1198689,481661,285,1198974,481946,25.4618322256099,10.2347742268004,244
-7.6926,53.28823,2021/05/01 23:00:00+00,Sun 02 May 2021,12432,907,14,1211121,482568,299,1211420,482867,25.7261398451913,10.254332905704,245
-7.6926,53.28823,2021/05/02 23:00:00+00,Mon 03 May 2021,14244,914,21,1225365,483482,320,1225685,483802,26.029076386516,10.2741888935161,246
-7.6926,53.28823,2021/05/03 23:00:00+00,Tue 04 May 2021,26637,6779,9,1252002,490261,329,1252331,490590,26.5949401846331,10.4183412413964,247
-7.6926,53.28823,2021/05/04 23:00:00+00,Wed 05 May 2021,32083,13449,69,1284085,503710,398,1284483,504108,27.2777313291598,10.7054142288221,248
-7.6926,53.28823,2021/05/05 23:00:00+00,Thu 06 May 2021,37260,14372,132,1321345,518082,530,1321875,518612,28.0718009508364,11.0134262579405,249
-7.6926,53.28823,2021/05/06 23:00:00+00,Fri 07 May 2021,40581,15065,97,1361926,533147,627,1362553,533774,28.9356532205881,11.3354118057545,250
-7.6926,53.28823,2021/05/07 23:00:00+00,Sat 08 May 2021,25599,7035,10,1387525,540182,637,1388162,540819,29.4794949231318,11.4850218957393,251
-7.6926,53.28823,2021/05/08 23:00:00+00,Sun 09 May 2021,19660,920,4,1407185,541102,641,1407826,541743,29.897086521352,11.5046442836947,252
-7.6926,53.28823,2021/05/09 23:00:00+00,Mon 10 May 2021,28816,4631,170,1436001,545733,811,1436812,546544,30.5126433798756,11.6066000029306,253
-7.6926,53.28823,2021/05/10 23:00:00+00,Tue 11 May 2021,33913,14807,152,1469914,560540,963,1470877,561503,31.2360596631023,11.9242745715726,254
-7.6926,53.28823,2021/05/11 23:00:00+00,Wed 12 May 2021,31271,20927,169,1501185,581467,1132,1502317,582599,31.903730526001,12.3722766238535,255
-7.6926,53.28823,2021/05/12 23:00:00+00,Thu 13 May 2021,35983,25478,151,1537168,606945,1283,1538451,608228,32.6710848186214,12.9165430534092,256
-7.6926,53.28823,2021/05/13 23:00:00+00,Fri 14 May 2021,38202,27960,235,1575370,634905,1518,1576888,636423,33.4873464266761,13.5153019586074,257
-7.6926,53.28823,2021/05/14 23:00:00+00,Sat 15 May 2021,28841,12441,20,1604211,647346,1538,1605749,648884,34.1002487413746,13.7799281234478,258
-7.6926,53.28823,2021/05/15 23:00:00+00,Sun 16 May 2021,23160,1166,9,1627371,648512,1547,1628918,650059,34.5922737484516,13.8048808354041,259
-7.6926,53.28823,2021/05/16 23:00:00+00,Mon 17 May 2021,35375,3935,114,1662746,652447,1661,1664407,654108,35.3459305949342,13.8908668189879,260
-7.6926,53.28823,2021/05/17 23:00:00+00,Tue 18 May 2021,39029,12482,124,1701775,664929,1785,1703560,666714,36.1773974300193,14.1585722546655,261
-7.6926,53.28823,2021/05/18 23:00:00+00,Wed 19 May 2021,37008,17588,204,1738783,682517,1989,1740772,684506,36.9676445085877,14.5364094045603,262
-7.6926,53.28823,2021/05/19 23:00:00+00,Thu 20 May 2021,39062,19641,134,1777845,702158,2123,1779968,704281,37.8000245067486,14.9563582376972,263
-7.6926,53.28823,2021/05/20 23:00:00+00,Fri 21 May 2021,25813,23249,14933,1803658,725407,17056,1820714,742463,38.6653208483412,15.7672045763486,264
-7.6926,53.28823,2021/05/21 23:00:00+00,Sat 22 May 2021,16574,10247,13522,1820232,735654,30578,1850810,766232,39.3044500560321,16.2719713937863,265
-7.6926,53.28823,2021/05/22 23:00:00+00,Sun 23 May 2021,8206,5518,10204,1828438,741172,40782,1869220,781954,39.6954112705985,16.6058492979369,266
-7.6926,53.28823,2021/05/23 23:00:00+00,Mon 24 May 2021,22524,8206,8448,1850962,749378,49230,1900192,798608,40.3531435214159,16.9595194808477,267
-7.6926,53.28823,2021/05/24 23:00:00+00,Tue 25 May 2021,30299,16479,3221,1881261,765857,52451,1933712,818308,41.064985993565,17.3778755876895,268
-7.6926,53.28823,2021/05/25 23:00:00+00,Wed 26 May 2021,19944,25382,3048,1901205,791239,55499,1956704,846738,41.5532521665856,17.9816250352789,269
-7.6926,53.28823,2021/05/26 23:00:00+00,Thu 27 May 2021,16976,36012,551,1918181,827251,56050,1974231,883301,41.9254616835712,18.7580897223071,270
-7.6926,53.28823,2021/05/27 23:00:00+00,Fri 28 May 2021,27003,31812,1558,1945184,859063,57608,2002792,916671,42.5319930930893,19.466746741866,271
-7.6926,53.28823,2021/05/28 23:00:00+00,Sat 29 May 2021,24448,7381,533,1969632,866444,58141,2027773,924585,43.0624983674555,19.6348112205231,272
-7.6926,53.28823,2021/05/29 23:00:00+00,Sun 30 May 2021,24221,1670,209,1993853,868114,58350,2052203,926464,43.5813024126406,19.6747143233026,273
-7.6926,53.28823,2021/05/30 23:00:00+00,Mon 31 May 2021,22551,7313,3439,2016404,875427,61789,2078193,937216,44.1332351647633,19.9030475649657,274
-7.6926,53.28823,2021/05/31 23:00:00+00,Tue 01 Jun 2021,27496,11504,3650,2043900,886931,65439,2109339,952370,44.7946625405853,20.2248632219749,275
-7.6926,53.28823,2021/06/01 23:00:00+00,Wed 02 Jun 2021,18657,20879,4005,2062557,907810,69444,2132001,977254,45.2759207179076,20.7533085703328,276
-7.6926,53.28823,2021/06/02 23:00:00+00,Thu 03 Jun 2021,16643,30699,1974,2079200,938509,71418,2150618,1009927,45.6712778570484,21.4471638535227,277
-7.6926,53.28823,2021/06/03 23:00:00+00,Fri 04 Jun 2021,28973,23335,150,2108173,961844,71568,2179741,1033412,46.2897440956043,21.9458995473897,278
-7.6926,53.28823,2021/06/04 23:00:00+00,Sat 05 Jun 2021,20929,11479,33,2129102,973323,71601,2200703,1044924,46.7349004769047,22.1903724155096,279
-7.6926,53.28823,2021/06/05 23:00:00+00,Sun 06 Jun 2021,19908,3894,40,2149010,977217,71641,2220651,1048858,47.1585231986956,22.2739162187743,280
-7.6926,53.28823,2021/06/06 23:00:00+00,Mon 07 Jun 2021,19774,4567,40,2168784,981784,71681,2240465,1053465,47.5793002495059,22.3717520859936,281
-7.6926,53.28823,2021/06/07 23:00:00+00,Tue 08 Jun 2021,26370,18332,41,2195154,1000116,71722,2266876,1071838,48.1401735052317,22.7619275555877,282
-7.6926,53.28823,2021/06/08 23:00:00+00,Wed 09 Jun 2021,32755,20092,172,2227909,1020208,71894,2299803,1092102,48.8394228214743,23.1922609641685,283
-7.6926,53.28823,2021/06/09 23:00:00+00,Thu 10 Jun 2021,27643,27476,268,2255552,1047684,72162,2327714,1119846,49.4321506031017,23.7814422752456,284
-7.6926,53.28823,2021/06/10 23:00:00+00,Fri 11 Jun 2021,26400,32883,39,2281952,1080567,72201,2354153,1152768,49.9936184766444,24.4805854097352,285
-7.6926,53.28823,2021/06/11 23:00:00+00,Sat 12 Jun 2021,12181,19707,103,2294133,1100274,72304,2366437,1172578,50.2544858074284,24.9012775151431,286
-7.6926,53.28823,2021/06/12 23:00:00+00,Sun 13 Jun 2021,8528,18158,829,2302661,1118432,73133,2375794,1191565,50.4531943400029,25.3044921040063,287
-7.6926,53.28823,2021/06/13 23:00:00+00,Mon 14 Jun 2021,15988,31287,45,2318649,1149719,73178,2391827,1222897,50.7936767491904,25.9698694410401,288
-7.6926,53.28823,2021/06/14 23:00:00+00,Tue 15 Jun 2021,14665,41559,201,2333314,1191278,73379,2406693,1264657,51.1093763372265,26.8566994421423,289
-7.6926,53.28823,2021/06/15 23:00:00+00,Wed 16 Jun 2021,13425,48370,211,2346739,1239648,73590,2420329,1313238,51.3989552140231,27.8883825906946,290
-7.6926,53.28823,2021/06/16 23:00:00+00,Thu 17 Jun 2021,21540,42658,534,2368279,1282306,74124,2442403,1356430,51.8677264171919,28.8056230458576,291
-7.6926,53.28823,2021/06/17 23:00:00+00,Fri 18 Jun 2021,11985,50024,548,2380264,1332330,74672,2454936,1407002,52.1338815992756,29.8795877684567,292
-7.6926,53.28823,2021/06/18 23:00:00+00,Sat 19 Jun 2021,6289,32777,431,2386553,1365107,75103,2461656,1440210,52.276589875315,30.5848044992182,293
-7.6926,53.28823,2021/06/19 23:00:00+00,Sun 20 Jun 2021,8493,26129,173,2395046,1391236,75276,2470322,1466512,52.4606240896242,31.1433629927285,294
-7.6926,53.28823,2021/06/20 23:00:00+00,Mon 21 Jun 2021,15439,32312,568,2410485,1423548,75844,2486329,1499392,52.8005543536961,31.8416142004928,295
-7.6926,53.28823,2021/06/21 23:00:00+00,Tue 22 Jun 2021,15104,43516,716,2425589,1467064,76560,2502149,1543624,53.1365134202056,32.7809404602809,296
-7.6926,53.28823,2021/06/22 23:00:00+00,Wed 23 Jun 2021,20056,39365,878,2445645,1506429,77438,2523083,1583867,53.5810751836891,33.6355549175212,297
-7.6926,53.28823,2021/06/23 23:00:00+00,Thu 24 Jun 2021,18986,44240,1030,2464631,1550669,78468,2543099,1629137,54.0061419773209,34.5969245092332,298
-7.6926,53.28823,2021/06/24 23:00:00+00,Fri 25 Jun 2021,15174,50106,834,2479805,1600775,79302,2559107,1680077,54.3460934777434,35.6787042088536,299
-7.6926,53.28823,2021/06/25 23:00:00+00,Sat 26 Jun 2021,9019,30529,497,2488824,1631304,79799,2568623,1711103,54.5481785900635,36.3375832226035,300
-7.6926,53.28823,2021/06/26 23:00:00+00,Sun 27 Jun 2021,8705,30453,55,2497529,1661757,79854,2577383,1741611,54.7342090213291,36.985461806742,301
-7.6926,53.28823,2021/06/27 23:00:00+00,Mon 28 Jun 2021,24195,24619,515,2521724,1686376,80369,2602093,1766745,55.2589592446825,37.5192162427502,302
-7.6926,53.28823,2021/06/28 23:00:00+00,Tue 29 Jun 2021,28118,30990,805,2549842,1717366,81174,2631016,1798540,55.8731782131182,38.1944260101123,303
-7.6926,53.28823,2021/06/29 23:00:00+00,Wed 30 Jun 2021,22525,36835,575,2572367,1754201,81749,2654116,1835950,56.3637379120038,38.9888778860997,304
-7.6926,53.28823,2021/06/30 23:00:00+00,Thu 01 Jul 2021,14946,48290,633,2587313,1802491,82382,2669695,1884873,56.6945790180184,40.0278238665576,305
-7.6926,53.28823,2021/07/01 23:00:00+00,Fri 02 Jul 2021,13620,47229,812,2600933,1849720,83194,2684127,1932914,57.0010620298936,41.0480393857853,306
-7.6926,53.28823,2021/07/02 23:00:00+00,Sat 03 Jul 2021,9286,30449,503,2610219,1880169,83697,2693916,1963866,57.2089446659278,41.7053469095907,307
-7.6926,53.28823,2021/07/03 23:00:00+00,Sun 04 Jul 2021,6417,27762,230,2616636,1907931,83927,2700563,1991858,57.3501026883733,42.2997948356168,308
-7.6926,53.28823,2021/07/04 23:00:00+00,Mon 05 Jul 2021,15551,33407,5333,2632187,1941338,89260,2721447,2030598,57.7936026343268,43.1224910579037,309
-7.6926,53.28823,2021/07/05 23:00:00+00,Tue 06 Jul 2021,12368,48264,5480,2644555,1989602,94740,2739295,2084342,58.1726290198553,44.2638174846095,310
-7.6926,53.28823,2021/07/06 23:00:00+00,Wed 07 Jul 2021,19652,43725,5051,2664207,2033327,99791,2763998,2133118,58.6972305887545,45.299641721529,311
-7.6926,53.28823,2021/07/07 23:00:00+00,Thu 08 Jul 2021,17724,45562,5988,2681931,2078889,105779,2787710,2184668,59.2007869342079,46.394375595016,312
-7.6926,53.28823,2021/07/08 23:00:00+00,Fri 09 Jul 2021,13489,45076,6523,2695420,2123965,112302,2807722,2236267,59.6257687824372,47.4901500496824,313
-7.6926,53.28823,2021/07/09 23:00:00+00,Sat 10 Jul 2021,8597,23841,4359,2704017,2147806,116661,2820678,2264467,59.9009069408251,48.0890151366336,314
-7.6926,53.28823,2021/07/10 23:00:00+00,Sun 11 Jul 2021,15208,16094,2148,2719225,2163900,118809,2838034,2282709,60.2694850418579,48.476408644299,315
-7.6926,53.28823,2021/07/11 23:00:00+00,Mon 12 Jul 2021,17071,31713,6086,2736296,2195613,124895,2861191,2320508,60.7612552127277,49.2791214606702,316
-7.6926,53.28823,2021/07/12 23:00:00+00,Tue 13 Jul 2021,20062,36526,8480,2756358,2232139,133375,2889733,2365514,61.3673831315845,50.2348846558235,317
-7.6926,53.28823,2021/07/13 23:00:00+00,Wed 14 Jul 2021,20760,35658,9327,2777118,2267797,142702,2919820,2410499,62.0063212121199,51.1902018876143,318
-7.6926,53.28823,2021/07/14 23:00:00+00,Thu 15 Jul 2021,23579,28792,9569,2800697,2296589,152271,2952968,2448860,62.7102637618454,52.0048495330233,319
-7.6926,53.28823,2021/07/15 23:00:00+00,Fri 16 Jul 2021,23508,27370,9157,2824205,2323959,161428,2985633,2485387,63.4039491542305,52.7805497114298,320
-7.6926,53.28823,2021/07/16 23:00:00+00,Sat 17 Jul 2021,11466,19396,4671,2835671,2343355,166099,3001770,2509454,63.7466401438805,53.2916449613466,321
-7.6926,53.28823,2021/07/17 23:00:00+00,Sun 18 Jul 2021,16831,15781,1924,2852502,2359136,168023,3020525,2527159,64.1449278994043,53.6676345487392,322
-7.6926,53.28823,2021/07/18 23:00:00+00,Mon 19 Jul 2021,24842,18379,6238,2877344,2377515,174261,3051605,2551776,64.8049536760866,54.1904097914867,323
-7.6926,53.28823,2021/07/19 23:00:00+00,Tue 20 Jul 2021,30535,18127,7690,2907879,2395642,181951,3089830,2577593,65.6167131778139,54.7386686549554,324
-7.6926,53.28823,2021/07/20 23:00:00+00,Wed 21 Jul 2021,30308,19795,6879,2938187,2415437,188830,3127017,2604267,66.4064293476172,55.3051270708893,325
-7.6926,53.28823,2021/07/21 23:00:00+00,Thu 22 Jul 2021,33496,15888,6929,2971683,2431325,195759,3167442,2627084,67.2649088206669,55.7896768825547,326
-7.6926,53.28823,2021/07/22 23:00:00+00,Fri 23 Jul 2021,27055,20778,5608,2998738,2452103,201367,3200105,2653470,67.9585517403508,56.3500192295155,327
-7.6926,53.28823,2021/07/23 23:00:00+00,Sat 24 Jul 2021,15410,14771,2264,3014148,2466874,203631,3217779,2670505,68.3338830008747,56.7117804620053,328
-7.6926,53.28823,2021/07/24 23:00:00+00,Sun 25 Jul 2021,14692,13617,1037,3028840,2480491,204668,3233508,2685159,68.6679095594795,57.0229779437139,329
-7.6926,53.28823,2021/07/25 23:00:00+00,Mon 26 Jul 2021,23791,18236,3415,3052631,2498727,208083,3260714,2706810,69.2456657139332,57.4827661705784,330
-7.6926,53.28823,2021/07/26 23:00:00+00,Tue 27 Jul 2021,25461,23840,3660,3078092,2522567,211743,3289835,2734310,69.864089479788,58.0667658121088,331
-7.6926,53.28823,2021/07/27 23:00:00+00,Wed 28 Jul 2021,23399,25231,3255,3101491,2547798,214998,3316489,2762796,70.4301231687098,58.6717044953319,332
-7.6926,53.28823,2021/07/28 23:00:00+00,Thu 29 Jul 2021,19225,27810,2953,3120716,2575608,217951,3338667,2793559,70.9011029523412,59.3249983488737,333
-7.6926,53.28823,2021/07/29 23:00:00+00,Fri 30 Jul 2021,21914,22885,2113,3142630,2598493,220064,3362694,2818557,71.4113487482339,59.8558646412002,334
-7.6926,53.28823,2021/07/30 23:00:00+00,Sat 31 Jul 2021,13711,12434,905,3156341,2610927,220969,3377310,2831896,71.7217392486197,60.1391363218683,335
-7.6926,53.28823,2021/07/31 23:00:00+00,Sun 01 Aug 2021,11075,9287,368,3167416,2620214,221337,3388753,2841551,71.9647468085481,60.344173286922,336
-7.6926,53.28823,2021/08/01 23:00:00+00,Mon 02 Aug 2021,14984,15954,423,3182400,2636168,221760,3404160,2857928,72.2919352622594,60.6919610007163,337
-7.6926,53.28823,2021/08/02 23:00:00+00,Tue 03 Aug 2021,17305,25393,1104,3199705,2661561,222864,3422569,2884425,72.6828752404751,61.2546605825938,338
-7.6926,53.28823,2021/08/03 23:00:00+00,Wed 04 Aug 2021,22071,17240,1571,3221776,2678801,224435,3446211,2903236,73.1849450413865,61.6541375737512,339
-7.6926,53.28823,2021/08/04 23:00:00+00,Thu 05 Aug 2021,13498,29986,1420,3235274,2708787,225855,3461129,2934642,73.5017489196537,62.3210864007295,340
-7.6926,53.28823,2021/08/05 23:00:00+00,Fri 06 Aug 2021,12167,24701,946,3247441,2733488,226801,3474242,2960289,73.780221185086,62.8657350845961,341
-7.6926,53.28823,2021/08/06 23:00:00+00,Sat 07 Aug 2021,6316,8414,580,3253757,2741902,227381,3481138,2969283,73.9266670588313,63.0567348219024,342
-7.6926,53.28823,2021/08/07 23:00:00+00,Sun 08 Aug 2021,8604,11937,153,3262361,2753839,227534,3489895,2981373,74.1126337810452,63.3134823006698,343
-7.6926,53.28823,2021/08/08 23:00:00+00,Mon 09 Aug 2021,5512,22974,597,3267873,2776813,228131,3496004,3004944,74.2423666468673,63.8140443206884,344
-7.6926,53.28823,2021/08/09 23:00:00+00,Tue 10 Aug 2021,9317,25937,709,3277190,2802750,228840,3506030,3031590,74.455282297994,64.3799081188055,345
-7.6926,53.28823,2021/08/10 23:00:00+00,Wed 11 Aug 2021,6983,31191,656,3284173,2833941,229496,3513669,3063437,74.6175067802358,65.0562221763989,346
-7.6926,53.28823,2021/08/11 23:00:00+00,Thu 12 Aug 2021,6733,38235,858,3290906,2872176,230354,3521260,3102530,74.7787119176488,65.8864148304479,347
-7.6926,53.28823,2021/08/12 23:00:00+00,Fri 13 Aug 2021,10893,28195,864,3301799,2900371,231218,3533017,3131589,75.028387691666,66.5035219425654,348
-7.6926,53.28823,2021/08/13 23:00:00+00,Sat 14 Aug 2021,18113,5813,277,3319912,2906184,231495,3551407,3137679,75.4189241792204,66.6328513177262,349
-7.6926,53.28823,2021/08/14 23:00:00+00,Sun 15 Aug 2021,16990,3703,49,3336902,2909887,231544,3568446,3141431,75.7807703571126,66.7125301051815,350
-7.6926,53.28823,2021/08/15 23:00:00+00,Mon 16 Aug 2021,10159,23087,382,3347061,2932974,231926,3578987,3164900,76.0046227287989,67.2109260174389,351
-7.6926,53.28823,2021/08/16 23:00:00+00,Tue 17 Aug 2021,12846,26819,524,3359907,2959793,232450,3592357,3192243,76.2885527363356,67.7915915519249,352
-7.6926,53.28823,2021/08/17 23:00:00+00,Wed 18 Aug 2021,15209,25733,656,3375116,2985526,233106,3608222,3218632,76.6254674386222,68.3519976079375,353
-7.6926,53.28823,2021/08/18 23:00:00+00,Thu 19 Aug 2021,11344,25656,539,3386460,3011182,233645,3620105,3244827,76.8778189928151,68.9082838119334,354
-7.6926,53.28823,2021/08/19 23:00:00+00,Fri 20 Aug 2021,14823,22204,684,3401283,3033386,234329,3635612,3267715,77.2071310815864,69.3943414044915,355
-7.6926,53.28823,2021/08/20 23:00:00+00,Sat 21 Aug 2021,11859,7945,243,3413142,3041331,234572,3647714,3275903,77.464133396561,69.5682246432134,356
-7.6926,53.28823,2021/08/21 23:00:00+00,Sun 22 Aug 2021,8000,12235,161,3421142,3053566,234733,3655875,3288299,77.6374432538167,69.8314704452647,357
-7.6926,53.28823,2021/08/22 23:00:00+00,Mon 23 Aug 2021,10848,15334,288,3431990,3068900,235021,3667011,3303921,77.8739312541106,70.1632247143552,358
-7.6926,53.28823,2021/08/23 23:00:00+00,Tue 24 Aug 2021,9690,22879,383,3441680,3091779,235404,3677084,3327183,78.0878450137155,70.6572247020381,359
-7.6926,53.28823,2021/08/24 23:00:00+00,Wed 25 Aug 2021,9403,19479,312,3451083,3111258,235716,3686799,3346974,78.2941561598052,71.0775133167846,360
-7.6926,53.28823,2021/08/25 23:00:00+00,Thu 26 Aug 2021,8562,19393,365,3459645,3130651,236081,3695726,3366732,78.4837330616213,71.4971011319612,361
-7.6926,53.28823,2021/08/26 23:00:00+00,Fri 27 Aug 2021,9704,19166,430,3469349,3149817,236511,3705860,3386328,78.6989422386129,71.9132486583404,362
-7.6926,53.28823,2021/08/27 23:00:00+00,Sat 28 Aug 2021,9911,7885,153,3479260,3157702,236664,3715924,3394366,78.9126648710624,72.0839464444721,363
-7.6926,53.28823,2021/08/28 23:00:00+00,Sun 29 Aug 2021,8790,9171,28,3488050,3166873,236692,3724742,3403565,79.099927010663,72.2792996336517,364
-7.6926,53.28823,2021/08/29 23:00:00+00,Mon 30 Aug 2021,5042,11084,82,3493092,3177957,236774,3729866,3414731,79.208742071143,72.5164247244637,365
-7.6926,53.28823,2021/08/30 23:00:00+00,Tue 31 Aug 2021,4050,12845,141,3497142,3190802,236915,3734057,3427717,79.2977436165123,72.7921999733696,366
-7.6926,53.28823,2021/08/31 23:00:00+00,Wed 01 Sep 2021,4933,12504,180,3502075,3203306,237095,3739170,3440401,79.4063250771357,73.061561844394,367
-7.6926,53.28823,2021/09/01 23:00:00+00,Thu 02 Sep 2021,5000,12329,246,3507075,3215635,237341,3744416,3452976,79.5177309723891,73.3286089532029,368
-7.6926,53.28823,2021/09/02 23:00:00+00,Fri 03 Sep 2021,4759,16029,165,3511834,3231664,237506,3749340,3469170,79.622298762749,73.6725104148372,369
-7.6926,53.28823,2021/09/03 23:00:00+00,Sat 04 Sep 2021,4619,10554,133,3516453,3242218,237639,3754092,3479857,79.7232139008054,73.8994632937112,370
-7.6926,53.28823,2021/09/04 23:00:00+00,Sun 05 Sep 2021,5304,11887,1,3521757,3254105,237640,3759397,3491745,79.8358727407443,74.1519210296572,371
-7.6926,53.28823,2021/09/05 23:00:00+00,Mon 06 Sep 2021,2143,9653,74,3523900,3263758,237714,3761614,3501472,79.882953730027,74.3584870119542,372
-7.6926,53.28823,2021/09/06 23:00:00+00,Tue 07 Sep 2021,3017,9985,155,3526917,3273743,237869,3764786,3511612,79.9503154341337,74.5738236070494,373
-7.6926,53.28823,2021/09/07 23:00:00+00,Wed 08 Sep 2021,2593,14790,186,3529510,3288533,238055,3767565,3526588,80.0093312524541,74.8918591936515,374
-7.6926,53.28823,2021/09/08 23:00:00+00,Thu 09 Sep 2021,3107,14779,137,3532617,3303312,238192,3770809,3541504,80.0782219738041,75.2086205992176,375
-7.6926,53.28823,2021/09/09 23:00:00+00,Fri 10 Sep 2021,3370,13932,115,3535987,3317244,238307,3774294,3555551,80.152230655649,75.5069276161113,376
-7.6926,53.28823,2021/09/10 23:00:00+00,Sat 11 Sep 2021,2550,11310,62,3538537,3328554,238369,3776906,3566923,80.2077000034191,75.7484273951471,377
-7.6926,53.28823,2021/09/11 23:00:00+00,Sun 12 Sep 2021,2037,12872,1,3540574,3341426,238370,3778944,3579796,80.2509796859441,76.0218029364352,378
-7.6926,53.28823,2021/09/12 23:00:00+00,Mon 13 Sep 2021,1603,7714,51,3542177,3349140,238421,3780598,3587561,80.2861046098383,76.1867031988527,379
-7.6926,53.28823,2021/09/13 23:00:00+00,Tue 14 Sep 2021,1541,10769,81,3543718,3359909,238502,3782220,3598411,80.3205499705133,76.4171176028747,380
-7.6926,53.28823,2021/09/14 23:00:00+00,Wed 15 Sep 2021,3269,12382,136,3546987,3372291,238638,3785625,3610929,80.3928597443101,76.6829542396994,381
-7.6926,53.28823,2021/09/15 23:00:00+00,Thu 16 Sep 2021,1901,10581,113,3548888,3382872,238751,3787639,3621623,80.4356297544207,76.9100557730276,382
-7.6926,53.28823,2021/09/16 23:00:00+00,Fri 17 Sep 2021,2555,14603,92,3551443,3397475,238843,3790286,3636318,80.4918423744618,77.2221239451108,383
-7.6926,53.28823,2021/09/17 23:00:00+00,Sat 18 Sep 2021,2282,11219,45,3553725,3408694,238888,3792613,3647582,80.5412593623106,77.4613301982817,384
-7.6926,53.28823,2021/09/18 23:00:00+00,Sun 19 Sep 2021,1858,8485,13,3555583,3417179,238901,3794484,3656080,80.5809925742853,77.6417967056899,385
-7.6926,53.28823,2021/09/19 23:00:00+00,Mon 20 Sep 2021,950,5599,34,3556533,3422778,238935,3795468,3661713,80.6018891432768,77.7614210686259,386
-7.6926,53.28823,2021/09/20 23:00:00+00,Tue 21 Sep 2021,1460,6654,90,3557993,3429432,239025,3797018,3668457,80.6348054867085,77.9046390170798,387
-7.6926,53.28823,2021/09/21 23:00:00+00,Wed 22 Sep 2021,1892,8123,96,3559885,3437555,239121,3799006,3676676,80.6770233517035,78.0791805826702,388
-7.6926,53.28823,2021/09/22 23:00:00+00,Thu 23 Sep 2021,1692,8746,88,3561577,3446301,239209,3800786,3685510,80.7148240557734,78.2667825038804,389
-7.6926,53.28823,2021/09/23 23:00:00+00,Fri 24 Sep 2021,1904,7379,79,3563481,3453680,239288,3802769,3692968,80.7569357390154,78.4251632066635,390
-7.6926,53.28823,2021/09/24 23:00:00+00,Sat 25 Sep 2021,2412,6581,51,3565893,3460261,239339,3805232,3699600,80.809240870546,78.56600268385,391
-7.6926,53.28823,2021/09/25 23:00:00+00,Sun 26 Sep 2021,1538,7091,0,3567431,3467352,239339,3806770,3706691,80.8419023777705,78.7165896459624,392
-7.6926,53.28823,2021/09/26 23:00:00+00,Mon 27 Sep 2021,1173,3790,45,3568604,3471142,239384,3807988,3710526,80.8677682528026,78.7980310505177,393
-7.6926,53.28823,2021/09/27 23:00:00+00,Tue 28 Sep 2021,1442,5116,91,3570046,3476258,239475,3809521,3715733,80.9003235782741,78.9086087280976,394
-7.6926,53.28823,2021/09/28 23:00:00+00,Wed 29 Sep 2021,1649,3605,78,3571695,3479863,239553,3811248,3719416,80.9369987557622,78.9868222073615,395
-7.6926,53.28823,2021/09/29 23:00:00+00,Thu 30 Sep 2021,1279,3943,77,3572974,3483806,239630,3812604,3723436,80.9657952471773,79.0721923367779,396
-7.6926,53.28823,2021/09/30 23:00:00+00,Fri 01 Oct 2021,1837,5155,42,3574811,3488961,239672,3814483,3728633,81.0056983499568,79.1825576508519,397
-7.6926,53.28823,2021/10/01 23:00:00+00,Sat 02 Oct 2021,1707,4077,40,3576518,3493038,239712,3816230,3732750,81.0427982544569,79.2699877062766,398
-7.6926,53.28823,2021/10/02 23:00:00+00,Sun 03 Oct 2021,1194,3011,9,3577712,3496049,239721,3817433,3735770,81.06834558423,79.334121485092,399
-7.6926,53.28823,2021/10/03 23:00:00+00,Mon 04 Oct 2021,336,1222,17,3578048,3497271,239738,3817786,3737009,81.0758420159923,79.3604333234867,400
-7.6926,53.28823,2021/10/04 23:00:00+00,Tue 05 Oct 2021,961,2811,69,3579009,3500082,239807,3818816,3739889,81.0977154571114,79.4215940132179,401
-7.6926,53.28823,2021/10/05 23:00:00+00,Wed 06 Oct 2021,972,2550,36,3579981,3502632,239843,3819824,3742475,81.1191216985173,79.4765112158724,402
-7.6926,53.28823,2021/10/06 23:00:00+00,Thu 07 Oct 2021,1206,2683,44,3581187,3505315,239887,3821074,3745202,81.1456671367687,79.5344227439616,403
-7.6926,53.28823,2021/10/07 23:00:00+00,Fri 08 Oct 2021,975,2770,47,3582162,3508085,239934,3822096,3748019,81.167370687083,79.5942455436049,404
-7.6926,53.28823,2021/10/08 23:00:00+00,Sat 09 Oct 2021,730,2368,23,3582892,3510453,239957,3822849,3750410,81.1833616590856,79.6450216578922,405
-7.6926,53.28823,2021/10/09 23:00:00+00,Sun 10 Oct 2021,1501,3910,1,3584393,3514363,239958,3824351,3754321,81.2152586576885,79.7280770250931,406
-7.6926,53.28823,2021/10/10 23:00:00+00,Mon 11 Oct 2021,329,1108,16,3584722,3515471,239974,3824696,3755445,81.2225851986459,79.7519466831687,407
-7.6926,53.28823,2021/10/11 23:00:00+00,Tue 12 Oct 2021,562,1599,20,3585284,3517070,239994,3825278,3757064,81.2349447546957,79.7863283347919,408
-7.6926,53.28823,2021/10/12 23:00:00+00,Wed 13 Oct 2021,1003,2050,11,3586287,3519120,240005,3826292,3759125,81.2564784142052,79.8300964533808,409
-7.6926,53.28823,2021/10/13 23:00:00+00,Thu 14 Oct 2021,689,1574,7,3586976,3520694,240012,3826988,3760706,81.2712589142236,79.8636711236811,410
-7.6926,53.28823,2021/10/14 23:00:00+00,Fri 15 Oct 2021,948,2060,7,3587924,3522754,240019,3827943,3762773,81.2915396290477,79.9075666603736,411
-7.6926,53.28823,2021/10/15 23:00:00+00,Sat 16 Oct 2021,1367,2627,13,3589291,3525381,240032,3829323,3765413,81.3208457928772,79.9636306259605,412
-7.6926,53.28823,2021/10/16 23:00:00+00,Sun 17 Oct 2021,1701,2883,2,3590992,3528264,240034,3831026,3768298,81.3570112979509,80.0248974974447,413
-7.6926,53.28823,2021/10/17 23:00:00+00,Mon 18 Oct 2021,669,1224,4,3591661,3529488,240038,3831699,3769526,81.3713033619054,80.0509757359829,414
-7.6926,53.28823,2021/10/18 23:00:00+00,Tue 19 Oct 2021,1329,1779,14,3592990,3531267,240052,3833042,3771319,81.3998237807627,80.0890525126107,415
-7.6926,53.28823,2021/10/19 23:00:00+00,Wed 20 Oct 2021,2245,2301,0,3595235,3533568,240052,3835287,3773620,81.4474993878622,80.1379173553438,416
-7.6926,53.28823,2021/10/20 23:00:00+00,Thu 21 Oct 2021,1744,1807,11,3596979,3535375,240063,3837042,3775438,81.4847691831671,80.1765250407366,417
-7.6926,53.28823,2021/10/21 23:00:00+00,Fri 22 Oct 2021,1496,1908,2,3598475,3537283,240065,3838540,3777348,81.5165812363676,80.2170864703847,418
-7.6926,53.28823,2021/10/22 23:00:00+00,Sat 23 Oct 2021,2009,1680,1,3600484,3538963,240066,3840550,3779029,81.5592663010758,80.2527847757452,419
-7.6926,53.28823,2021/10/23 23:00:00+00,Sun 24 Oct 2021,1946,2182,2,3602430,3541145,240068,3842498,3781213,81.6006347120468,80.299164965458,420
-7.6926,53.28823,2021/10/24 23:00:00+00,Mon 25 Oct 2021,1216,834,2,3603646,3541979,240070,3843716,3782049,81.6265005870789,80.3169185545605,421
-7.6926,53.28823,2021/10/25 23:00:00+00,Tue 26 Oct 2021,1236,1197,6,3604882,3543176,240076,3844958,3783252,81.6528761345255,80.3424658843337,422
-7.6926,53.28823,2021/10/26 23:00:00+00,Wed 27 Oct 2021,1555,1405,5,3606437,3544581,240081,3846518,3784662,81.6860048414632,80.3724091386812,423
-7.6926,53.28823,2021/10/27 23:00:00+00,Thu 28 Oct 2021,2144,1672,4,3608581,3546253,240085,3848666,3786338,81.7316205225544,80.4080012622887,424
-7.6926,53.28823,2021/10/28 23:00:00+00,Fri 29 Oct 2021,2133,1347,0,3610714,3547600,240085,3850799,3787685,81.7769176583865,80.4366066265484,425
-7.6926,53.28823,2021/10/29 23:00:00+00,Sat 30 Oct 2021,2009,1438,0,3612723,3549038,240085,3852808,3789123,81.8195814867442,80.4671444987128,426
-7.6926,53.28823,2021/10/30 23:00:00+00,Sun 31 Oct 2021,1592,1315,0,3614315,3550353,240085,3854400,3790438,81.8533897569011,80.4950702997532,427
-7.6926,53.28823,2021/11/01 00:00:00+00,Mon 01 Nov 2021,261,260,2,3614576,3550613,240087,3854663,3790700,81.8589749171092,80.5006342236107,428
-7.6926,53.28823,2021/11/02 00:00:00+00,Tue 02 Nov 2021,1088,1077,9,3615664,3551690,240096,3855760,3791786,81.8822711937186,80.5236969003635,429
-7.6926,53.28823,2021/11/03 00:00:00+00,Wed 03 Nov 2021,2533,1842,6,3618197,3553532,240102,3858299,3793634,81.9361902878948,80.5629416762743,430
-7.6926,53.28823,2021/11/04 00:00:00+00,Thu 04 Nov 2021,1541,1255,1,3619738,3554787,240103,3859841,3794890,81.9689367405217,80.5896145326293,431
-7.6926,53.28823,2021/11/05 00:00:00+00,Fri 05 Nov 2021,1627,1070,2,3621365,3555857,240105,3861470,3795962,82.0035307556509,80.6123799004737,432
-7.6926,53.28823,2021/11/06 00:00:00+00,Sat 06 Nov 2021,1815,1338,5,3623180,3557195,240110,3863290,3797305,82.042180913745,80.640900319331,433
-7.6926,53.28823,2021/11/07 00:00:00+00,Sun 07 Nov 2021,700,767,0,3623880,3557962,240110,3863990,3798072,82.0570463591657,80.6571886002421,434
-7.6926,53.28823,2021/11/08 00:00:00+00,Mon 08 Nov 2021,512,518,2,3624392,3558480,240112,3864504,3798592,82.0679618433747,80.6682315025546,435
-7.6926,53.28823,2021/11/09 00:00:00+00,Tue 09 Nov 2021,1373,1043,1,3625765,3559523,240113,3865878,3799636,82.0971405891006,80.6904022525822,436
-7.6926,53.28823,2021/11/10 00:00:00+00,Wed 10 Nov 2021,1626,1329,0,3627391,3560852,240113,3867504,3800965,82.131670895178,80.718625362531,437
-7.6926,53.28823,2021/11/11 00:00:00+00,Thu 11 Nov 2021,1395,1090,2,3628786,3561942,240115,3868901,3802057,82.1613380769678,80.7418154573875,438
-7.6926,53.28823,2021/11/12 00:00:00+00,Fri 12 Nov 2021,1151,1120,5,3629937,3563062,240120,3870057,3803182,82.1858872982626,80.7657063518137,439
-7.6926,53.28823,2021/11/13 00:00:00+00,Sat 13 Nov 2021,1405,1359,0,3631342,3564421,240120,3871462,3804541,82.2157243708572,80.7945665522806,440
-7.6926,53.28823,2021/11/14 00:00:00+00,Sun 14 Nov 2021,1646,1801,0,3632988,3566222,240120,3873108,3806342,82.2506794039466,80.8328132197132,441
-7.6926,53.28823,2021/11/15 00:00:00+00,Mon 15 Nov 2021,1246,574,1,3634234,3566796,240121,3874355,3806917,82.2771611331462,80.8450241213088,442
-7.6926,53.28823,2021/11/16 00:00:00+00,Tue 16 Nov 2021,1317,1054,5,3635551,3567850,240126,3875677,3807976,82.3052355886408,80.8675134165954,443
-7.6926,53.28823,2021/11/17 00:00:00+00,Wed 17 Nov 2021,1515,1092,0,3637066,3568942,240126,3877192,3809068,82.3374086598015,80.8907035114518,444
-7.6926,53.28823,2021/11/18 00:00:00+00,Thu 18 Nov 2021,1664,2476,5,3638730,3571418,240131,3878861,3811549,82.3728521289548,80.9433908972932,445
-7.6926,53.28823,2021/11/19 00:00:00+00,Fri 19 Nov 2021,1177,1527,0,3639907,3572945,240131,3880038,3813076,82.3978473136123,80.975818804661,446
-7.6926,53.28823,2021/11/20 00:00:00+00,Sat 20 Nov 2021,1540,2923,12,3641447,3575868,240143,3881590,3816011,82.4308061297452,81.0381474936753,447
-7.6926,53.28823,2021/11/21 00:00:00+00,Sun 21 Nov 2021,1786,2754,0,3643233,3578622,240143,3883376,3818765,82.4687342519188,81.0966324032307,448
-7.6926,53.28823,2021/11/22 00:00:00+00,Mon 22 Nov 2021,707,493,2,3643940,3579115,240145,3884085,3819260,82.4837908244949,81.1071443967783,449
-7.6926,53.28823,2021/11/23 00:00:00+00,Tue 23 Nov 2021,2162,1563,6,3646102,3580678,240151,3886253,3820829,82.5298312325981,81.1404642308714,450
-7.6926,53.28823,2021/11/24 00:00:00+00,Wed 24 Nov 2021,1624,3119,2,3647726,3583797,240153,3887879,3823950,82.5643615386755,81.2067428810975,451
-7.6926,53.28823,2021/11/25 00:00:00+00,Thu 25 Nov 2021,993,1164,1,3648719,3584961,240154,3888873,3825115,82.585470471173,81.2314832295477,452
-7.6926,53.28823,2021/11/26 00:00:00+00,Fri 26 Nov 2021,1288,1082,12,3650007,3586043,240166,3890173,3826209,82.6130777269545,81.2547157971054,453
-7.6926,53.28823,2021/11/27 00:00:00+00,Sat 27 Nov 2021,1220,1553,5,3651227,3587596,240171,3891398,3827767,82.6390922564408,81.2878020313419,454
-7.6926,53.28823,2021/11/28 00:00:00+00,Sun 28 Nov 2021,1967,2252,0,3653194,3589848,240171,3893365,3830019,82.6808641580732,81.3356262928956,455
-7.6926,53.28823,2021/11/29 00:00:00+00,Mon 29 Nov 2021,544,980,1,3653738,3590828,240172,3893910,3831000,82.6924379691508,81.3564591528353,456
-7.6926,53.28823,2021/11/30 00:00:00+00,Tue 30 Nov 2021,1923,1621,6,3655661,3592449,240178,3895839,3832627,82.7334028894603,81.3910106952633,457
-7.6926,53.28823,2021/12/01 00:00:00+00,Wed 01 Dec 2021,1077,1352,1,3656738,3593801,240179,3896917,3833980,82.7562956754083,81.4197434776266,458
-7.6926,53.28823,2021/12/02 00:00:00+00,Thu 02 Dec 2021,1771,1397,0,3658509,3595198,240179,3898688,3835377,82.7939052523229,81.4494106594163,459
-7.6926,53.28823,2021/12/03 00:00:00+00,Fri 03 Dec 2021,1048,1167,3,3659557,3596365,240182,3899739,3836547,82.8162246568046,81.4742571896196,460
-7.6926,53.28823,2021/12/04 00:00:00+00,Sat 04 Dec 2021,1201,1696,1,3660758,3598061,240183,3900941,3838244,82.8417507502272,81.5102952765897,461
-7.6926,53.28823,2021/12/05 00:00:00+00,Sun 05 Dec 2021,1348,1772,1,3662106,3599833,240184,3902290,3840017,82.8703985871881,81.5479473262054,462
-7.6926,53.28823,2021/12/06 00:00:00+00,Mon 06 Dec 2021,932,1278,0,3663038,3601111,240184,3903222,3841295,82.8901908659483,81.5750873822736,463
-7.6926,53.28823,2021/12/07 00:00:00+00,Tue 07 Dec 2021,486,730,1,3663524,3601841,240185,3903709,3842026,82.900532968691,81.590611154563,464
-7.6926,53.28823,2021/12/08 00:00:00+00,Wed 08 Dec 2021,807,1492,0,3664331,3603333,240185,3904516,3843518,82.9176707036261,81.6222957896599,465
-7.6926,53.28823,2021/12/09 00:00:00+00,Thu 09 Dec 2021,795,1190,0,3665126,3604523,240185,3905311,3844708,82.934553602354,81.6475670468752,466
-7.6926,53.28823,2021/12/10 00:00:00+00,Fri 10 Dec 2021,893,1593,1,3666019,3606116,240186,3906205,3846302,82.9535388997914,81.6814177897334,467
-7.6926,53.28823,2021/12/11 00:00:00+00,Sat 11 Dec 2021,638,834,0,3666657,3606950,240186,3906843,3847136,82.9670876914749,81.6991289061347,468
-7.6926,53.28823,2021/12/12 00:00:00+00,Sun 12 Dec 2021,691,1188,0,3667348,3608138,240186,3907534,3848324,82.9817620097403,81.7243576906488,469
-7.6926,53.28823,2021/12/13 00:00:00+00,Mon 13 Dec 2021,725,1046,1,3668073,3609184,240187,3908260,3849371,82.9971796002767,81.7465921497282,470
-7.6926,53.28823,2021/12/14 00:00:00+00,Tue 14 Dec 2021,626,1186,1,3668699,3610370,240188,3908887,3850558,83.0104947921036,81.7717996978917,471
-7.6926,53.28823,2021/12/15 00:00:00+00,Wed 15 Dec 2021,798,1229,1,3669497,3611599,240189,3909686,3851788,83.0274626362338,81.797920409131,472
-7.6926,53.28823,2021/12/16 00:00:00+00,Thu 16 Dec 2021,1064,1517,7,3670561,3613116,240196,3910757,3853312,83.0502067677276,81.8302846074471,473
-7.6926,53.28823,2021/12/17 00:00:00+00,Fri 17 Dec 2021,1214,2433,1,3671775,3615549,240197,3911972,3855746,83.076008933708,81.8819738848102,474
-7.6926,53.28823,2021/12/18 00:00:00+00,Sat 18 Dec 2021,1262,1172,0,3673037,3616721,240197,3913234,3856918,83.1028092081666,81.9068628877147,475
-7.6926,53.28823,2021/12/19 00:00:00+00,Sun 19 Dec 2021,561,878,0,3673598,3617599,240197,3913795,3857796,83.1147228008538,81.9255084035425,476
