X,Y,VaccinationDate,VaccineText,Dose1,Dose2,SingleDose,Dose1Cum,Dose2Cum,SingleDoseCum,PartiallyVacc,FullyVacc,PartialPercent,FullyPercent,ObjectId
-7.6926,53.28823,2022/03/09 00:00:00+00,Wed 09 Mar 2022,127,343,0,3829456,3757205,240710,4070166,3997915,86.4354721806993,84.9011246134188,1
-7.6926,53.28823,2021/11/20 00:00:00+00,Sat 20 Nov 2021,1543,2929,12,3645450,3579761,240617,3886067,3820378,82.5258812713863,81.1308866367503,2
-7.6926,53.28823,2020/12/28 00:00:00+00,Mon 28 Dec 2020,220,18,0,220,18,0,220,18,0.00467199713224321,0.000382254310819899,3
-7.6926,53.28823,2021/04/15 23:00:00+00,Fri 16 Apr 2021,27973,9832,1,883527,374676,234,883761,374910,18.7678584435836,7.96172020386047,4
-7.6926,53.28823,2020/12/29 00:00:00+00,Tue 29 Dec 2020,76,2,0,296,20,0,296,20,0.00628595977792723,0.00042472701202211,5
-7.6926,53.28823,2022/03/10 00:00:00+00,Thu 10 Mar 2022,257,507,0,3829713,3757712,240710,4070423,3998422,86.4409299228037,84.9118914431735,6
-7.6926,53.28823,2021/11/21 00:00:00+00,Sun 21 Nov 2021,1786,2759,0,3647236,3582520,240617,3887853,3823137,82.5638093935599,81.1894777280588,7
-7.6926,53.28823,2021/04/16 23:00:00+00,Sat 17 Apr 2021,15846,4551,3,899373,379227,237,899610,379464,19.1044333642605,8.05843054449791,8
-7.6926,53.28823,2020/12/30 00:00:00+00,Wed 30 Dec 2020,1057,1,0,1353,21,0,1353,21,0.0287327823632958,0.000445963362623216,9
-7.6926,53.28823,2022/03/11 00:00:00+00,Fri 11 Mar 2022,493,2181,0,3830206,3759893,240710,4070916,4000603,86.4513994436501,84.9582079238346,10
-7.6926,53.28823,2021/11/22 00:00:00+00,Mon 22 Nov 2021,715,501,2,3647951,3583021,240619,3888570,3823640,82.5790358569409,81.2001596124111,11
-7.6926,53.28823,2021/04/17 23:00:00+00,Sun 18 Apr 2021,1072,485,0,900445,379712,237,900682,379949,19.1271987321049,8.06873017453944,12
-7.6926,53.28823,2020/12/31 00:00:00+00,Thu 31 Dec 2020,1032,1,0,2385,22,0,2385,22,0.0506486961836367,0.000467199713224322,13
-7.6926,53.28823,2022/03/12 00:00:00+00,Sat 12 Mar 2022,473,2387,2,3830679,3762280,240712,4071391,4002992,86.4614867101856,85.0089415654206,14
-7.6926,53.28823,2021/11/23 00:00:00+00,Tue 23 Nov 2021,2156,1577,7,3650107,3584598,240626,3890733,3825224,82.6249700832911,81.2337979917633,15
-7.6926,53.28823,2021/04/18 23:00:00+00,Mon 19 Apr 2021,6740,2256,0,907185,381968,237,907422,382205,19.2703317351564,8.11663938149553,16
-7.6926,53.28823,2021/01/01 00:00:00+00,Fri 01 Jan 2021,812,0,0,3197,22,0,3197,22,0.0678926128717344,0.000467199713224322,17
-7.6926,53.28823,2022/03/13 00:00:00+00,Sun 13 Mar 2022,358,1082,0,3831037,3763362,240712,4071749,4004074,86.4690893237008,85.031919296771,18
-7.6926,53.28823,2021/11/24 00:00:00+00,Wed 24 Nov 2021,1624,3130,2,3651731,3587728,240628,3892359,3828356,82.6595003893685,81.3003102418459,19
-7.6926,53.28823,2021/04/19 23:00:00+00,Tue 20 Apr 2021,15088,7314,1,922273,389282,238,922511,389520,19.5907670293765,8.27198328614262,20
-7.6926,53.28823,2021/01/02 00:00:00+00,Sat 02 Jan 2021,1016,0,0,4213,22,0,4213,22,0.0894687450824576,0.000467199713224322,21
-7.6926,53.28823,2022/03/14 00:00:00+00,Mon 14 Mar 2022,109,120,0,3831146,3763482,240712,4071858,4004194,86.4714040859163,85.0344676588431,22
-7.6926,53.28823,2021/11/25 00:00:00+00,Thu 25 Nov 2021,984,1167,1,3652715,3588895,240629,3893344,3829524,82.6804181947106,81.325114299348,23
-7.6926,53.28823,2021/04/20 23:00:00+00,Wed 21 Apr 2021,26718,9876,4,948991,399158,242,949233,399400,20.1582447901392,8.48179843008154,24
-7.6926,53.28823,2021/01/03 00:00:00+00,Sun 03 Jan 2021,20,2,1,4233,24,1,4234,25,0.0899147084450808,0.000530908765027638,25
-7.6926,53.28823,2022/03/15 00:00:00+00,Tue 15 Mar 2022,221,757,0,3831367,3764239,240712,4072079,4004951,86.4760973193992,85.0505435762482,26
-7.6926,53.28823,2021/11/26 00:00:00+00,Fri 26 Nov 2021,1288,1095,12,3654003,3589990,240641,3894644,3830631,82.708025450492,81.3486229394634,27
-7.6926,53.28823,2021/01/04 00:00:00+00,Mon 04 Jan 2021,1187,3,0,5420,27,1,5421,28,0.115122256608593,0.000594617816830955,28
-7.6926,53.28823,2021/04/21 23:00:00+00,Thu 22 Apr 2021,31621,12180,1,980612,411338,243,980855,411581,20.8297806688474,8.74047841675361,29
-7.6926,53.28823,2022/03/16 00:00:00+00,Wed 16 Mar 2022,196,797,0,3831563,3765036,240712,4072275,4005748,86.480259644117,85.0674689476772,30
-7.6926,53.28823,2022/03/18 00:00:00+00,Fri 18 Mar 2022,1,6,0,3831564,3765042,240712,4072276,4005754,86.4802808804676,85.0675963657808,31
-7.6926,53.28823,2021/01/05 00:00:00+00,Tue 05 Jan 2021,3528,11,0,8948,38,1,8949,39,0.190044101529293,0.000828217673443115,32
-7.6926,53.28823,2021/11/27 00:00:00+00,Sat 27 Nov 2021,1201,1558,6,3655204,3591548,240647,3895851,3832195,82.7336577256676,81.3818365918036,33
-7.6926,53.28823,2021/04/22 23:00:00+00,Fri 23 Apr 2021,33614,12351,3,1014226,423689,246,1014472,423935,21.5436830670047,9.00283229207967,34
-7.6926,53.28823,2022/03/19 00:00:00+00,Sat 19 Mar 2022,743,2779,0,3832307,3767821,240712,4073019,4008533,86.4960594889642,85.1266121841013,35
-7.6926,53.28823,2021/11/28 00:00:00+00,Sun 28 Nov 2021,1960,2255,0,3657164,3593803,240647,3897811,3834450,82.7752809728457,81.4297245624091,36
-7.6926,53.28823,2021/01/06 00:00:00+00,Wed 06 Jan 2021,6776,11,0,15724,49,1,15725,50,0.333941613202384,0.00106181753005528,37
-7.6926,53.28823,2021/04/23 23:00:00+00,Sat 24 Apr 2021,23699,6988,2,1037925,430677,248,1038173,430925,22.0470058126015,9.1512743827814,38
-7.6926,53.28823,2022/03/20 00:00:00+00,Sun 20 Mar 2022,394,1401,0,3832701,3769222,240712,4073413,4009934,86.5044266111011,85.1563643112935,39
-7.6926,53.28823,2021/11/29 00:00:00+00,Mon 29 Nov 2021,540,984,1,3657704,3594787,240648,3898352,3835435,82.7867698385209,81.4506423677512,40
-7.6926,53.28823,2021/04/24 23:00:00+00,Sun 25 Apr 2021,9748,298,2,1047673,430975,250,1047923,431225,22.2540602309623,9.15764528796173,41
-7.6926,53.28823,2021/01/07 00:00:00+00,Thu 07 Jan 2021,11724,8,0,27448,57,1,27449,58,0.582916587649745,0.00123170833486412,42
-7.6926,53.28823,2022/03/21 00:00:00+00,Mon 21 Mar 2022,54,112,0,3832755,3769334,240712,4073467,4010046,86.5055733740335,85.1587427825608,43
-7.6926,53.28823,2021/11/30 00:00:00+00,Tue 30 Nov 2021,1918,1632,6,3659622,3596419,240654,3900276,3837073,82.8276285770774,81.4854275100358,44
-7.6926,53.28823,2021/04/25 23:00:00+00,Mon 26 Apr 2021,15586,3053,3,1063259,434028,253,1063512,434281,22.5851137004829,9.22254357539871,45
-7.6926,53.28823,2022/03/22 00:00:00+00,Tue 22 Mar 2022,137,574,0,3832892,3769908,240712,4073604,4010620,86.5084827540659,85.1709324478058,46
-7.6926,53.28823,2021/01/08 00:00:00+00,Fri 08 Jan 2021,12680,5,0,40128,62,1,40129,63,0.852193513271764,0.00133789008786965,47
-7.6926,53.28823,2021/12/01 00:00:00+00,Wed 01 Dec 2021,1076,1362,2,3660698,3597781,240656,3901354,3838437,82.8505213630254,81.5143938922557,48
-7.6926,53.28823,2021/04/26 23:00:00+00,Tue 27 Apr 2021,25916,7807,9,1089175,441835,262,1089437,442097,23.1356660898166,9.38852689169695,49
-7.6926,53.28823,2022/03/23 00:00:00+00,Wed 23 Mar 2022,101,219,0,3832993,3770127,240712,4073705,4010839,86.5106276254766,85.1755832085875,50
-7.6926,53.28823,2021/12/02 00:00:00+00,Thu 02 Dec 2021,1768,1397,0,3662466,3599178,240656,3903122,3839834,82.8880672308882,81.5440610740454,51
-7.6926,53.28823,2021/08/02 23:00:00+00,Tue 03 Aug 2021,17333,25437,1110,3203101,2663585,223230,3426331,2886815,72.7627663914365,61.3054154605304,52
-7.6926,53.28823,2021/01/09 00:00:00+00,Sat 09 Jan 2021,8074,7,0,48202,69,1,48203,70,1.02365580802509,0.00148654454207739,53
-7.6926,53.28823,2021/08/03 23:00:00+00,Wed 04 Aug 2021,22098,17288,1575,3225199,2680873,224805,3450004,2905678,73.2654945192165,61.7059967419191,54
-7.6926,53.28823,2021/04/27 23:00:00+00,Wed 28 Apr 2021,26030,8599,5,1115205,450434,267,1115472,450701,23.6885544777164,9.57124445226886,55
-7.6926,53.28823,2022/03/24 00:00:00+00,Thu 24 Mar 2022,148,239,0,3833141,3770366,240712,4073853,4011078,86.5137706053655,85.1806586963811,56
-7.6926,53.28823,2021/12/03 00:00:00+00,Fri 03 Dec 2021,1044,1167,2,3663510,3600345,240658,3904168,3841003,82.9102804536169,81.5688863678981,57
-7.6926,53.28823,2022/03/25 00:00:00+00,Fri 25 Mar 2022,435,1624,0,3833576,3771990,240712,4074288,4012702,86.523008417877,85.2151465297573,58
-7.6926,53.28823,2021/08/04 23:00:00+00,Thu 05 Aug 2021,13517,30027,1420,3238716,2710900,226225,3464941,2937125,73.5827018881452,62.3738162592721,59
-7.6926,53.28823,2021/01/10 00:00:00+00,Sun 10 Jan 2021,4780,4,1,52982,73,2,52984,75,1.12518680024897,0.00159272629508291,60
-7.6926,53.28823,2021/04/28 23:00:00+00,Thu 29 Apr 2021,31692,11329,6,1146897,461763,273,1147170,462036,24.3617043190702,9.81195848633239,61
-7.6926,53.28823,2021/12/04 00:00:00+00,Sat 04 Dec 2021,1204,1696,1,3664714,3602041,240659,3905373,3842700,82.9358702560913,81.6049244548682,62
-7.6926,53.28823,2022/03/26 00:00:00+00,Sat 26 Mar 2022,874,1848,0,3834450,3773838,240712,4075162,4014550,86.5415689883024,85.2543913056682,63
-7.6926,53.28823,2021/08/05 23:00:00+00,Fri 06 Aug 2021,12198,24733,948,3250914,2735633,227173,3478087,2962806,73.8618749531473,62.919186979059,64
-7.6926,53.28823,2021/01/11 00:00:00+00,Mon 11 Jan 2021,8339,6,0,61321,79,2,61323,81,1.30227672791159,0.00172014439868955,65
-7.6926,53.28823,2021/04/29 23:00:00+00,Fri 30 Apr 2021,36112,13525,8,1183009,475288,281,1183290,475569,25.1287613027822,10.0993500190172,66
-7.6926,53.28823,2021/12/05 00:00:00+00,Sun 05 Dec 2021,1347,1772,2,3666061,3603813,240661,3906722,3844474,82.9645180930522,81.6425977408346,67
-7.6926,53.28823,2022/03/27 00:00:00+00,Sun 27 Mar 2022,380,802,0,3834830,3774640,240712,4075542,4015352,86.5496388015308,85.2714228588503,68
-7.6926,53.28823,2021/08/06 23:00:00+00,Sat 07 Aug 2021,6326,8449,583,3257240,2744082,227756,3484996,2971838,74.0085968994503,63.1109936976882,69
-7.6926,53.28823,2021/01/12 00:00:00+00,Tue 12 Jan 2021,8880,10,0,70201,89,2,70203,91,1.49085552124941,0.0019325079047006,70
-7.6926,53.28823,2021/04/30 23:00:00+00,Sat 01 May 2021,16576,6688,18,1199585,481976,299,1199884,482275,25.4811573046569,10.2417609861482,71
-7.6926,53.28823,2021/12/06 00:00:00+00,Mon 06 Dec 2021,935,1283,0,3666996,3605096,240661,3907657,3845757,82.9843740808642,81.6698439786558,72
-7.6926,53.28823,2022/03/27 23:00:00+00,Mon 28 Mar 2022,43,51,0,3834873,3774691,240712,4075585,4015403,86.5505519646067,85.2725059127309,73
-7.6926,53.28823,2021/08/07 23:00:00+00,Sun 08 Aug 2021,8622,11966,153,3265862,2756048,227909,3493771,2983957,74.194945875975,63.368357030623,74
-7.6926,53.28823,2021/01/13 00:00:00+00,Wed 13 Jan 2021,9878,4,0,80079,93,2,80081,95,1.70062819248713,0.00201745330710502,75
-7.6926,53.28823,2021/05/01 23:00:00+00,Sun 02 May 2021,12462,909,15,1212047,482885,314,1212361,483199,25.7461232511069,10.2613833741036,76
-7.6926,53.28823,2021/12/07 00:00:00+00,Tue 07 Dec 2021,485,736,2,3667481,3605832,240663,3908144,3846495,82.9947161836069,81.6855164053994,77
-7.6926,53.28823,2022/03/28 23:00:00+00,Tue 29 Mar 2022,140,192,3,3835013,3774883,240715,4075728,4015598,86.5535887627426,85.2766470010981,78
-7.6926,53.28823,2021/08/08 23:00:00+00,Mon 09 Aug 2021,5529,23024,600,3271391,2779072,228509,3499900,3007581,74.3251034688092,63.8700445772236,79
-7.6926,53.28823,2021/01/14 00:00:00+00,Thu 14 Jan 2021,8081,4,0,88160,97,2,88162,99,1.87223914169466,0.00210239870950945,80
-7.6926,53.28823,2021/05/02 23:00:00+00,Mon 03 May 2021,14259,922,21,1226306,483807,335,1226641,484142,26.0493783376907,10.2814092527204,81
-7.6926,53.28823,2021/12/08 00:00:00+00,Wed 08 Dec 2021,801,1502,1,3668282,3607334,240664,3908946,3847998,83.011747736789,81.7174346403528,82
-7.6926,53.28823,2022/03/29 23:00:00+00,Wed 30 Mar 2022,109,134,0,3835122,3775017,240715,4075837,4015732,86.5559035249581,85.2794926720787,83
-7.6926,53.28823,2021/08/09 23:00:00+00,Tue 10 Aug 2021,9342,25991,714,3280733,2805063,229223,3509956,3034286,74.5386562104539,64.4371613200261,84
-7.6926,53.28823,2021/01/15 00:00:00+00,Fri 15 Jan 2021,7691,2,0,95851,99,2,95853,101,2.03556791416777,0.00214487141071166,85
-7.6926,53.28823,2021/05/03 23:00:00+00,Tue 04 May 2021,26660,6785,10,1252966,490592,345,1253311,490937,26.6157518082222,10.4257102550549,86
-7.6926,53.28823,2021/12/09 00:00:00+00,Thu 09 Dec 2021,798,1198,0,3669080,3608532,240664,3909744,3849196,83.0286943445687,81.742875788373,87
-7.6926,53.28823,2022/03/30 23:00:00+00,Thu 31 Mar 2022,228,356,0,3835350,3775373,240715,4076065,4016088,86.5607454128952,85.2870528128927,88
-7.6926,53.28823,2021/08/10 23:00:00+00,Wed 11 Aug 2021,7003,31228,663,3287736,2836291,229886,3517622,3066177,74.701454074162,65.1144097770459,89
-7.6926,53.28823,2021/01/16 00:00:00+00,Sat 16 Jan 2021,5232,3,0,101083,102,2,101085,104,2.14667650051275,0.00220858046251497,90
-7.6926,53.28823,2021/05/04 23:00:00+00,Wed 05 May 2021,32106,13457,69,1285072,504049,414,1285486,504463,27.2990313888127,10.7129531332855,91
-7.6926,53.28823,2021/12/10 00:00:00+00,Fri 10 Dec 2021,891,1602,1,3669971,3610134,240665,3910636,3850799,83.0476371693049,81.7769176583865,92
-7.6926,53.28823,2022/03/31 23:00:00+00,Fri 01 Apr 2022,308,902,0,3835658,3776275,240715,4076373,4016990,86.5672862088803,85.3062080011349,93
-7.6926,53.28823,2021/08/11 23:00:00+00,Thu 12 Aug 2021,6759,38280,862,3294495,2874571,230748,3525243,3105319,74.863296302093,65.9456430122744,94
-7.6926,53.28823,2021/01/17 00:00:00+00,Sun 17 Jan 2021,1112,4,0,102195,106,2,102197,108,2.17029132238118,0.0022935258649194,95
-7.6926,53.28823,2021/05/05 23:00:00+00,Thu 06 May 2021,37282,14377,132,1322354,518426,546,1322900,518972,28.0935682102025,11.0210713441569,96
-7.6926,53.28823,2021/12/11 00:00:00+00,Sat 11 Dec 2021,639,836,1,3670610,3610970,240666,3911276,3851636,83.0612284336896,81.7946924838397,97
-7.6926,53.28823,2022/04/01 23:00:00+00,Sat 02 Apr 2022,730,1538,0,3836388,3777813,240715,4077103,4018528,86.5827887448191,85.3388695083594,98
-7.6926,53.28823,2022/04/02 23:00:00+00,Sun 03 Apr 2022,537,816,0,3836925,3778629,240715,4077640,4019344,86.5941926650919,85.3561983704499,99
-7.6926,53.28823,2022/04/03 23:00:00+00,Mon 04 Apr 2022,49,51,0,3836974,3778680,240715,4077689,4019395,86.5952332462714,85.3572814243305,100
-7.6926,53.28823,2022/04/04 23:00:00+00,Tue 05 Apr 2022,130,165,0,3837104,3778845,240715,4077819,4019560,86.5979939718495,85.3607854221797,101
-7.6926,53.28823,2022/04/05 23:00:00+00,Wed 06 Apr 2022,159,209,0,3837263,3779054,240715,4077978,4019769,86.6013705515951,85.3652238194553,102
-7.6926,53.28823,2022/04/06 23:00:00+00,Thu 07 Apr 2022,120,174,0,3837383,3779228,240715,4078098,4019943,86.6039189136672,85.3689189444599,103
-7.6926,53.28823,2022/04/07 23:00:00+00,Fri 08 Apr 2022,266,417,0,3837649,3779645,240715,4078364,4020360,86.6095677829271,85.3777745026606,104
-7.6926,53.28823,2022/04/08 23:00:00+00,Sat 09 Apr 2022,561,1017,0,3838210,3780662,240715,4078925,4021377,86.6214813756143,85.3993718712219,105
-7.6926,53.28823,2022/04/09 23:00:00+00,Sun 10 Apr 2022,413,719,0,3838623,3781381,240715,4079338,4022096,86.6302519884126,85.4146408073041,106
-7.6926,53.28823,2022/04/10 23:00:00+00,Mon 11 Apr 2022,71,93,0,3838694,3781474,240715,4079409,4022189,86.6317597693053,85.41661578791,107
-7.6926,53.28823,2022/04/11 23:00:00+00,Tue 12 Apr 2022,195,176,0,3838889,3781650,240715,4079604,4022365,86.6359008576725,85.4203533856158,108
-7.6926,53.28823,2022/04/12 23:00:00+00,Wed 13 Apr 2022,144,233,0,3839033,3781883,240715,4079748,4022598,86.6389588921591,85.4253014553059,109
-7.6926,53.28823,2022/04/13 23:00:00+00,Thu 14 Apr 2022,361,427,0,3839394,3782310,240715,4080109,4023025,86.646625214726,85.4343693770125,110
-7.6926,53.28823,2022/04/14 23:00:00+00,Fri 15 Apr 2022,447,989,0,3839841,3783299,240715,4080556,4024014,86.6561178634447,85.455372127757,111
-7.6926,53.28823,2022/04/15 23:00:00+00,Sat 16 Apr 2022,42,88,0,3839883,3783387,240715,4080598,4024102,86.65700979017,85.4572409266099,112
-7.6926,53.28823,2022/04/16 23:00:00+00,Sun 17 Apr 2022,1,0,0,3839884,3783387,240715,4080599,4024102,86.6570310265206,85.4572409266099,113
-7.6926,53.28823,2022/04/17 23:00:00+00,Mon 18 Apr 2022,36,61,0,3839920,3783448,240715,4080635,4024163,86.6577955351422,85.4585363439966,114
-7.6926,53.28823,2022/04/18 23:00:00+00,Tue 19 Apr 2022,219,268,1,3840139,3783716,240716,4080855,4024432,86.6624675322745,85.4642489223083,115
-7.6926,53.28823,2022/04/19 23:00:00+00,Wed 20 Apr 2022,250,605,0,3840389,3784321,240716,4081105,4025037,86.6677766199248,85.477096914422,116
-7.6926,53.28823,2022/04/20 23:00:00+00,Thu 21 Apr 2022,172,237,0,3840561,3784558,240716,4081277,4025274,86.6714292722281,85.4821299295144,117
-7.6926,53.28823,2022/04/21 23:00:00+00,Fri 22 Apr 2022,198,251,0,3840759,3784809,240716,4081475,4025525,86.6756340696472,85.4874602535153,118
-7.6926,53.28823,2022/04/22 23:00:00+00,Sat 23 Apr 2022,324,1010,0,3841083,3785819,240716,4081799,4026535,86.6825146472419,85.5089089676224,119
-7.6926,53.28823,2022/04/23 23:00:00+00,Sun 24 Apr 2022,181,253,0,3841264,3786072,240716,4081980,4026788,86.6863584267007,85.5142817643245,120
-7.6926,53.28823,2022/04/24 23:00:00+00,Mon 25 Apr 2022,41,57,0,3841305,3786129,240716,4082021,4026845,86.6872291170754,85.5154922363088,121
-7.6926,53.28823,2022/04/25 23:00:00+00,Tue 26 Apr 2022,144,238,0,3841449,3786367,240716,4082165,4027083,86.6902871515619,85.5205464877518,122
-7.6926,53.28823,2022/04/26 23:00:00+00,Wed 27 Apr 2022,122,208,0,3841571,3786575,240716,4082287,4027291,86.6928779863353,85.5249636486769,123
-7.6926,53.28823,2022/04/27 23:00:00+00,Thu 28 Apr 2022,106,128,0,3841677,3786703,240716,4082393,4027419,86.695129039499,85.5276819015538,124
-7.6926,53.28823,2022/04/28 23:00:00+00,Fri 29 Apr 2022,176,222,0,3841853,3786925,240716,4082569,4027641,86.6988666372048,85.5323963713872,125
-7.6926,53.28823,2022/04/29 23:00:00+00,Sat 30 Apr 2022,281,723,0,3842134,3787648,240716,4082850,4028364,86.7048340517237,85.5477502528719,126
-7.6926,53.28823,2022/04/30 23:00:00+00,Sun 01 May 2022,186,746,0,3842320,3788394,240716,4083036,4029110,86.7087840129355,85.5635925704203,127
-7.6926,53.28823,2022/05/01 23:00:00+00,Mon 02 May 2022,11,26,0,3842331,3788420,240716,4083047,4029136,86.7090176127921,85.5641447155359,128
-7.6926,53.28823,2022/05/02 23:00:00+00,Tue 03 May 2022,100,117,0,3842431,3788537,240716,4083147,4029253,86.7111412478522,85.5666293685562,129
-7.6926,53.28823,2022/05/03 23:00:00+00,Wed 04 May 2022,128,128,0,3842559,3788665,240716,4083275,4029381,86.7138595007292,85.5693476214332,130
-7.6926,53.28823,2022/05/04 23:00:00+00,Thu 05 May 2022,119,163,0,3842678,3788828,240716,4083394,4029544,86.7163866264507,85.5728091465812,131
-7.6926,53.28823,2022/05/05 23:00:00+00,Fri 06 May 2022,143,258,0,3842821,3789086,240716,4083537,4029802,86.7194234245866,85.5782881250362,132
-7.6926,53.28823,2022/05/06 23:00:00+00,Sat 07 May 2022,441,1083,0,3843262,3790169,240716,4083978,4030885,86.7287886552017,85.6012870927372,133
-7.6926,53.28823,2022/05/07 23:00:00+00,Sun 08 May 2022,273,437,0,3843535,3790606,240716,4084251,4031322,86.7345861789158,85.6105673779499,134
-7.6926,53.28823,2022/05/08 23:00:00+00,Mon 09 May 2022,28,31,0,3843563,3790637,240716,4084279,4031353,86.7351807967327,85.6112257048186,135
-7.6926,53.28823,2022/05/09 23:00:00+00,Tue 10 May 2022,88,98,1,3843651,3790735,240717,4084368,4031452,86.7370708319362,85.6133281035281,136
-7.6926,53.28823,2022/05/10 23:00:00+00,Wed 11 May 2022,127,131,0,3843778,3790866,240717,4084495,4031583,86.7397678484625,85.6161100654568,137
-7.6926,53.28823,2022/05/11 23:00:00+00,Thu 12 May 2022,249,397,0,3844027,3791263,240717,4084744,4031980,86.7450556997622,85.6245408966454,138
-7.6926,53.28823,2022/05/12 23:00:00+00,Fri 13 May 2022,184,324,0,3844211,3791587,240717,4084928,4032304,86.7489631882728,85.6314214742402,139
-7.6926,53.28823,2022/05/13 23:00:00+00,Sat 14 May 2022,333,632,0,3844544,3792219,240717,4085261,4032936,86.7560348930229,85.6448428478201,140
-7.6926,53.28823,2022/05/14 23:00:00+00,Sun 15 May 2022,169,254,0,3844713,3792473,240717,4085430,4033190,86.7596238362745,85.6502368808728,141
-7.6926,53.28823,2022/05/15 23:00:00+00,Mon 16 May 2022,32,39,0,3844745,3792512,240717,4085462,4033229,86.7603033994938,85.6510650985462,142
-7.6926,53.28823,2022/05/16 23:00:00+00,Tue 17 May 2022,104,94,0,3844849,3792606,240717,4085566,4033323,86.7625119799563,85.6530613155027,143
-7.6926,53.28823,2022/05/17 23:00:00+00,Wed 18 May 2022,105,119,0,3844954,3792725,240717,4085671,4033442,86.7647417967694,85.6555884412243,144
-7.6926,53.28823,2022/05/18 23:00:00+00,Thu 19 May 2022,98,102,0,3845052,3792827,240717,4085769,4033544,86.7668229591283,85.6577545489856,145
-7.6926,53.28823,2022/05/19 23:00:00+00,Fri 20 May 2022,129,206,0,3845181,3793033,240717,4085898,4033750,86.7695624483559,85.6621292372094,146
-7.6926,53.28823,2022/05/20 23:00:00+00,Sat 21 May 2022,392,761,0,3845573,3793794,240717,4086290,4034511,86.7778870977915,85.6782901000168,147
-7.6926,53.28823,2022/05/21 23:00:00+00,Sun 22 May 2022,233,409,0,3845806,3794203,240717,4086523,4034920,86.7828351674815,85.6869757674127,148
-7.6926,53.28823,2022/05/22 23:00:00+00,Mon 23 May 2022,30,34,0,3845836,3794237,240717,4086553,4034954,86.7834722579996,85.6876978033331,149
-7.6926,53.28823,2022/05/23 23:00:00+00,Tue 24 May 2022,79,82,0,3845915,3794319,240717,4086632,4035036,86.7851499296971,85.6894391840824,150
-7.6926,53.28823,2022/05/24 23:00:00+00,Wed 25 May 2022,91,129,0,3846006,3794448,240717,4086723,4035165,86.7870824376018,85.69217867331,151
-7.6926,53.28823,2022/05/25 23:00:00+00,Thu 26 May 2022,132,155,0,3846138,3794603,240717,4086855,4035320,86.7898856358811,85.6954703076531,152
-7.6926,53.28823,2022/05/26 23:00:00+00,Fri 27 May 2022,97,151,0,3846235,3794754,240717,4086952,4035471,86.7919455618894,85.6986769965939,153
-7.6926,53.28823,2022/05/27 23:00:00+00,Sat 28 May 2022,336,578,0,3846571,3795332,240717,4087288,4036049,86.7990809756914,85.7109516072413,154
-7.6926,53.28823,2022/05/28 23:00:00+00,Sun 29 May 2022,181,348,0,3846752,3795680,240717,4087469,4036397,86.8029247551502,85.7183418572505,155
-7.6926,53.28823,2022/05/29 23:00:00+00,Mon 30 May 2022,14,21,0,3846766,3795701,240717,4087483,4036418,86.8032220640586,85.7187878206132,156
-7.6926,53.28823,2022/05/30 23:00:00+00,Tue 31 May 2022,65,78,1,3846831,3795779,240718,4087549,4036497,86.8046236631983,85.7204654923106,157
-7.6926,53.28823,2022/05/31 23:00:00+00,Wed 01 Jun 2022,64,100,0,3846895,3795879,240718,4087613,4036597,86.8059827896367,85.7225891273708,158
-7.6926,53.28823,2022/06/01 23:00:00+00,Thu 02 Jun 2022,121,132,0,3847016,3796011,240718,4087734,4036729,86.8085523880595,85.7253923256501,159
-7.6926,53.28823,2022/06/02 23:00:00+00,Fri 03 Jun 2022,64,141,0,3847080,3796152,240718,4087798,4036870,86.809911514498,85.7283866510848,160
-7.6926,53.28823,2022/06/03 23:00:00+00,Sat 04 Jun 2022,305,606,0,3847385,3796758,240718,4088103,4037476,86.8163886014313,85.7412558795491,161
-7.6926,53.28823,2022/06/04 23:00:00+00,Sun 05 Jun 2022,142,273,0,3847527,3797031,240718,4088245,4037749,86.8194041632166,85.7470534032632,162
-7.6926,53.28823,2022/06/05 23:00:00+00,Mon 06 Jun 2022,3,6,0,3847530,3797037,240718,4088248,4037755,86.8194678722684,85.7471808213668,163
-7.6926,53.28823,2022/06/06 23:00:00+00,Tue 07 Jun 2022,29,49,0,3847559,3797086,240718,4088277,4037804,86.8200837264359,85.7482214025463,164
-7.6926,53.28823,2022/06/07 23:00:00+00,Wed 08 Jun 2022,42,75,0,3847601,3797161,240718,4088319,4037879,86.8209756531611,85.7498141288414,165
-7.6926,53.28823,2022/06/08 23:00:00+00,Thu 09 Jun 2022,85,121,0,3847686,3797282,240718,4088404,4038000,86.8227807429622,85.7523837272641,166
-7.6926,53.28823,2022/06/09 23:00:00+00,Fri 10 Jun 2022,58,107,0,3847744,3797389,240718,4088462,4038107,86.8240124512971,85.7546560167784,167
-7.6926,53.28823,2022/06/10 23:00:00+00,Sat 11 Jun 2022,190,558,0,3847934,3797947,240718,4088652,4038665,86.8280473579113,85.7665059004138,168
-7.6926,53.28823,2022/06/11 23:00:00+00,Sun 12 Jun 2022,146,283,0,3848080,3798230,240718,4088798,4038948,86.8311478650991,85.7725157876339,169
-7.6926,53.28823,2022/06/12 23:00:00+00,Mon 13 Jun 2022,20,39,0,3848100,3798269,240718,4088818,4038987,86.8315725921111,85.7733440053074,170
-7.6926,53.28823,2022/06/13 23:00:00+00,Tue 14 Jun 2022,39,50,0,3848139,3798319,240718,4088857,4039037,86.8324008097845,85.7744058228374,171
-7.6926,53.28823,2022/06/14 23:00:00+00,Wed 15 Jun 2022,69,122,0,3848208,3798441,240718,4088926,4039159,86.833866117976,85.7769966576108,172
-7.6926,53.28823,2022/06/15 23:00:00+00,Thu 16 Jun 2022,83,80,0,3848291,3798521,240718,4089009,4039239,86.8356287350759,85.7786955656589,173
-7.6926,53.28823,2022/06/16 23:00:00+00,Fri 17 Jun 2022,62,90,0,3848353,3798611,240718,4089071,4039329,86.8369453888132,85.780606837213,174
-7.6926,53.28823,2022/06/17 23:00:00+00,Sat 18 Jun 2022,222,486,0,3848575,3799097,240718,4089293,4039815,86.8416598586466,85.7909277036051,175
-7.6926,53.28823,2022/06/18 23:00:00+00,Sun 19 Jun 2022,75,129,0,3848650,3799226,240718,4089368,4039944,86.8432525849417,85.7936671928326,176
-7.6926,53.28823,2022/06/19 23:00:00+00,Mon 20 Jun 2022,7,24,0,3848657,3799250,240718,4089375,4039968,86.8434012393959,85.7941768652471,177
-7.6926,53.28823,2022/06/20 23:00:00+00,Tue 21 Jun 2022,77,160,1,3848734,3799410,240719,4089453,4040129,86.8450576747428,85.7975959176939,178
-7.6926,53.28823,2022/06/21 23:00:00+00,Wed 22 Jun 2022,56,81,0,3848790,3799491,240719,4089509,4040210,86.8462469103765,85.7993160620925,179
-7.6926,53.28823,2021/08/12 23:00:00+00,Fri 13 Aug 2021,10919,28236,870,3305414,2902807,231618,3537032,3134425,75.1136516393295,66.5637482328702,180
-7.6926,53.28823,2021/12/12 00:00:00+00,Sun 12 Dec 2021,689,1190,0,3671299,3612160,240666,3911965,3852826,83.0758602792538,81.819963741055,181
-7.6926,53.28823,2021/05/06 23:00:00+00,Fri 07 May 2021,40597,15069,97,1362951,533495,643,1363594,534138,28.9577602615639,11.3431418373733,182
-7.6926,53.28823,2021/01/18 00:00:00+00,Mon 18 Jan 2021,8713,8,1,110908,114,3,110911,117,2.35534488151921,0.00248465302032935,183
-7.6926,53.28823,2021/08/13 23:00:00+00,Sat 14 Aug 2021,18128,5832,279,3323542,2908639,231897,3555439,3140536,75.504549144844,66.6935235713935,184
-7.6926,53.28823,2021/12/13 00:00:00+00,Mon 13 Dec 2021,726,1055,1,3672025,3613215,240667,3912692,3853882,83.0912991061408,81.8423893272898,185
-7.6926,53.28823,2021/05/07 23:00:00+00,Sat 08 May 2021,25617,7039,10,1388568,540534,653,1389221,541187,29.5019842184184,11.4928368727605,186
-7.6926,53.28823,2021/08/14 23:00:00+00,Sun 15 Aug 2021,16997,3722,49,3340539,2912361,231946,3572485,3144307,75.8665439771905,66.7736058495103,187
-7.6926,53.28823,2021/01/19 00:00:00+00,Tue 19 Jan 2021,8379,19,0,119287,133,3,119290,136,2.53328426320588,0.00288814368175035,188
-7.6926,53.28823,2021/12/14 00:00:00+00,Tue 14 Dec 2021,628,1189,1,3672653,3614404,240668,3913321,3855072,83.1046567706689,81.8676605845051,189
-7.6926,53.28823,2021/05/08 23:00:00+00,Sun 09 May 2021,19672,922,5,1408240,541456,658,1408898,542114,29.9198518891964,11.5125229697677,190
-7.6926,53.28823,2021/08/15 23:00:00+00,Mon 16 Aug 2021,10177,23142,384,3350716,2935503,232330,3583046,3167833,76.0908210758887,67.2732122337519,191
-7.6926,53.28823,2021/01/20 00:00:00+00,Wed 20 Jan 2021,8446,962,0,127733,1095,3,127736,1098,2.71264648038281,0.0233175129600139,192
-7.6926,53.28823,2021/12/15 00:00:00+00,Wed 15 Dec 2021,795,1236,1,3673448,3615640,240669,3914117,3856309,83.1215609057473,81.8939299501986,193
-7.6926,53.28823,2021/05/09 23:00:00+00,Mon 10 May 2021,28841,4641,171,1437081,546097,829,1437910,546926,30.5359608928356,11.6147122888602,194
-7.6926,53.28823,2021/08/16 23:00:00+00,Tue 17 Aug 2021,12860,26847,528,3363576,2962350,232858,3596434,3195208,76.3751333377363,67.8545573314572,195
-7.6926,53.28823,2021/08/17 23:00:00+00,Wed 18 Aug 2021,15227,25760,657,3378803,2988110,233515,3612318,3221625,76.7124515306843,68.4155580052866,196
-7.6926,53.28823,2021/08/18 23:00:00+00,Thu 19 Aug 2021,11355,25694,544,3390158,3013804,234059,3624217,3247863,76.9651428664868,68.9727573723584,197
-7.6926,53.28823,2021/08/19 23:00:00+00,Fri 20 Aug 2021,14837,22245,686,3404995,3036049,234745,3639740,3270794,77.2947947368678,69.4597281279923,198
-7.6926,53.28823,2021/08/20 23:00:00+00,Sat 21 Aug 2021,11880,7965,245,3416875,3044014,234990,3651865,3279004,77.5522854879062,69.6340785664274,199
-7.6926,53.28823,2021/08/21 23:00:00+00,Sun 22 Aug 2021,8003,12250,161,3424878,3056264,235151,3660029,3291415,77.7256590542137,69.8976429137377,200
-7.6926,53.28823,2021/08/22 23:00:00+00,Mon 23 Aug 2021,10862,15365,289,3435740,3071629,235440,3671180,3307069,77.9624655997666,70.2300767460474,201
-7.6926,53.28823,2021/08/23 23:00:00+00,Tue 24 Aug 2021,9705,22912,383,3445445,3094541,235823,3681268,3330364,78.1766979046305,70.7247775333002,202
-7.6926,53.28823,2021/08/24 23:00:00+00,Wed 25 Aug 2021,9413,19510,313,3454858,3114051,236136,3690994,3350187,78.3832426505769,71.1457457112659,203
-7.6926,53.28823,2021/08/25 23:00:00+00,Thu 26 Aug 2021,8575,19425,367,3463433,3133476,236503,3699936,3369979,78.573138097652,71.566055562363,204
-7.6926,53.28823,2021/08/26 23:00:00+00,Fri 27 Aug 2021,9717,19198,430,3473150,3152674,236933,3710083,3389607,78.7886233472014,71.9828826519615,205
-7.6926,53.28823,2021/08/27 23:00:00+00,Sat 28 Aug 2021,9917,7908,153,3483067,3160582,237086,3720153,3397668,79.0024733977545,72.154068874157,206
-7.6926,53.28823,2021/08/28 23:00:00+00,Sun 29 Aug 2021,8795,9184,29,3491862,3169766,237115,3728977,3406881,79.1898629554587,72.349719372245,207
-7.6926,53.28823,2021/08/29 23:00:00+00,Mon 30 Aug 2021,5056,11114,84,3496918,3180880,237199,3734117,3418079,79.2990177975483,72.5875240262762,208
-7.6926,53.28823,2021/08/30 23:00:00+00,Tue 31 Aug 2021,4059,12876,142,3500977,3193756,237341,3738318,3431097,79.3882317064236,72.8639788384014,209
-7.6926,53.28823,2021/08/31 23:00:00+00,Wed 01 Sep 2021,4956,12516,180,3505933,3206272,237521,3743454,3443793,79.4973016031109,73.133595545633,210
-7.6926,53.28823,2021/09/01 23:00:00+00,Thu 02 Sep 2021,5005,12345,247,3510938,3218617,237768,3748706,3456385,79.6088349164679,73.4010036724021,211
-7.6926,53.28823,2021/09/02 23:00:00+00,Fri 03 Sep 2021,4771,16061,165,3515709,3234678,237933,3753642,3472611,79.7136575430349,73.7455846972557,212
-7.6926,53.28823,2021/09/03 23:00:00+00,Sat 04 Sep 2021,4628,10576,133,3520337,3245254,238066,3758403,3483320,79.8147638082468,73.9730047758429,213
-7.6926,53.28823,2021/09/04 23:00:00+00,Sun 05 Sep 2021,5305,11896,1,3525642,3257150,238067,3763709,3495217,79.9274438845363,74.2256536389442,214
-7.6926,53.28823,2021/09/05 23:00:00+00,Mon 06 Sep 2021,2155,9664,75,3527797,3266814,238142,3765939,3504956,79.9748009463767,74.4324744574484,215
-7.6926,53.28823,2021/09/06 23:00:00+00,Tue 07 Sep 2021,3026,10006,158,3530823,3276820,238300,3769123,3515120,80.0424174866907,74.648320724958,216
-7.6926,53.28823,2021/09/07 23:00:00+00,Wed 08 Sep 2021,2608,14808,187,3533431,3291628,238487,3771918,3530115,80.1017730866207,74.9667598022216,217
-7.6926,53.28823,2021/09/08 23:00:00+00,Thu 09 Sep 2021,3112,14806,138,3536543,3306434,238625,3775168,3545059,80.1707912260743,75.2841158256045,218
-7.6926,53.28823,2021/09/09 23:00:00+00,Fri 10 Sep 2021,3373,13943,115,3539916,3320377,238740,3778656,3559117,80.244863616971,75.5826564423549,219
-7.6926,53.28823,2021/09/10 23:00:00+00,Sat 11 Sep 2021,2557,11328,62,3542473,3331705,238802,3781275,3570507,80.3004816191953,75.8245384757015,220
-7.6926,53.28823,2021/09/11 23:00:00+00,Sun 12 Sep 2021,2041,12880,1,3544514,3344585,238803,3783317,3583388,80.3438462471227,76.0980839077943,221
-7.6926,53.28823,2021/09/12 23:00:00+00,Mon 13 Sep 2021,1611,7731,52,3546125,3352316,238855,3784980,3591171,80.3791622981724,76.2633664245227,222
-7.6926,53.28823,2021/09/13 23:00:00+00,Tue 14 Sep 2021,1544,10780,82,3547669,3363096,238937,3786606,3602033,80.4136926042498,76.4940356647519,223
-7.6926,53.28823,2021/09/14 23:00:00+00,Wed 15 Sep 2021,3277,12392,138,3550946,3375488,239075,3790021,3614563,80.4862147415526,76.7601271377838,224
-7.6926,53.28823,2021/09/15 23:00:00+00,Thu 16 Sep 2021,1908,10590,115,3552854,3386078,239190,3792044,3625268,80.5291758788186,76.9874622709686,225
-7.6926,53.28823,2021/09/16 23:00:00+00,Fri 17 Sep 2021,2558,14611,94,3555412,3400689,239284,3794696,3639973,80.5854946806127,77.2997428065579,226
-7.6926,53.28823,2021/09/17 23:00:00+00,Sat 18 Sep 2021,2287,11227,47,3557699,3411916,239331,3797030,3651247,80.6350603229157,77.5391614232347,227
-7.6926,53.28823,2021/09/18 23:00:00+00,Sun 19 Sep 2021,1860,8489,15,3559559,3420405,239346,3798905,3659751,80.6748784802928,77.7197553487465,228
-7.6926,53.28823,2021/09/19 23:00:00+00,Mon 20 Sep 2021,952,5611,35,3560511,3426016,239381,3799892,3665397,80.6958387583361,77.8396557842404,229
-7.6926,53.28823,2021/09/20 23:00:00+00,Tue 21 Sep 2021,1463,6665,90,3561974,3432681,239471,3801445,3672152,80.7288188108196,77.9831073325508,230
-7.6926,53.28823,2021/09/21 23:00:00+00,Wed 22 Sep 2021,1894,8150,97,3563868,3440831,239568,3803436,3680399,80.7711003848664,78.1582435159582,231
-7.6926,53.28823,2021/09/22 23:00:00+00,Thu 23 Sep 2021,1698,8732,89,3565566,3449563,239657,3805223,3689220,80.8090497433906,78.3455693646105,232
-7.6926,53.28823,2021/09/23 23:00:00+00,Fri 24 Sep 2021,1909,7383,79,3567475,3456946,239736,3807211,3696682,80.8512676083856,78.504035012796,233
-7.6926,53.28823,2021/09/24 23:00:00+00,Sat 25 Sep 2021,2414,6594,52,3569889,3463540,239788,3809677,3703328,80.9036364489679,78.6451717988909,234
-7.6926,53.28823,2021/09/25 23:00:00+00,Sun 26 Sep 2021,1548,7097,0,3571437,3470637,239788,3811225,3710425,80.9365103196984,78.795886179107,235
-7.6926,53.28823,2021/09/26 23:00:00+00,Mon 27 Sep 2021,1177,3819,45,3572614,3474456,239833,3812447,3714289,80.9624611401329,78.8779434378296,236
-7.6926,53.28823,2021/09/27 23:00:00+00,Tue 28 Sep 2021,1449,5128,93,3574063,3479584,239926,3813989,3719510,80.9952075927598,78.988818424318,237
-7.6926,53.28823,2021/09/28 23:00:00+00,Wed 29 Sep 2021,1651,3615,79,3575714,3483199,240005,3815719,3723204,81.0319464792998,79.0672655034385,238
-7.6926,53.28823,2021/09/29 23:00:00+00,Thu 30 Sep 2021,1280,3962,78,3576994,3487161,240083,3817077,3727244,81.0607854434161,79.1530603598669,239
-7.6926,53.28823,2021/09/30 23:00:00+00,Fri 01 Oct 2021,1844,5173,41,3578838,3492334,240124,3818962,3732458,81.1008159642991,79.2637866919011,240
-7.6926,53.28823,2021/10/01 23:00:00+00,Sat 02 Oct 2021,1710,4085,40,3580548,3496419,240164,3820712,3736583,81.1379795778511,79.3513866381307,241
-7.6926,53.28823,2021/10/02 23:00:00+00,Sun 03 Oct 2021,1196,3015,9,3581744,3499434,240173,3821917,3739607,81.1635693803254,79.4156053623484,242
-7.6926,53.28823,2021/10/03 23:00:00+00,Mon 04 Oct 2021,335,1234,18,3582079,3500668,240191,3822270,3740859,81.1710658120876,79.442193273301,243
-7.6926,53.28823,2021/10/04 23:00:00+00,Tue 05 Oct 2021,964,2820,70,3583043,3503488,240261,3823304,3743749,81.1930241986091,79.5035663265382,244
-7.6926,53.28823,2021/10/05 23:00:00+00,Wed 06 Oct 2021,978,2568,39,3584021,3506056,240300,3824321,3746356,81.2146215671705,79.5589294925553,245
-7.6926,53.28823,2021/10/06 23:00:00+00,Thu 07 Oct 2021,1212,2694,44,3585233,3508750,240344,3825577,3749094,81.2412944235255,79.6170746205011,246
-7.6926,53.28823,2021/10/07 23:00:00+00,Fri 08 Oct 2021,965,2778,48,3586198,3511528,240392,3826590,3751920,81.2628068466844,79.6770885472998,247
-7.6926,53.28823,2021/10/08 23:00:00+00,Sat 09 Oct 2021,732,2379,23,3586930,3513907,240415,3827345,3754322,81.2788402913882,79.7280982614437,248
-7.6926,53.28823,2021/10/09 23:00:00+00,Sun 10 Oct 2021,1502,3915,1,3588432,3517822,240416,3828848,3758238,81.3107585263417,79.8112598103976,249
-7.6926,53.28823,2021/10/10 23:00:00+00,Mon 11 Oct 2021,331,1122,19,3588763,3518944,240435,3829198,3759379,81.3181912490521,79.8354904864335,250
-7.6926,53.28823,2021/10/11 23:00:00+00,Tue 12 Oct 2021,558,1608,20,3589321,3520552,240455,3829776,3761007,81.3304658596995,79.8700632652121,251
-7.6926,53.28823,2021/10/12 23:00:00+00,Wed 13 Oct 2021,997,2071,11,3590318,3522623,240466,3830784,3763089,81.3518721011054,79.9142773471636,252
-7.6926,53.28823,2021/10/13 23:00:00+00,Thu 14 Oct 2021,683,1596,8,3591001,3524219,240474,3831475,3764693,81.3665464193708,79.9483404535277,253
-7.6926,53.28823,2021/10/14 23:00:00+00,Fri 15 Oct 2021,949,2064,8,3591950,3526283,240482,3832432,3766765,81.386869606896,79.9923421719732,254
-7.6926,53.28823,2021/10/15 23:00:00+00,Sat 16 Oct 2021,1369,2636,14,3593319,3528919,240496,3833815,3769415,81.4162394797774,80.0486185010662,255
-7.6926,53.28823,2021/10/16 23:00:00+00,Sun 17 Oct 2021,1702,2888,2,3595021,3531807,240498,3835519,3772305,81.4524262212016,80.1099915543034,256
-7.6926,53.28823,2021/10/17 23:00:00+00,Mon 18 Oct 2021,671,1240,6,3595692,3533047,240504,3836196,3773551,81.4668032305586,80.1364520471523,257
-7.6926,53.28823,2021/10/18 23:00:00+00,Tue 19 Oct 2021,1334,1792,13,3597026,3534839,240517,3837543,3775356,81.4954085948183,80.1747836599873,258
-7.6926,53.28823,2021/10/19 23:00:00+00,Wed 20 Oct 2021,2253,2319,0,3599279,3537158,240517,3839796,3777675,81.5432540927226,80.2240307570313,259
-7.6926,53.28823,2021/10/20 23:00:00+00,Thu 21 Oct 2021,1738,1826,11,3601017,3538984,240528,3841545,3779512,81.5803964699239,80.2630419330855,260
-7.6926,53.28823,2021/10/21 23:00:00+00,Fri 22 Oct 2021,1501,1919,3,3602518,3540903,240531,3843049,3781434,81.612335941228,80.3038581989409,261
-7.6926,53.28823,2021/10/22 23:00:00+00,Sat 23 Oct 2021,2009,1694,1,3604527,3542597,240532,3845059,3783129,81.6550210059362,80.3398538132097,262
-7.6926,53.28823,2021/10/23 23:00:00+00,Sun 24 Oct 2021,1948,2184,2,3606475,3544781,240534,3847009,3785315,81.6964318896084,80.3862764756238,263
-7.6926,53.28823,2021/10/24 23:00:00+00,Mon 25 Oct 2021,1219,842,2,3607694,3545623,240536,3848230,3786159,81.7223614736923,80.4041999555311,264
-7.6926,53.28823,2021/10/25 23:00:00+00,Tue 26 Oct 2021,1237,1219,6,3608931,3546842,240542,3849473,3787384,81.7487582574895,80.4302144850174,265
-7.6926,53.28823,2021/10/26 23:00:00+00,Wed 27 Oct 2021,1557,1415,5,3610488,3548257,240547,3851035,3788804,81.7819294371284,80.460370102871,266
-7.6926,53.28823,2021/10/27 23:00:00+00,Thu 28 Oct 2021,2150,1686,4,3612638,3549943,240551,3853189,3790494,81.8276725363232,80.4962595353869,267
-7.6926,53.28823,2021/10/28 23:00:00+00,Fri 29 Oct 2021,2132,1355,1,3614770,3551298,240552,3855322,3791850,81.8729696721553,80.525056026802,268
-7.6926,53.28823,2021/10/29 23:00:00+00,Sat 30 Oct 2021,2014,1445,0,3616784,3552743,240552,3857336,3793295,81.915739682266,80.5557425534206,269
-7.6926,53.28823,2021/10/30 23:00:00+00,Sun 31 Oct 2021,1593,1318,0,3618377,3554061,240552,3858929,3794613,81.9495691887735,80.5837320635128,270
-7.6926,53.28823,2021/11/01 00:00:00+00,Mon 01 Nov 2021,265,273,2,3618642,3554334,240554,3859196,3794888,81.955239294384,80.5895720599281,271
-7.6926,53.28823,2021/11/02 00:00:00+00,Tue 02 Nov 2021,1093,1081,10,3619735,3555415,240564,3860299,3795979,81.978662989097,80.6127409184339,272
-7.6926,53.28823,2021/11/03 00:00:00+00,Wed 03 Nov 2021,2529,1863,6,3622264,3557278,240570,3862834,3797848,82.0324971378708,80.6524316577074,273
-7.6926,53.28823,2021/11/04 00:00:00+00,Thu 04 Nov 2021,1536,1266,1,3623800,3558544,240571,3864371,3799115,82.0651374087447,80.679338113919,274
-7.6926,53.28823,2021/11/05 00:00:00+00,Fri 05 Nov 2021,1631,1078,3,3625431,3559622,240574,3866005,3800196,82.099837605627,80.7022946089188,275
-7.6926,53.28823,2021/11/06 00:00:00+00,Sat 06 Nov 2021,1813,1345,5,3627244,3560967,240579,3867823,3801546,82.1384452910198,80.7309636822303,276
-7.6926,53.28823,2021/11/07 00:00:00+00,Sun 07 Nov 2021,693,771,0,3627937,3561738,240579,3868516,3802317,82.1531620819863,80.7473369085437,277
-7.6926,53.28823,2021/11/08 00:00:00+00,Mon 08 Nov 2021,516,528,3,3628453,3562266,240582,3869035,3802848,82.1641837479483,80.7586134107129,278
-7.6926,53.28823,2021/11/09 00:00:00+00,Tue 09 Nov 2021,1369,1050,3,3629822,3563316,240585,3870407,3803901,82.193320020973,80.7809752878959,279
-7.6926,53.28823,2021/11/10 00:00:00+00,Wed 10 Nov 2021,1616,1350,1,3631438,3564666,240586,3872024,3805252,82.227659199895,80.809665597558,280
-7.6926,53.28823,2021/11/11 00:00:00+00,Thu 11 Nov 2021,1386,1100,2,3632824,3565766,240588,3873412,3806354,82.2571352545293,80.8330680559204,281
-7.6926,53.28823,2021/11/12 00:00:00+00,Fri 12 Nov 2021,1144,1138,6,3633968,3566904,240594,3874562,3807498,82.2815570577206,80.8573624410081,282
-7.6926,53.28823,2021/11/13 00:00:00+00,Sat 13 Nov 2021,1400,1362,0,3635368,3568266,240594,3875962,3808860,82.3112879485622,80.8862863505268,283
-7.6926,53.28823,2021/11/14 00:00:00+00,Sun 14 Nov 2021,1646,1802,0,3637014,3570068,240594,3877608,3810662,82.3462429816516,80.92455425431,284
-7.6926,53.28823,2021/11/15 00:00:00+00,Mon 15 Nov 2021,1246,579,1,3638260,3570647,240595,3878855,3811242,82.3727247108512,80.9368713376586,285
-7.6926,53.28823,2021/11/16 00:00:00+00,Tue 16 Nov 2021,1319,1061,5,3639579,3571708,240600,3880179,3812308,82.400841639047,80.9595092873994,286
-7.6926,53.28823,2021/11/17 00:00:00+00,Wed 17 Nov 2021,1508,1099,0,3641087,3572807,240600,3881687,3813407,82.4328660557535,80.98284803671,287
-7.6926,53.28823,2021/11/18 00:00:00+00,Thu 18 Nov 2021,1652,2490,5,3642739,3575297,240605,3883344,3815902,82.4680546886995,81.0358327314598,288
-7.6926,53.28823,2021/11/19 00:00:00+00,Fri 19 Nov 2021,1168,1535,0,3643907,3576832,240605,3884512,3817437,82.4928587462016,81.0684305296325,289
-7.6926,53.28823,2021/12/16 00:00:00+00,Thu 16 Dec 2021,1057,1526,7,3674505,3617166,240676,3915181,3857842,83.1441563827869,81.9264852756701,290
-7.6926,53.28823,2021/05/10 23:00:00+00,Tue 11 May 2021,33921,14820,153,1471002,560917,982,1471984,561899,31.2595683032177,11.9326841664106,291
-7.6926,53.28823,2021/12/17 00:00:00+00,Fri 17 Dec 2021,1212,2441,1,3675717,3619607,240677,3916394,3860284,83.1699160760661,81.978344443838,292
-7.6926,53.28823,2021/12/18 00:00:00+00,Sat 18 Dec 2021,1258,1180,0,3676975,3620787,240677,3917652,3861464,83.1966314051222,82.0034033375473,293
-7.6926,53.28823,2021/05/11 23:00:00+00,Wed 12 May 2021,31290,20933,171,1502292,581850,1153,1503445,583003,31.9276851294791,12.3808561094963,294
-7.6926,53.28823,2021/12/19 00:00:00+00,Sun 19 Dec 2021,552,882,1,3677527,3621669,240678,3918205,3862347,83.2083751070047,82.0221550351281,295
-7.6926,53.28823,2021/05/12 23:00:00+00,Thu 13 May 2021,35999,25476,152,1538291,607326,1305,1539596,608631,32.6954004400597,12.9251013027015,296
-7.6926,53.28823,2021/12/20 00:00:00+00,Mon 20 Dec 2021,527,601,0,3678054,3622270,240678,3918732,3862948,83.2195666637714,82.0349180818394,297
-7.6926,53.28823,2021/05/13 23:00:00+00,Fri 14 May 2021,38216,27944,236,1576507,635270,1541,1578048,636811,33.5119805933734,13.5235416626406,298
-7.6926,53.28823,2021/12/21 00:00:00+00,Tue 21 Dec 2021,1441,1798,3,3679495,3624068,240681,3920176,3864749,83.2502319540394,82.073164749272,299
-7.6926,53.28823,2021/05/14 23:00:00+00,Sat 15 May 2021,28855,12444,22,1605362,647714,1563,1606925,649277,34.1252226896815,13.788274009234,300
-7.6926,53.28823,2021/12/22 00:00:00+00,Wed 22 Dec 2021,1205,1576,2,3680700,3625644,240683,3921383,3866327,83.275864229215,82.1066757105205,301
-7.6926,53.28823,2021/05/15 23:00:00+00,Sun 16 May 2021,23171,1173,9,1628533,648887,1572,1630105,650459,34.6174812966151,13.8133753756445,302
-7.6926,53.28823,2021/12/23 00:00:00+00,Thu 23 Dec 2021,952,1361,0,3681652,3627005,240683,3922335,3867688,83.2960812349872,82.1355783836886,303
-7.6926,53.28823,2021/05/16 23:00:00+00,Mon 17 May 2021,35393,3947,117,1663926,652834,1689,1665615,654523,35.3715841064604,13.8996799044874,304
-7.6926,53.28823,2021/12/24 00:00:00+00,Fri 24 Dec 2021,103,149,0,3681755,3627154,240683,3922438,3867837,83.2982685790991,82.1387425999282,305
-7.6926,53.28823,2021/05/17 23:00:00+00,Tue 18 May 2021,39007,12491,127,1702933,665325,1816,1704749,667141,36.202647450884,14.1676401763721,306
-7.6926,53.28823,2021/12/25 00:00:00+00,Sat 25 Dec 2021,2,2,0,3681757,3627156,240683,3922440,3867839,83.2983110518003,82.1387850726294,307
-7.6926,53.28823,2021/05/18 23:00:00+00,Wed 19 May 2021,37026,17585,209,1739959,682910,2025,1741984,684935,36.9933829655162,14.5455197989682,308
-7.6926,53.28823,2021/12/26 00:00:00+00,Sun 26 Dec 2021,11,9,0,3681768,3627165,240683,3922451,3867848,83.298544651657,82.1389761997848,309
-7.6926,53.28823,2021/05/19 23:00:00+00,Thu 20 May 2021,39081,19638,136,1779040,702548,2161,1781201,704709,37.8262089270398,14.9654473957545,310
-7.6926,53.28823,2021/12/27 00:00:00+00,Mon 27 Dec 2021,390,586,0,3682158,3627751,240683,3922841,3868434,83.3068268283914,82.151420701237,311
-7.6926,53.28823,2021/05/20 23:00:00+00,Fri 21 May 2021,25842,23244,14934,1804882,725792,17095,1821977,742887,38.6921423591504,15.7762087890035,312
-7.6926,53.28823,2021/12/28 00:00:00+00,Tue 28 Dec 2021,469,741,0,3682627,3628492,240683,3923310,3869175,83.3167866768233,82.1671568370325,313
-7.6926,53.28823,2021/05/21 23:00:00+00,Sat 22 May 2021,16588,10244,13523,1821470,736036,30618,1852088,766654,39.3315901121003,16.28093313374,314
-7.6926,53.28823,2021/12/29 00:00:00+00,Wed 29 Dec 2021,1072,1296,0,3683699,3629788,240683,3924382,3870471,83.3395520446677,82.1946791474115,315
-7.6926,53.28823,2021/05/22 23:00:00+00,Sun 23 May 2021,8210,5522,10204,1829680,741558,40822,1870502,782380,39.7226362720691,16.6148959832929,316
-7.6926,53.28823,2021/12/30 00:00:00+00,Thu 30 Dec 2021,1065,1185,1,3684764,3630973,240684,3925448,3871657,83.3621899944085,82.2198654592244,317
-7.6926,53.28823,2021/05/23 23:00:00+00,Mon 24 May 2021,22546,8213,8450,1852226,749771,49272,1901498,799043,40.3808781953009,16.9687572933592,318
-7.6926,53.28823,2021/12/31 00:00:00+00,Fri 31 Dec 2021,719,1675,0,3685483,3632648,240684,3926167,3873332,83.3774589304907,82.2554363464813,319
-7.6926,53.28823,2021/05/24 23:00:00+00,Tue 25 May 2021,30339,16484,3222,1882565,766255,52494,1935059,818749,41.0935913578246,17.3872408183045,320
-7.6926,53.28823,2022/01/01 00:00:00+00,Sat 01 Jan 2022,65,96,0,3685548,3632744,240684,3926232,3873428,83.3788392932797,82.257475036139,321
-7.6926,53.28823,2021/05/25 23:00:00+00,Wed 26 May 2021,19973,25391,3052,1902538,791646,55546,1958084,847192,41.5825583304151,17.9912663384518,322
-7.6926,53.28823,2022/01/02 00:00:00+00,Sun 02 Jan 2022,271,625,0,3685819,3633369,240684,3926503,3874053,83.3845943442926,82.2707477552647,323
-7.6926,53.28823,2021/05/26 23:00:00+00,Thu 27 May 2021,17014,36029,550,1919552,827675,56096,1975648,883771,41.9555535923729,18.7680708070896,324
-7.6926,53.28823,2022/01/03 00:00:00+00,Mon 03 Jan 2022,3631,720,1,3689450,3634089,240685,3930135,3874774,83.4617247696759,82.2860591640481,325
-7.6926,53.28823,2021/05/27 23:00:00+00,Fri 28 May 2021,27038,31817,1558,1946590,859492,57654,2004244,917146,42.5628282741621,19.4768340084015,326
-7.6926,53.28823,2022/01/04 00:00:00+00,Tue 04 Jan 2022,1191,775,0,3690641,3634864,240685,3931326,3875549,83.4870172632418,82.3025173357639,327
-7.6926,53.28823,2021/05/28 23:00:00+00,Sat 29 May 2021,24469,7382,534,1971059,866874,58188,2029247,925062,43.0938007482416,19.6449409597599,328
-7.6926,53.28823,2022/01/05 00:00:00+00,Wed 05 Jan 2022,2145,888,0,3692786,3635752,240685,3933471,3876437,83.5325692352811,82.3213752150977,329
-7.6926,53.28823,2021/05/29 23:00:00+00,Sun 30 May 2021,24242,1676,209,1995301,868550,58397,2053698,926947,43.6130507567892,19.684971480643,330
-7.6926,53.28823,2022/01/06 00:00:00+00,Thu 06 Jan 2022,2461,1684,1,3695247,3637436,240686,3935933,3878122,83.5848531304611,82.3571584658606,331
-7.6926,53.28823,2021/05/30 23:00:00+00,Mon 31 May 2021,22580,7325,3443,2017881,875875,61840,2079721,937715,44.1656843084818,19.9136445039157,332
-7.6926,53.28823,2022/01/07 00:00:00+00,Fri 07 Jan 2022,4856,772,2,3700103,3638208,240688,3940791,3878896,83.6880193216812,82.3735954012258,333
-7.6926,53.28823,2021/05/31 23:00:00+00,Tue 01 Jun 2021,27548,11510,3653,2045429,887385,65493,2110922,952878,44.8282796835869,20.2356512880802,334
-7.6926,53.28823,2022/01/08 00:00:00+00,Sat 08 Jan 2022,9791,735,1,3709894,3638943,240689,3950583,3879632,83.8959656667673,82.3892253552682,335
-7.6926,53.28823,2021/06/01 23:00:00+00,Wed 02 Jun 2021,18691,20896,4007,2064120,908281,69500,2133620,977781,45.3103023695308,20.7645001270996,336
-7.6926,53.28823,2022/01/09 00:00:00+00,Sun 09 Jan 2022,7115,663,0,3717009,3639606,240689,3957698,3880295,84.0470623012941,82.4033050557167,337
-7.6926,53.28823,2022/01/10 00:00:00+00,Mon 10 Jan 2022,6659,499,0,3723668,3640105,240689,3964357,3880794,84.1884751599469,82.4139019946667,338
-7.6926,53.28823,2022/01/11 00:00:00+00,Tue 11 Jan 2022,4777,1353,1,3728445,3641458,240690,3969135,3882148,84.289942443119,82.4426560133806,339
-7.6926,53.28823,2022/01/12 00:00:00+00,Wed 12 Jan 2022,7564,900,1,3736009,3642358,240691,3976700,3883049,84.4505954354163,82.4617899652722,340
-7.6926,53.28823,2022/01/13 00:00:00+00,Thu 13 Jan 2022,7327,800,0,3743336,3643158,240691,3984027,3883849,84.6061941762706,82.4787790457531,341
-7.6926,53.28823,2022/01/14 00:00:00+00,Fri 14 Jan 2022,10731,827,0,3754067,3643985,240691,3994758,3884676,84.8340814545711,82.4963415077002,342
-7.6926,53.28823,2022/01/15 00:00:00+00,Sat 15 Jan 2022,8358,646,2,3762425,3644631,240693,4003118,3885324,85.0116173455963,82.5101026628897,343
-7.6926,53.28823,2022/01/16 00:00:00+00,Sun 16 Jan 2022,6966,1215,1,3769391,3645846,240694,4010085,3886540,85.1595710002342,82.5359260652207,344
-7.6926,53.28823,2022/01/17 00:00:00+00,Mon 17 Jan 2022,2566,552,0,3771957,3646398,240694,4012651,3887092,85.2140634758767,82.5476485307525,345
-7.6926,53.28823,2022/01/18 00:00:00+00,Tue 18 Jan 2022,4057,438,3,3776014,3646836,240697,4016711,3887533,85.3002830593172,82.5570137613675,346
-7.6926,53.28823,2022/01/19 00:00:00+00,Wed 19 Jan 2022,3490,618,0,3779504,3647454,240697,4020201,3888151,85.374397922915,82.570137826039,347
-7.6926,53.28823,2022/01/20 00:00:00+00,Thu 20 Jan 2022,3697,931,0,3783201,3648385,240697,4023898,3889082,85.4529087110873,82.5899088684487,348
-7.6926,53.28823,2022/01/21 00:00:00+00,Fri 21 Jan 2022,3254,970,0,3786455,3649355,240697,4027152,3890052,85.5220117959433,82.6105081285317,349
-7.6926,53.28823,2022/01/22 00:00:00+00,Sat 22 Jan 2022,4271,640,0,3790726,3649995,240697,4031423,3890692,85.6127122493606,82.6240993929164,350
-7.6926,53.28823,2022/01/23 00:00:00+00,Sun 23 Jan 2022,3092,677,0,3793818,3650672,240697,4034515,3891369,85.6783750454192,82.6384764022734,351
-7.6926,53.28823,2022/01/24 00:00:00+00,Mon 24 Jan 2022,648,458,0,3794466,3651130,240697,4035163,3891827,85.6921362006088,82.6482026508487,352
-7.6926,53.28823,2022/01/25 00:00:00+00,Tue 25 Jan 2022,697,1830,0,3795163,3652960,240697,4035860,3893657,85.7069379369777,82.6870651724487,353
-7.6926,53.28823,2022/01/26 00:00:00+00,Wed 26 Jan 2022,700,888,0,3795863,3653848,240697,4036560,3894545,85.7218033823985,82.7059230517825,354
-7.6926,53.28823,2022/01/27 00:00:00+00,Thu 27 Jan 2022,1274,1166,0,3797137,3655014,240697,4037834,3895711,85.7488584930643,82.7306846365834,355
-7.6926,53.28823,2022/01/28 00:00:00+00,Fri 28 Jan 2022,1032,3090,0,3798169,3658104,240697,4038866,3898801,85.7707744068847,82.7963049599408,356
-7.6926,53.28823,2022/01/29 00:00:00+00,Sat 29 Jan 2022,2328,3442,0,3800497,3661546,240697,4041194,3902243,85.820212631084,82.8694004787098,357
-7.6926,53.28823,2022/01/30 00:00:00+00,Sun 30 Jan 2022,1634,7537,0,3802131,3669083,240697,4042828,3909780,85.8549128279662,83.0294588531903,358
-7.6926,53.28823,2022/01/31 00:00:00+00,Mon 31 Jan 2022,482,1388,0,3802613,3670471,240697,4043310,3911168,85.865148748956,83.0589349078247,359
-7.6926,53.28823,2022/02/01 00:00:00+00,Tue 01 Feb 2022,754,3410,1,3803367,3673881,240698,4044065,3914579,85.8811821936598,83.1313720997251,360
-7.6926,53.28823,2022/02/02 00:00:00+00,Wed 02 Feb 2022,649,2994,0,3804016,3676875,240698,4044714,3917573,85.8949645851999,83.1949537334248,361
-7.6926,53.28823,2022/02/03 00:00:00+00,Thu 03 Feb 2022,908,2431,1,3804924,3679306,240699,4045623,3920005,85.9142684278963,83.2466005380867,362
-7.6926,53.28823,2022/02/04 00:00:00+00,Fri 04 Feb 2022,1173,6520,0,3806097,3685826,240699,4046796,3926525,85.9391786671514,83.3850615440059,363
-7.6926,53.28823,2022/02/05 00:00:00+00,Sat 05 Feb 2022,1777,5748,0,3807874,3691574,240699,4048573,3932273,85.9769156621696,83.507128087261,364
-7.6926,53.28823,2022/02/06 00:00:00+00,Sun 06 Feb 2022,1408,7555,0,3809282,3699129,240699,4049981,3939828,86.0068164438159,83.6675687160524,365
-7.6926,53.28823,2022/02/07 00:00:00+00,Mon 07 Feb 2022,439,1347,0,3809721,3700476,240699,4050420,3941175,86.0161392017298,83.6961740803121,366
-7.6926,53.28823,2022/02/08 00:00:00+00,Tue 08 Feb 2022,902,1234,0,3810623,3701710,240699,4051322,3942409,86.035294389972,83.7223797369538,367
-7.6926,53.28823,2022/02/09 00:00:00+00,Wed 09 Feb 2022,1332,1781,0,3811955,3703491,240699,4052654,3944190,86.0635812089727,83.7602016773744,368
-7.6926,53.28823,2022/02/10 00:00:00+00,Thu 10 Feb 2022,685,2545,0,3812640,3706036,240699,4053339,3946735,86.0781281091345,83.8142481896542,369
-7.6926,53.28823,2022/02/11 00:00:00+00,Fri 11 Feb 2022,550,4915,0,3813190,3710951,240699,4053889,3951650,86.0898081019651,83.9186248528586,370
-7.6926,53.28823,2022/02/12 00:00:00+00,Sat 12 Feb 2022,1399,5460,0,3814589,3716411,240699,4055288,3957110,86.119517756456,84.0345753271407,371
-7.6926,53.28823,2022/02/13 00:00:00+00,Sun 13 Feb 2022,1568,4705,0,3816157,3721116,240699,4056856,3961815,86.1528163541985,84.1344923567189,372
-7.6926,53.28823,2022/02/14 00:00:00+00,Mon 14 Feb 2022,173,952,0,3816330,3722068,240699,4057029,3962767,86.1564902428525,84.1547093624911,373
-7.6926,53.28823,2022/02/15 00:00:00+00,Tue 15 Feb 2022,649,815,1,3816979,3722883,240700,4057679,3963583,86.1702938707433,84.1720382245816,374
-7.6926,53.28823,2022/02/16 00:00:00+00,Wed 16 Feb 2022,801,1785,0,3817780,3724668,240700,4058480,3965368,86.1873041875747,84.2099451104046,375
-7.6926,53.28823,2022/02/17 00:00:00+00,Thu 17 Feb 2022,793,1188,2,3818573,3725856,240702,4059275,3966558,86.2041870863026,84.2352163676199,376
-7.6926,53.28823,2022/02/18 00:00:00+00,Fri 18 Feb 2022,794,3290,0,3819367,3729146,240702,4060069,3969848,86.2210487486799,84.3050839610976,377
-7.6926,53.28823,2022/02/19 00:00:00+00,Sat 19 Feb 2022,980,3552,0,3820347,3732698,240702,4061049,3973400,86.241860372269,84.3805154784327,378
-7.6926,53.28823,2022/02/20 00:00:00+00,Sun 20 Feb 2022,1366,3587,0,3821713,3736285,240702,4062415,3976987,86.2708692271901,84.4566902680388,379
-7.6926,53.28823,2022/02/21 00:00:00+00,Mon 21 Feb 2022,251,992,2,3821964,3737277,240704,4062668,3977981,86.2762420238922,84.4777992005363,380
-7.6926,53.28823,2022/02/22 00:00:00+00,Tue 22 Feb 2022,474,977,0,3822438,3738254,240704,4063142,3978958,86.2863080540771,84.4985471150736,381
-7.6926,53.28823,2022/02/23 00:00:00+00,Wed 23 Feb 2022,831,1270,1,3823269,3739524,240705,4063974,3980229,86.3039766977772,84.5255385166876,382
-7.6926,53.28823,2022/02/24 00:00:00+00,Thu 24 Feb 2022,657,1233,0,3823926,3740757,240705,4064631,3981462,86.3179289801221,84.5517229369788,383
-7.6926,53.28823,2022/02/25 00:00:00+00,Fri 25 Feb 2022,691,1223,0,3824617,3741980,240705,4065322,3982685,86.3326032983875,84.5776949937639,384
-7.6926,53.28823,2022/02/26 00:00:00+00,Sat 26 Feb 2022,960,2090,0,3825577,3744070,240705,4066282,3984775,86.3529901949646,84.6220789665202,385
-7.6926,53.28823,2022/02/27 00:00:00+00,Sun 27 Feb 2022,671,1782,0,3826248,3745852,240705,4066953,3986557,86.3672397862179,84.6599221432914,386
-7.6926,53.28823,2022/02/28 00:00:00+00,Mon 28 Feb 2022,82,427,0,3826330,3746279,240705,4067035,3986984,86.3689811669672,84.6689900649981,387
-7.6926,53.28823,2022/03/01 00:00:00+00,Tue 01 Mar 2022,130,939,1,3826460,3747218,240706,4067166,3987924,86.3717631288959,84.6889522345631,388
-7.6926,53.28823,2022/03/02 00:00:00+00,Wed 02 Mar 2022,206,995,2,3826666,3748213,240708,4067374,3988921,86.376180289821,84.7101248761124,389
-7.6926,53.28823,2022/03/03 00:00:00+00,Thu 03 Mar 2022,279,1272,0,3826945,3749485,240708,4067653,3990193,86.3821052316387,84.737137514077,390
-7.6926,53.28823,2022/03/04 00:00:00+00,Fri 04 Mar 2022,734,1507,2,3827679,3750992,240710,4068389,3991702,86.3977351856811,84.7691831671341,391
-7.6926,53.28823,2022/03/05 00:00:00+00,Sat 05 Mar 2022,963,3341,0,3828642,3754333,240710,4069352,3995043,86.41818579131,84.8401338144924,392
-7.6926,53.28823,2022/03/06 00:00:00+00,Sun 06 Mar 2022,455,1915,0,3829097,3756248,240710,4069807,3996958,86.4278483308335,84.8808014258935,393
-7.6926,53.28823,2022/03/07 00:00:00+00,Mon 07 Mar 2022,113,123,0,3829210,3756371,240710,4069920,3997081,86.4302480384514,84.8834134970175,394
-7.6926,53.28823,2022/03/08 00:00:00+00,Tue 08 Mar 2022,119,491,0,3829329,3756862,240710,4070039,3997572,86.4327751641729,84.8938405451626,395
-7.6926,53.28823,2021/01/21 00:00:00+00,Thu 21 Jan 2021,9005,962,0,136738,2057,3,136741,2060,2.90387981754577,0.0437468822382774,396
-7.6926,53.28823,2021/06/02 23:00:00+00,Thu 03 Jun 2021,16685,30705,1976,2080805,938986,71476,2152281,1010462,45.706593908098,21.4585253010943,397
-7.6926,53.28823,2021/01/22 00:00:00+00,Fri 22 Jan 2021,6779,967,0,143517,3024,3,143520,3027,3.04784103827066,0.0642824332695464,398
-7.6926,53.28823,2021/06/03 23:00:00+00,Fri 04 Jun 2021,28996,23343,153,2109801,962329,71629,2181430,1033958,46.3256122917696,21.9574945948179,399
-7.6926,53.28823,2021/01/23 00:00:00+00,Sat 23 Jan 2021,4185,460,0,147702,3484,3,147705,3487,3.13671516553629,0.074051154546055,400
-7.6926,53.28823,2021/06/04 23:00:00+00,Sat 05 Jun 2021,20950,11489,33,2130751,973818,71662,2202413,1045480,46.7712146364326,22.2021798264438,401
-7.6926,53.28823,2021/01/24 00:00:00+00,Sun 24 Jan 2021,1182,398,0,148884,3882,3,148887,3885,3.1618165319468,0.082503222085295,402
-7.6926,53.28823,2021/06/05 23:00:00+00,Sun 06 Jun 2021,19935,3904,45,2150686,977722,71707,2222393,1049429,47.1955169214427,22.2860421749676,403
-7.6926,53.28823,2021/01/25 00:00:00+00,Mon 25 Jan 2021,1357,1287,0,150241,5169,3,150244,5172,3.1906342597125,0.109834405308918,404
-7.6926,53.28823,2021/06/06 23:00:00+00,Mon 07 Jun 2021,19807,4584,45,2170493,982306,71752,2242245,1054058,47.6171009535759,22.3843452419001,405
-7.6926,53.28823,2021/01/26 00:00:00+00,Tue 26 Jan 2021,1001,3500,0,151242,8669,3,151245,8672,3.2118918466642,0.184161632412787,406
-7.6926,53.28823,2021/06/07 23:00:00+00,Tue 08 Jun 2021,26394,18348,45,2196887,1000654,71797,2268684,1072451,48.1785688271185,22.7749454385062,407
-7.6926,53.28823,2021/01/27 00:00:00+00,Wed 27 Jan 2021,2172,6700,0,153414,15369,3,153417,15372,3.25801720016981,0.326445181440194,408
-7.6926,53.28823,2021/06/08 23:00:00+00,Wed 09 Jun 2021,32788,20109,173,2229675,1020763,71970,2301645,1092733,48.8785401792815,23.2056611013978,409
-7.6926,53.28823,2021/01/28 00:00:00+00,Thu 28 Jan 2021,1005,11538,0,154419,26907,3,154422,26910,3.27935973252392,0.57147019467575,410
-7.6926,53.28823,2021/06/09 23:00:00+00,Thu 10 Jun 2021,27683,27482,270,2257358,1048245,72240,2329598,1120485,49.4721598876342,23.7950123032797,411
-7.6926,53.28823,2021/01/29 00:00:00+00,Fri 29 Jan 2021,1575,11526,0,155994,38433,3,155997,38436,3.31280698472066,0.816240371704092,412
-7.6926,53.28823,2021/06/10 23:00:00+00,Fri 11 Jun 2021,26427,32893,39,2283785,1081138,72279,2356064,1153417,50.0342011426431,24.4943678012753,413
-7.6926,53.28823,2021/01/30 00:00:00+00,Sat 30 Jan 2021,634,7793,0,156628,46226,3,156631,46229,3.32627083100176,0.981735251938507,414
-7.6926,53.28823,2021/06/11 23:00:00+00,Sat 12 Jun 2021,12209,19713,104,2295994,1100851,72383,2368377,1173234,50.2956843275945,24.9152085611374,415
-7.6926,53.28823,2021/01/31 00:00:00+00,Sun 31 Jan 2021,225,4086,0,156853,50312,3,156856,50315,3.33104900988701,1.06850698049462,416
-7.6926,53.28823,2021/06/12 23:00:00+00,Sun 13 Jun 2021,8545,18169,832,2304539,1119020,73215,2377754,1192235,50.4948175871811,25.318720458909,417
-7.6926,53.28823,2021/02/01 00:00:00+00,Mon 01 Feb 2021,1024,8335,0,157877,58647,3,157880,58650,3.35279503290254,1.24551196275484,418
-7.6926,53.28823,2021/06/13 23:00:00+00,Mon 14 Jun 2021,16015,31301,49,2320554,1150321,73264,2393818,1223585,50.8359583232372,25.9844800502537,419
-7.6926,53.28823,2021/02/02 00:00:00+00,Tue 02 Feb 2021,826,5108,0,158703,63755,3,158706,63758,3.37033625849905,1.35398724162529,420
-7.6926,53.28823,2021/06/14 23:00:00+00,Tue 15 Jun 2021,14690,41580,205,2335244,1191901,73469,2408713,1265370,51.1522737654407,26.8718409601209,421
-7.6926,53.28823,2021/02/03 00:00:00+00,Wed 03 Feb 2021,1397,6865,0,160100,70620,3,160103,70623,3.4000034402888,1.49977478850188,422
-7.6926,53.28823,2021/06/15 23:00:00+00,Wed 16 Jun 2021,13466,48386,215,2348710,1240287,73684,2422394,1313971,51.4428082780144,27.9039488356852,423
-7.6926,53.28823,2021/02/04 00:00:00+00,Thu 04 Feb 2021,1428,10541,1,161528,81161,4,161532,81165,3.43035018529778,1.72364839653873,424
-7.6926,53.28823,2021/06/16 23:00:00+00,Thu 17 Jun 2021,21569,42675,535,2370279,1282962,74219,2444498,1357181,51.9122165717012,28.821571545159,425
-7.6926,53.28823,2021/02/05 00:00:00+00,Fri 05 Feb 2021,3391,8613,0,164919,89774,4,164923,89778,3.50236265018613,1.90655708426605,426
-7.6926,53.28823,2021/06/17 23:00:00+00,Fri 18 Jun 2021,12012,50035,553,2382291,1332997,74772,2457063,1407769,52.1790513170041,29.8958760493677,427
-7.6926,53.28823,2021/02/06 00:00:00+00,Sat 06 Feb 2021,897,3867,0,165816,93641,4,165820,93645,3.52141165667532,1.98867805204053,428
-7.6926,53.28823,2021/06/18 23:00:00+00,Sat 19 Jun 2021,6307,32799,432,2388598,1365796,75204,2463802,1441000,52.322163083705,30.6015812161931,429
-7.6926,53.28823,2021/02/07 00:00:00+00,Sun 07 Feb 2021,329,1300,2,166145,94941,6,166151,94947,3.52844088872428,2.01632778052317,430
-7.6926,53.28823,2021/06/19 23:00:00+00,Sun 20 Jun 2021,8514,26136,177,2397112,1391932,75381,2472493,1467313,52.5067282067792,31.1603733095599,431
-7.6926,53.28823,2021/02/08 00:00:00+00,Mon 08 Feb 2021,1179,879,0,167324,95820,6,167330,95826,3.55347854608299,2.03499453270154,432
-7.6926,53.28823,2021/02/09 00:00:00+00,Tue 09 Feb 2021,4261,543,2,171585,96363,8,171593,96371,3.6440091086955,2.04656834377914,433
-7.6926,53.28823,2021/02/10 00:00:00+00,Wed 10 Feb 2021,8823,580,0,180408,96943,8,180416,96951,3.83137743004905,2.05888542712778,434
-7.6926,53.28823,2021/02/11 00:00:00+00,Thu 11 Feb 2021,6179,445,0,186587,97388,8,186595,97396,3.96259684041329,2.06833560314527,435
-7.6926,53.28823,2021/02/12 00:00:00+00,Fri 12 Feb 2021,4393,524,0,190980,97912,8,190988,97920,4.05588812860394,2.07946345086025,436
-7.6926,53.28823,2021/02/13 00:00:00+00,Sat 13 Feb 2021,1208,1914,0,192188,99826,8,192196,99834,4.08154164013008,2.12010982591077,437
-7.6926,53.28823,2021/02/14 00:00:00+00,Sun 14 Feb 2021,2698,27,0,194886,99853,8,194894,99861,4.13883731405186,2.120683207377,438
-7.6926,53.28823,2021/02/15 00:00:00+00,Mon 15 Feb 2021,1962,7890,0,196848,107743,8,196856,107751,4.18050303393123,2.28823801361972,439
-7.6926,53.28823,2021/02/16 00:00:00+00,Tue 16 Feb 2021,5648,8158,0,202496,115901,8,202504,115909,4.30044594212627,2.46148416182354,440
-7.6926,53.28823,2021/02/17 00:00:00+00,Wed 17 Feb 2021,9741,8465,0,212237,124366,8,212245,124374,4.50730923333164,2.6412498696619,441
-7.6926,53.28823,2021/02/18 00:00:00+00,Thu 18 Feb 2021,8463,8350,1,220700,132716,9,220709,132725,4.6870537048194,2.81859463353173,442
-7.6926,53.28823,2021/02/19 00:00:00+00,Fri 19 Feb 2021,9384,6582,0,230084,139298,9,230093,139307,4.88633561886017,2.95837229318821,443
-7.6926,53.28823,2021/02/20 00:00:00+00,Sat 20 Feb 2021,5885,3568,2,235969,142866,11,235980,142877,5.01135401484888,3.03418606483415,444
-7.6926,53.28823,2021/02/21 00:00:00+00,Sun 21 Feb 2021,1109,1024,5,237078,143890,16,237094,143906,5.03501130941851,3.05603826960269,445
-7.6926,53.28823,2021/02/22 00:00:00+00,Mon 22 Feb 2021,3943,1123,1,241021,145013,17,241038,145030,5.11876747618927,3.07990792767833,446
-7.6926,53.28823,2021/02/23 00:00:00+00,Tue 23 Feb 2021,13362,1064,1,254383,146077,18,254401,146095,5.40254882927185,3.10252464106851,447
-7.6926,53.28823,2021/02/24 00:00:00+00,Wed 24 Feb 2021,16936,2104,3,271319,148181,21,271340,148202,5.76227137210397,3.14726963178504,448
-7.6926,53.28823,2021/02/25 00:00:00+00,Thu 25 Feb 2021,18088,1755,2,289407,149936,23,289430,149959,6.14643695447797,3.18458189979118,449
-7.6926,53.28823,2021/02/26 00:00:00+00,Fri 26 Feb 2021,16079,2768,0,305486,152704,23,305509,152727,6.48789623579315,3.24336411825504,450
-7.6926,53.28823,2021/02/27 00:00:00+00,Sat 27 Feb 2021,8991,704,1,314477,153408,24,314501,153432,6.67885350039829,3.25833574542882,451
-7.6926,53.28823,2021/02/28 00:00:00+00,Sun 28 Feb 2021,2443,57,2,316920,153465,26,316946,153491,6.73077637761799,3.25958869011429,452
-7.6926,53.28823,2021/03/01 00:00:00+00,Mon 01 Mar 2021,5594,795,0,322514,154260,26,322540,154286,6.84957252288057,3.27647158884217,453
-7.6926,53.28823,2021/03/02 00:00:00+00,Tue 02 Mar 2021,12180,1610,0,334694,155870,26,334720,155896,7.10823127320204,3.31066211330995,454
-7.6926,53.28823,2021/03/03 00:00:00+00,Wed 03 Mar 2021,12901,1504,1,347595,157374,27,347622,157401,7.3822226686575,3.34262282096461,455
-7.6926,53.28823,2021/03/04 00:00:00+00,Thu 04 Mar 2021,18738,1688,4,366333,159062,31,366364,159093,7.78023435162342,3.37855472618168,456
-7.6926,53.28823,2021/03/05 00:00:00+00,Fri 05 Mar 2021,18445,2396,6,384778,161458,37,384815,161495,8.17206625656442,3.42956444032554,457
-7.6926,53.28823,2021/03/06 00:00:00+00,Sat 06 Mar 2021,10396,140,4,395174,161598,41,395215,161639,8.39292430281592,3.4326224748121,458
-7.6926,53.28823,2021/03/07 00:00:00+00,Sun 07 Mar 2021,1520,13,3,396694,161611,44,396738,161655,8.4252672647814,3.43296225642171,459
-7.6926,53.28823,2021/03/08 00:00:00+00,Mon 08 Mar 2021,6666,1496,5,403360,163107,49,403409,163156,8.56693495964138,3.46483801867397,460
-7.6926,53.28823,2021/03/09 00:00:00+00,Tue 09 Mar 2021,13829,3103,6,417189,166210,55,417244,166265,8.86073987020767,3.53086183269281,461
-7.6926,53.28823,2021/03/10 00:00:00+00,Wed 10 Mar 2021,13732,3988,3,430921,170198,58,430979,170256,9.15242114571386,3.61561610794182,462
-7.6926,53.28823,2021/03/11 00:00:00+00,Thu 11 Mar 2021,18481,2099,3,449402,172297,61,449463,172358,9.54495385022469,3.66025491690535,463
-7.6926,53.28823,2021/03/12 00:00:00+00,Fri 12 Mar 2021,17324,1338,4,466726,173635,65,466791,173700,9.91293733344065,3.68875409941203,464
-7.6926,53.28823,2021/03/13 00:00:00+00,Sat 13 Mar 2021,8305,173,0,475031,173808,65,475096,173873,10.0893052251828,3.69242798806602,465
-7.6926,53.28823,2021/03/14 00:00:00+00,Sun 14 Mar 2021,382,19,2,475413,173827,67,475480,173894,10.0974599838137,3.69287395142864,466
-7.6926,53.28823,2021/03/15 00:00:00+00,Mon 15 Mar 2021,2653,992,0,478066,174819,67,478133,174886,10.1538000219584,3.71394041122494,467
-7.6926,53.28823,2021/03/16 00:00:00+00,Tue 16 Mar 2021,8942,3823,2,487008,178642,69,487077,178711,10.3437379417347,3.79516945227417,468
-7.6926,53.28823,2021/03/17 00:00:00+00,Wed 17 Mar 2021,4900,2415,6,491908,181057,75,491983,181132,10.4479234777837,3.84658265707945,469
-7.6926,53.28823,2021/03/18 00:00:00+00,Thu 18 Mar 2021,11727,4681,5,503635,185738,80,503715,185818,10.6970683430359,3.94609619599623,470
-7.6926,53.28823,2021/03/19 00:00:00+00,Fri 19 Mar 2021,10368,6128,2,514003,191866,82,514085,191948,10.9172892987693,4.076275025181,471
-7.6926,53.28823,2021/03/20 00:00:00+00,Sat 20 Mar 2021,5239,3118,4,519242,194984,86,519328,195070,11.0286314849709,4.14257491175765,472
-7.6926,53.28823,2021/03/21 00:00:00+00,Sun 21 Mar 2021,3638,55,3,522880,195039,89,522969,195128,11.1059530375096,4.14380662009252,473
-7.6926,53.28823,2021/03/22 00:00:00+00,Mon 22 Mar 2021,7412,2403,1,530292,197442,90,530382,197532,11.2633781045155,4.19485880693758,474
-7.6926,53.28823,2021/03/23 00:00:00+00,Tue 23 Mar 2021,12562,7391,4,542854,204833,94,542948,204927,11.530234086169,4.35190161963275,475
-7.6926,53.28823,2021/03/24 00:00:00+00,Wed 24 Mar 2021,13625,9779,2,556479,214612,96,556575,214708,11.8196218358103,4.55961436486216,476
-7.6926,53.28823,2021/03/25 00:00:00+00,Thu 25 Mar 2021,20863,10226,3,577342,224838,99,577441,224937,12.262739527453,4.77684099516087,477
-7.6926,53.28823,2021/03/26 00:00:00+00,Fri 26 Mar 2021,19695,9497,1,597037,234335,100,597137,234435,12.6810106888923,4.97854385317017,478
-7.6926,53.28823,2021/03/27 00:00:00+00,Sat 27 Mar 2021,11750,5350,3,608787,239685,103,608890,239788,12.9306015175071,5.09222203793789,479
-7.6926,53.28823,2021/03/28 00:00:00+00,Sun 28 Mar 2021,2491,483,0,611278,240168,103,611381,240271,12.9835012668545,5.10247919527822,480
-7.6926,53.28823,2021/03/28 23:00:00+00,Mon 29 Mar 2021,9269,3119,3,620547,243287,106,620653,243393,13.1804047096279,5.16877908185488,481
-7.6926,53.28823,2021/03/29 23:00:00+00,Tue 30 Mar 2021,13324,8667,4,633871,251954,110,633981,252064,13.4634427904395,5.35291947791706,482
-7.6926,53.28823,2021/03/30 23:00:00+00,Wed 31 Mar 2021,15834,10512,4,649705,262466,114,649819,262580,13.7997841112598,5.57624094083829,483
-7.6926,53.28823,2021/03/31 23:00:00+00,Thu 01 Apr 2021,19698,11577,8,669403,274043,122,669525,274165,14.2182676362052,5.8222640625521,484
-7.6926,53.28823,2021/04/01 23:00:00+00,Fri 02 Apr 2021,20139,13721,9,689542,287764,131,689673,287895,14.6461376281162,6.11383915630527,485
-7.6926,53.28823,2021/04/02 23:00:00+00,Sat 03 Apr 2021,7548,4635,6,697090,292399,137,697227,292536,14.806557020557,6.21239705944501,486
-7.6926,53.28823,2021/04/03 23:00:00+00,Sun 04 Apr 2021,3034,169,3,700124,292568,140,700264,292708,14.8710518173326,6.2160497117484,487
-7.6926,53.28823,2021/04/04 23:00:00+00,Mon 05 Apr 2021,3430,607,4,703554,293175,144,703698,293319,14.9439774452968,6.22902512196567,488
-7.6926,53.28823,2021/04/05 23:00:00+00,Tue 06 Apr 2021,11991,8149,11,715545,301324,155,715700,301479,15.1988561252112,6.40231374287069,489
-7.6926,53.28823,2021/04/06 23:00:00+00,Wed 07 Apr 2021,18357,10468,10,733902,311792,165,734067,311957,15.5889041767017,6.62482822446908,490
-7.6926,53.28823,2021/04/07 23:00:00+00,Thu 08 Apr 2021,20183,10575,15,754085,322367,180,754265,322547,16.0178359861429,6.84972117733478,491
-7.6926,53.28823,2021/04/08 23:00:00+00,Fri 09 Apr 2021,20676,9154,16,774761,331521,196,774957,331717,16.4572585527809,7.04445851234692,492
-7.6926,53.28823,2021/04/09 23:00:00+00,Sat 10 Apr 2021,11167,4168,12,785928,335689,208,786136,335897,16.6946597161507,7.13322645785954,493
-7.6926,53.28823,2021/04/10 23:00:00+00,Sun 11 Apr 2021,2861,362,8,788789,336051,216,789005,336267,16.7555868060253,7.14108390758195,494
-7.6926,53.28823,2021/04/11 23:00:00+00,Mon 12 Apr 2021,7776,2796,13,796565,338847,229,796794,339076,16.9209967408573,7.20073681642046,495
-7.6926,53.28823,2021/04/12 23:00:00+00,Tue 13 Apr 2021,11513,8594,1,808078,347441,230,808308,347671,17.1655120816784,7.38326324983696,496
-7.6926,53.28823,2021/04/13 23:00:00+00,Wed 14 Apr 2021,20352,6596,2,828430,354037,232,828662,354269,17.5977567618133,7.52338069110305,497
-7.6926,53.28823,2021/04/14 23:00:00+00,Thu 15 Apr 2021,27124,10807,1,855554,364844,233,855787,365077,18.1737927718683,7.7529031683998,498
-7.6926,53.28823,2021/06/20 23:00:00+00,Mon 21 Jun 2021,15467,32338,572,2412579,1424270,75953,2488532,1500223,52.8473380340703,31.8592616078423,499
-7.6926,53.28823,2021/06/21 23:00:00+00,Tue 22 Jun 2021,15130,43541,722,2427709,1467811,76675,2504384,1544486,53.1839766637991,32.7992461944991,500
-7.6926,53.28823,2021/06/22 23:00:00+00,Wed 23 Jun 2021,20080,39384,883,2447789,1507195,77558,2525347,1584753,53.62915428145,33.6543703241538,501
-7.6926,53.28823,2021/06/23 23:00:00+00,Thu 24 Jun 2021,19018,44266,1031,2466807,1551461,78589,2545396,1630050,54.0549218746516,34.6163132973321,502
-7.6926,53.28823,2021/06/24 23:00:00+00,Fri 25 Jun 2021,15202,50116,843,2482009,1601577,79432,2561441,1681009,54.3956591200463,35.6984964876138,503
-7.6926,53.28823,2021/06/25 23:00:00+00,Sat 26 Jun 2021,9054,30548,510,2491063,1632125,79942,2571005,1712067,54.5987635771953,36.3580550645829,504
-7.6926,53.28823,2021/06/26 23:00:00+00,Sun 27 Jun 2021,8724,30473,58,2499787,1662598,80000,2579787,1742598,54.7852612081742,37.0064220847853,505
-7.6926,53.28823,2021/06/27 23:00:00+00,Mon 28 Jun 2021,24222,24634,522,2524009,1687232,80522,2604531,1767754,55.310733467448,37.5406437205067,506
-7.6926,53.28823,2021/06/28 23:00:00+00,Tue 29 Jun 2021,28143,31024,809,2552152,1718256,81331,2633483,1799587,55.9255682900512,38.2166604691917,507
-7.6926,53.28823,2021/06/29 23:00:00+00,Wed 30 Jun 2021,22561,36859,588,2574713,1755115,81919,2656632,1837034,56.4171685701162,39.0118980901513,508
-7.6926,53.28823,2021/06/30 23:00:00+00,Thu 01 Jul 2021,15003,48309,638,2589716,1803424,82557,2672273,1885981,56.7493263298681,40.0513537430236,509
-7.6926,53.28823,2021/07/01 23:00:00+00,Fri 02 Jul 2021,13657,47256,815,2603373,1850680,83372,2686745,1934052,57.0566587957673,41.0722063527693,510
-7.6926,53.28823,2021/07/02 23:00:00+00,Sat 03 Jul 2021,9305,30470,505,2612678,1881150,83877,2696555,1965027,57.2649873951641,41.7300023126386,511
-7.6926,53.28823,2021/07/03 23:00:00+00,Sun 04 Jul 2021,6446,27778,233,2619124,1908928,84110,2703234,1993038,57.4068249808289,42.3248537293261,512
-7.6926,53.28823,2021/07/04 23:00:00+00,Mon 05 Jul 2021,15597,33446,5342,2634721,1942374,89452,2724173,2031826,57.8514929260654,43.1485692964418,513
-7.6926,53.28823,2021/07/05 23:00:00+00,Tue 06 Jul 2021,12406,48288,5486,2647127,1990662,94938,2742065,2085600,58.2314537110204,44.2905328136657,514
-7.6926,53.28823,2021/07/06 23:00:00+00,Wed 07 Jul 2021,19700,43750,5058,2666827,2034412,99996,2766823,2134408,58.7572232792026,45.3270366138044,515
-7.6926,53.28823,2021/07/07 23:00:00+00,Thu 08 Jul 2021,17762,45581,5993,2684589,2079993,105989,2790578,2185982,59.2616927877318,46.4222801597059,516
-7.6926,53.28823,2021/07/08 23:00:00+00,Fri 09 Jul 2021,13513,45082,6528,2698102,2125075,112517,2810619,2237592,59.6872904901286,47.5182882142289,517
-7.6926,53.28823,2021/07/09 23:00:00+00,Sat 10 Jul 2021,8630,23860,4364,2706732,2148935,116881,2823613,2265816,59.9632356298394,48.1176629735945,518
-7.6926,53.28823,2021/07/10 23:00:00+00,Sun 11 Jul 2021,15228,16105,2153,2721960,2165040,119034,2840994,2284074,60.3323446396372,48.5053962628695,519
-7.6926,53.28823,2021/07/11 23:00:00+00,Mon 12 Jul 2021,17104,31748,6091,2739064,2196788,125125,2864189,2321913,60.8249217918298,49.3089585332647,520
-7.6926,53.28823,2021/07/12 23:00:00+00,Tue 13 Jul 2021,20097,36558,8487,2759161,2233346,133612,2892773,2366958,61.4319416374118,50.2655499460915,521
-7.6926,53.28823,2021/07/13 23:00:00+00,Wed 14 Jul 2021,20790,35697,9332,2779951,2269043,142944,2922895,2411987,62.0716229902183,51.2218015773087,522
-7.6926,53.28823,2021/07/14 23:00:00+00,Thu 15 Jul 2021,23626,28826,9583,2803577,2297869,152527,2956104,2450396,62.7768609573304,52.0374685675466,523
-7.6926,53.28823,2021/07/15 23:00:00+00,Fri 16 Jul 2021,23523,27412,9163,2827100,2325281,161690,2988790,2486971,63.4709923130782,52.814188090782,524
-7.6926,53.28823,2021/07/16 23:00:00+00,Sat 17 Jul 2021,11496,19421,4676,2838596,2344702,166366,3004962,2511068,63.8144265749993,53.3259204312168,525
-7.6926,53.28823,2021/07/17 23:00:00+00,Sun 18 Jul 2021,16857,15813,1930,2855453,2360515,168296,3023749,2528811,64.2133938937422,53.7027169999323,526
-7.6926,53.28823,2021/07/18 23:00:00+00,Mon 19 Jul 2021,24875,18425,6252,2880328,2378940,174548,3054876,2553488,64.8744177789028,54.2267664237157,527
-7.6926,53.28823,2021/07/19 23:00:00+00,Tue 20 Jul 2021,30568,18166,7695,2910896,2397106,182243,3093139,2579349,65.6869842619529,54.7759596866109,528
-7.6926,53.28823,2021/07/20 23:00:00+00,Wed 21 Jul 2021,30347,19835,6886,2941243,2416941,189129,3130372,2606070,66.4776773038839,55.3434162110231,529
-7.6926,53.28823,2021/07/21 23:00:00+00,Thu 22 Jul 2021,33523,15925,6933,2974766,2432866,196062,3170828,2628928,67.3368151038022,55.8288367130631,530
-7.6926,53.28823,2021/07/22 23:00:00+00,Fri 23 Jul 2021,27082,20818,5614,3001848,2453684,201676,3203524,2655360,68.031158823056,56.3901559321516,531
-7.6926,53.28823,2021/07/23 23:00:00+00,Sat 24 Jul 2021,15427,14802,2272,3017275,2468486,203948,3221223,2672434,68.4070209923449,56.7527453823148,532
-7.6926,53.28823,2021/07/24 23:00:00+00,Sun 25 Jul 2021,14712,13639,1042,3031987,2482125,204990,3236977,2687115,68.7415784597147,57.0645162454897,533
-7.6926,53.28823,2021/07/25 23:00:00+00,Mon 26 Jul 2021,23820,18281,3419,3055807,2500406,208409,3264216,2708815,69.3200354137383,57.5253450535336,534
-7.6926,53.28823,2021/07/26 23:00:00+00,Tue 27 Jul 2021,25497,23892,3670,3081304,2524298,212079,3293383,2736377,69.9394360517207,58.1106613488013,535
-7.6926,53.28823,2021/07/27 23:00:00+00,Wed 28 Jul 2021,23426,25275,3261,3104730,2549573,215340,3320070,2764913,70.5061705402124,58.7166618495545,536
-7.6926,53.28823,2021/07/28 23:00:00+00,Thu 29 Jul 2021,19254,27855,2960,3123984,2577428,218300,3342284,2795728,70.9779148324654,59.3710599933275,537
-7.6926,53.28823,2021/07/29 23:00:00+00,Fri 30 Jul 2021,21943,22931,2115,3145927,2600359,220415,3366342,2820774,71.4888189552268,59.9029456304828,538
-7.6926,53.28823,2021/07/30 23:00:00+00,Sat 31 Jul 2021,13733,12473,907,3159660,2612832,221322,3380982,2834154,71.799719128027,60.1870880015256,539
-7.6926,53.28823,2021/07/31 23:00:00+00,Sun 01 Aug 2021,11097,9318,368,3170757,2622150,221690,3392447,2843840,72.0431938876686,60.3927832934479,540
-7.6926,53.28823,2021/08/01 23:00:00+00,Mon 02 Aug 2021,15011,15998,430,3185768,2638148,222120,3407888,2860268,72.3711043773003,60.7416540611229,541
