X,Y,VaccinationDate,VaccineText,Dose1,Dose2,SingleDose,Dose1Cum,Dose2Cum,SingleDoseCum,PartiallyVacc,FullyVacc,PartialPercent,FullyPercent,ObjectId
-7.6926,53.28823,2022/02/13 00:00:00+00,Sun 13 Feb 2022,1566,4706,0,3820347,3726700,241030,4061377,3967730,84.6381352246391,82.6865539138222,1
-7.6926,53.28823,2021/11/02 00:00:00+00,Tue 02 Nov 2021,1100,1099,10,3624262,3559697,240864,3865126,3800561,80.5483108434081,79.2027915279694,2
-7.6926,53.28823,2022/02/14 00:00:00+00,Mon 14 Feb 2022,174,954,0,3820521,3727654,241030,4061551,3968684,84.6417613434478,82.7064350479804,3
-7.6926,53.28823,2022/02/15 00:00:00+00,Tue 15 Feb 2022,649,817,1,3821170,3728471,241031,4062201,3969502,84.6553071895725,82.7234819743342,4
-7.6926,53.28823,2021/11/03 00:00:00+00,Wed 03 Nov 2021,2538,1883,7,3626800,3561580,240871,3867671,3802451,80.6013480409268,79.2421786805471,5
-7.6926,53.28823,2022/02/16 00:00:00+00,Wed 16 Feb 2022,798,1786,0,3821968,3730257,241031,4062999,3971288,84.6719373206608,82.7607017915319,6
-7.6926,53.28823,2022/02/17 00:00:00+00,Thu 17 Feb 2022,790,1194,2,3822758,3731451,241033,4063791,3972484,84.6884424131696,82.7856261484012,7
-7.6926,53.28823,2021/04/09 23:00:00+00,Sat 10 Apr 2021,11186,4184,12,787467,336245,236,787703,336481,16.4155440459859,7.01218438439027,8
-7.6926,53.28823,2021/11/04 00:00:00+00,Thu 04 Nov 2021,1537,1288,2,3628337,3562868,240873,3869210,3803741,80.6334204365972,79.2690619751636,9
-7.6926,53.28823,2021/04/10 23:00:00+00,Sun 11 Apr 2021,2868,368,9,790335,336613,245,790580,336858,16.4755000449097,7.02004097514254,10
-7.6926,53.28823,2022/02/18 00:00:00+00,Fri 18 Feb 2022,792,3295,0,3823550,3734746,241033,4064583,3975779,84.7049475056783,82.8542931683713,11
-7.6926,53.28823,2021/11/05 00:00:00+00,Fri 05 Nov 2021,1630,1103,4,3629967,3563971,240877,3870844,3804848,80.6674726097781,79.292131593102,12
-7.6926,53.28823,2021/04/11 23:00:00+00,Mon 12 Apr 2021,7787,2807,13,798122,339420,258,798380,339678,16.638050198405,7.07880910756006,13
-7.6926,53.28823,2022/02/19 00:00:00+00,Sat 19 Feb 2022,980,3555,0,3824530,3738301,241033,4065563,3979334,84.7253704736816,82.9283785267913,14
-7.6926,53.28823,2021/11/06 00:00:00+00,Sat 06 Nov 2021,1822,1359,6,3631789,3565330,240883,3872672,3806213,80.7055676970332,79.3205778699636,15
-7.6926,53.28823,2021/04/12 23:00:00+00,Tue 13 Apr 2021,11529,8594,1,809651,348014,259,809910,348273,16.8783326688922,7.2579268728539,16
-7.6926,53.28823,2022/02/20 00:00:00+00,Sun 20 Feb 2022,1365,3588,0,3825895,3741889,241033,4066928,3982922,84.7538167505432,83.0031515973991,17
-7.6926,53.28823,2021/11/07 00:00:00+00,Sun 07 Nov 2021,698,775,0,3632487,3566105,240883,3873370,3806988,80.7201138517947,79.3367286864968,18
-7.6926,53.28823,2022/02/21 00:00:00+00,Mon 21 Feb 2022,254,995,1,3826149,3742884,241034,4067183,3983918,84.7591308901767,83.0239080016147,19
-7.6926,53.28823,2021/04/13 23:00:00+00,Wed 14 Apr 2021,20353,6600,2,830004,354614,261,830265,354875,17.3025260502251,7.39551098995336,20
-7.6926,53.28823,2021/11/08 00:00:00+00,Mon 08 Nov 2021,516,536,4,3633003,3566641,240887,3873890,3807528,80.7309505286944,79.3479821586619,21
-7.6926,53.28823,2022/02/22 00:00:00+00,Tue 22 Feb 2022,475,981,1,3826624,3743865,241035,4067659,3984900,84.7690506174926,83.0443726491445,22
-7.6926,53.28823,2021/04/14 23:00:00+00,Thu 15 Apr 2021,27115,10820,1,857119,365434,262,857381,365696,17.8676170710171,7.62101806828315,23
-7.6926,53.28823,2021/11/09 00:00:00+00,Tue 09 Nov 2021,1373,1071,4,3634376,3567712,240891,3875267,3808603,80.7596468827153,79.3703849041756,24
-7.6926,53.28823,2022/02/23 00:00:00+00,Wed 23 Feb 2022,829,1273,1,3827453,3745138,241036,4068489,3986174,84.7863476210056,83.0709225075487,25
-7.6926,53.28823,2021/04/15 23:00:00+00,Fri 16 Apr 2021,27969,9845,1,885088,375279,263,885351,375542,18.4505052496406,7.82620637742603,26
-7.6926,53.28823,2021/11/10 00:00:00+00,Wed 10 Nov 2021,1602,1369,2,3635978,3569081,240893,3876871,3809974,80.7930738629981,79.3989562196169,27
-7.6926,53.28823,2022/02/24 00:00:00+00,Thu 24 Feb 2022,653,1235,0,3828106,3746373,241036,4069142,3987409,84.79995598642,83.0966596151854,28
-7.6926,53.28823,2021/04/16 23:00:00+00,Sat 17 Apr 2021,15856,4564,3,900944,379843,266,901210,380109,18.7810030553177,7.92138157627385,29
-7.6926,53.28823,2020/12/28 00:00:00+00,Mon 28 Dec 2020,272,18,2,272,18,2,274,20,0.0057100951356033,0.000416795265372503,30
-7.6926,53.28823,2021/11/11 00:00:00+00,Thu 11 Nov 2021,1394,1126,2,3637372,3570207,240895,3878267,3811102,80.8221661725212,79.4224634725839,31
-7.6926,53.28823,2022/02/25 00:00:00+00,Fri 25 Feb 2022,692,1228,0,3828798,3747601,241036,4069834,3988637,84.8143771026019,83.1222508444793,32
-7.6926,53.28823,2021/04/17 23:00:00+00,Sun 18 Apr 2021,1080,486,0,902024,380329,266,902290,380595,18.8035099996478,7.9315097012224,33
-7.6926,53.28823,2020/12/29 00:00:00+00,Tue 29 Dec 2020,80,3,0,352,21,2,354,23,0.00737727619709331,0.000479314555178379,34
-7.6926,53.28823,2021/11/12 00:00:00+00,Fri 12 Nov 2021,1143,1161,6,3638515,3571368,240901,3879416,3812269,80.8461110605168,79.4467834763184,35
-7.6926,53.28823,2022/02/26 00:00:00+00,Sat 26 Feb 2022,960,2092,0,3829758,3749693,241036,4070794,3990729,84.8343832753397,83.1658476292373,36
-7.6926,53.28823,2020/12/30 00:00:00+00,Wed 30 Dec 2020,1063,2,0,1415,23,2,1417,25,0.0295299445516419,0.000520994081715629,37
-7.6926,53.28823,2021/04/18 23:00:00+00,Mon 19 Apr 2021,6758,2264,0,908782,382593,266,909048,382859,18.9443451198172,7.97869092526257,38
-7.6926,53.28823,2021/11/13 00:00:00+00,Sat 13 Nov 2021,1396,1384,0,3639911,3572752,240901,3880812,3813653,80.8752033700398,79.4756257086822,39
-7.6926,53.28823,2022/02/27 00:00:00+00,Sun 27 Feb 2022,671,1783,0,3830429,3751476,241036,4071465,3992512,84.848366756493,83.2030049271452,40
-7.6926,53.28823,2020/12/31 00:00:00+00,Thu 31 Dec 2020,1041,1,0,2456,24,2,2458,26,0.0512241381142807,0.000541833844984254,41
-7.6926,53.28823,2021/04/19 23:00:00+00,Tue 20 Apr 2021,15099,7326,1,923881,389919,267,924148,390186,19.2590255451734,8.13138387073178,42
-7.6926,53.28823,2022/09/07 23:00:00+00,Thu 08 Sep 2022,39,50,2,3857488,3811770,241072,4098560,4052842,85.4130201422564,84.4602678451414,43
-7.6926,53.28823,2022/02/28 00:00:00+00,Mon 28 Feb 2022,81,435,0,3830510,3751911,241036,4071546,3992947,84.8500547773178,83.2120702241671,44
-7.6926,53.28823,2021/11/14 00:00:00+00,Sun 14 Nov 2021,1646,1808,1,3641557,3574560,240902,3882459,3815462,80.9095264601432,79.5133248404351,45
-7.6926,53.28823,2021/01/01 00:00:00+00,Fri 01 Jan 2021,819,0,0,3275,24,2,3277,26,0.0682919042312847,0.000541833844984254,46
-7.6926,53.28823,2021/04/20 23:00:00+00,Wed 21 Apr 2021,26738,9898,4,950619,399817,271,950890,400088,19.816322494503,8.33773920661771,47
-7.6926,53.28823,2022/09/08 23:00:00+00,Fri 09 Sep 2022,63,61,0,3857551,3811831,241072,4098623,4052903,85.4143330473423,84.4615390707008,48
-7.6926,53.28823,2022/03/01 00:00:00+00,Tue 01 Mar 2022,132,936,0,3830642,3752847,241036,4071678,3993883,84.8528056260692,83.2315762425865,49
-7.6926,53.28823,2021/11/15 00:00:00+00,Mon 15 Nov 2021,1243,598,1,3642800,3575158,240903,3883703,3816061,80.9354511256494,79.525807858633,50
-7.6926,53.28823,2021/01/02 00:00:00+00,Sat 02 Jan 2021,1020,0,0,4295,24,2,4297,26,0.0895484627652824,0.000541833844984254,51
-7.6926,53.28823,2021/04/21 23:00:00+00,Thu 22 Apr 2021,31637,12193,1,982256,412010,272,982528,412282,20.4756509247958,8.59185927991532,52
-7.6926,53.28823,2022/03/02 00:00:00+00,Wed 02 Mar 2022,206,997,2,3830848,3753844,241038,4071886,3994882,84.8571402968291,83.2523951660919,53
-7.6926,53.28823,2022/03/03 00:00:00+00,Thu 03 Mar 2022,278,1277,0,3831126,3755121,241038,4072164,3996159,84.8629337510178,83.2790075437859,54
-7.6926,53.28823,2022/03/04 00:00:00+00,Fri 04 Mar 2022,735,1508,1,3831861,3756629,241039,4072900,3997668,84.8782718167835,83.3104547465583,55
-7.6926,53.28823,2022/03/05 00:00:00+00,Sat 05 Mar 2022,962,3341,0,3832823,3759970,241039,4073862,4001009,84.8983196690479,83.3800803956387,56
-7.6926,53.28823,2022/03/06 00:00:00+00,Sun 06 Mar 2022,455,1916,0,3833278,3761886,241039,4074317,4002925,84.9078017613351,83.4200093820614,57
-7.6926,53.28823,2022/03/07 00:00:00+00,Mon 07 Mar 2022,116,124,1,3833394,3762010,241040,4074434,4003050,84.9102400136375,83.42261435247,58
-7.6926,53.28823,2022/03/08 00:00:00+00,Tue 08 Mar 2022,120,493,0,3833514,3762503,241040,4074554,4003543,84.9127407852298,83.4328883557614,59
-7.6926,53.28823,2022/03/09 00:00:00+00,Wed 09 Mar 2022,129,345,1,3833643,3762848,241041,4074684,4003889,84.9154499544547,83.4400989138524,60
-7.6926,53.28823,2022/03/10 00:00:00+00,Thu 10 Mar 2022,259,508,0,3833902,3763356,241041,4074943,4004397,84.9208474531413,83.4506855135928,61
-7.6926,53.28823,2022/03/11 00:00:00+00,Fri 11 Mar 2022,492,2183,0,3834394,3765539,241041,4075435,4006580,84.9311006166694,83.4961787168082,62
-7.6926,53.28823,2022/03/12 00:00:00+00,Sat 12 Mar 2022,473,2391,2,3834867,3767930,241043,4075910,4008973,84.940999504222,83.5460482703101,63
-7.6926,53.28823,2022/03/13 00:00:00+00,Sun 13 Mar 2022,358,1082,0,3835225,3769012,241043,4076268,4010055,84.9484601394722,83.5685968941667,64
-7.6926,53.28823,2022/03/14 00:00:00+00,Mon 14 Mar 2022,109,122,0,3835334,3769134,241043,4076377,4010177,84.9507316736685,83.5711393452855,65
-7.6926,53.28823,2022/03/15 00:00:00+00,Tue 15 Mar 2022,222,755,1,3835556,3769889,241044,4076600,4010933,84.9553789408774,83.5868942063166,66
-7.6926,53.28823,2022/03/16 00:00:00+00,Wed 16 Mar 2022,195,798,0,3835751,3770687,241044,4076795,4011731,84.9594426947148,83.6035243374049,67
-7.6926,53.28823,2022/03/18 00:00:00+00,Fri 18 Mar 2022,3,6,0,3835754,3770693,241044,4076798,4011737,84.9595052140046,83.6036493759845,68
-7.6926,53.28823,2022/03/19 00:00:00+00,Sat 19 Mar 2022,743,2778,0,3836497,3773471,241044,4077541,4014515,84.9749891581132,83.6615422383448,69
-7.6926,53.28823,2022/03/20 00:00:00+00,Sun 20 Mar 2022,395,1402,0,3836892,3774873,241044,4077936,4015917,84.9832208646043,83.6907595864474,70
-7.6926,53.28823,2022/03/21 00:00:00+00,Mon 21 Mar 2022,56,112,0,3836948,3774985,241044,4077992,4016029,84.9843878913473,83.6930936399335,71
-7.6926,53.28823,2022/03/22 00:00:00+00,Tue 22 Mar 2022,141,575,0,3837089,3775560,241044,4078133,4016604,84.9873262979682,83.7050765038129,72
-7.6926,53.28823,2022/03/23 00:00:00+00,Wed 23 Mar 2022,101,221,0,3837190,3775781,241044,4078234,4016825,84.9894311140583,83.7096820914953,73
-7.6926,53.28823,2022/03/24 00:00:00+00,Thu 24 Mar 2022,147,245,0,3837337,3776026,241044,4078381,4017070,84.9924945592588,83.7147878334961,74
-7.6926,53.28823,2022/03/25 00:00:00+00,Fri 25 Mar 2022,434,1625,0,3837771,3777651,241044,4078815,4018695,85.0015390165174,83.7486524488076,75
-7.6926,53.28823,2022/03/26 00:00:00+00,Sat 26 Mar 2022,874,1848,1,3838645,3779499,241045,4079690,4020544,85.0197738093774,83.7871851710913,76
-7.6926,53.28823,2022/03/27 00:00:00+00,Sun 27 Mar 2022,380,803,0,3839025,3780302,241045,4080070,4021347,85.0276929194195,83.803919500996,77
-7.6926,53.28823,2022/03/27 23:00:00+00,Mon 28 Mar 2022,44,53,1,3839069,3780355,241046,4080115,4021401,85.0286307087666,83.8050448482125,78
-7.6926,53.28823,2022/03/28 23:00:00+00,Tue 29 Mar 2022,137,193,3,3839206,3780548,241049,4080255,4021597,85.0315482756242,83.8091294418132,79
-7.6926,53.28823,2022/03/29 23:00:00+00,Wed 30 Mar 2022,109,135,0,3839315,3780683,241049,4080364,4021732,85.0338198098205,83.8119428098545,80
-7.6926,53.28823,2022/03/30 23:00:00+00,Thu 31 Mar 2022,227,360,0,3839542,3781043,241049,4080591,4022092,85.0385504360825,83.8194451246312,81
-7.6926,53.28823,2022/03/31 23:00:00+00,Fri 01 Apr 2022,307,905,0,3839849,3781948,241049,4080898,4022997,85.0449482434059,83.8383051103893,82
-7.6926,53.28823,2022/04/01 23:00:00+00,Sat 02 Apr 2022,729,1538,1,3840578,3783486,241050,4081628,4024536,85.060161270592,83.8703775060597,83
-7.6926,53.28823,2022/04/02 23:00:00+00,Sun 03 Apr 2022,538,817,0,3841116,3784303,241050,4082166,4025353,85.0713730632306,83.8874035926501,84
-7.6926,53.28823,2022/04/03 23:00:00+00,Mon 04 Apr 2022,50,52,0,3841166,3784355,241050,4082216,4025405,85.072415051394,83.8884872603401,85
-7.6926,53.28823,2022/04/04 23:00:00+00,Tue 05 Apr 2022,131,170,0,3841297,3784525,241050,4082347,4025575,85.0751450603822,83.8920300200958,86
-7.6926,53.28823,2022/04/05 23:00:00+00,Wed 06 Apr 2022,158,210,0,3841455,3784735,241050,4082505,4025785,85.0784377429786,83.8964063703822,87
-7.6926,53.28823,2022/04/06 23:00:00+00,Thu 07 Apr 2022,117,178,0,3841572,3784913,241050,4082622,4025963,85.080875995281,83.900115848244,88
-7.6926,53.28823,2022/04/07 23:00:00+00,Fri 08 Apr 2022,256,422,2,3841828,3785335,241052,4082880,4026387,85.0862526542044,83.9089519078699,89
-7.6926,53.28823,2022/04/08 23:00:00+00,Sat 09 Apr 2022,558,1018,0,3842386,3786353,241052,4083438,4027405,85.0978812421082,83.9301667868774,90
-7.6926,53.28823,2022/04/09 23:00:00+00,Sun 10 Apr 2022,413,719,0,3842799,3787072,241052,4083851,4028124,85.1064880643382,83.9451505766675,91
-7.6926,53.28823,2022/04/10 23:00:00+00,Mon 11 Apr 2022,70,93,1,3842869,3787165,241053,4083922,4028218,85.1079676875303,83.9471095144148,92
-7.6926,53.28823,2022/04/11 23:00:00+00,Tue 12 Apr 2022,197,178,0,3843066,3787343,241053,4084119,4028396,85.1120731208942,83.9508189922766,93
-7.6926,53.28823,2022/04/12 23:00:00+00,Wed 13 Apr 2022,142,235,0,3843208,3787578,241053,4084261,4028631,85.1150323672783,83.9557163366447,94
-7.6926,53.28823,2022/04/13 23:00:00+00,Thu 14 Apr 2022,359,431,0,3843567,3788009,241053,4084620,4029062,85.1225138422918,83.9646982746135,95
-7.6926,53.28823,2022/04/14 23:00:00+00,Fri 15 Apr 2022,446,990,0,3844013,3788999,241053,4085066,4030052,85.1318083767096,83.9853296402494,96
-7.6926,53.28823,2022/04/15 23:00:00+00,Sat 16 Apr 2022,43,88,0,3844056,3789087,241053,4085109,4030140,85.1327044865301,83.9871635394171,97
-7.6926,53.28823,2022/04/16 23:00:00+00,Sun 17 Apr 2022,1,1,0,3844057,3789088,241053,4085110,4030141,85.1327253262934,83.9871843791803,98
-7.6926,53.28823,2022/04/17 23:00:00+00,Mon 18 Apr 2022,36,62,1,3844093,3789150,241054,4085147,4030204,85.1334963975343,83.9884972842662,99
-7.6926,53.28823,2022/04/18 23:00:00+00,Tue 19 Apr 2022,218,270,1,3844311,3789420,241055,4085366,4030475,85.1380603056902,83.9941448601121,100
-7.6926,53.28823,2022/04/19 23:00:00+00,Wed 20 Apr 2022,250,607,0,3844561,3790027,241055,4085616,4031082,85.1432702465073,84.0067945964161,101
-7.6926,53.28823,2022/04/20 23:00:00+00,Thu 21 Apr 2022,170,236,0,3844731,3790263,241055,4085786,4031318,85.146813006263,84.0117127805475,102
-7.6926,53.28823,2022/04/21 23:00:00+00,Fri 22 Apr 2022,195,254,0,3844926,3790517,241055,4085981,4031572,85.1508767601004,84.0170060804177,103
-7.6926,53.28823,2022/04/22 23:00:00+00,Sat 23 Apr 2022,325,1010,0,3845251,3791527,241055,4086306,4032582,85.1576496831627,84.038054241319,104
-7.6926,53.28823,2022/04/23 23:00:00+00,Sun 24 Apr 2022,181,252,0,3845432,3791779,241055,4086487,4032834,85.1614216803143,84.0433058616627,105
-7.6926,53.28823,2022/04/24 23:00:00+00,Mon 25 Apr 2022,41,59,1,3845473,3791838,241056,4086529,4032894,85.1622969503716,84.0445562474588,106
-7.6926,53.28823,2022/04/25 23:00:00+00,Tue 26 Apr 2022,144,238,0,3845617,3792076,241056,4086673,4033132,85.1652978762822,84.0495161111168,107
-7.6926,53.28823,2022/04/26 23:00:00+00,Wed 27 Apr 2022,122,208,0,3845739,3792284,241056,4086795,4033340,85.167840327401,84.0538507818767,108
-7.6926,53.28823,2022/04/27 23:00:00+00,Thu 28 Apr 2022,100,130,0,3845839,3792414,241056,4086895,4033470,85.1699243037279,84.0565599511016,109
-7.6926,53.28823,2022/04/28 23:00:00+00,Fri 29 Apr 2022,168,222,0,3846007,3792636,241056,4087063,4033692,85.173425383957,84.0611863785472,110
-7.6926,53.28823,2022/04/29 23:00:00+00,Sat 30 Apr 2022,281,723,0,3846288,3793359,241056,4087344,4034415,85.1792813574355,84.0762535273904,111
-7.6926,53.28823,2022/04/30 23:00:00+00,Sun 01 May 2022,187,747,0,3846475,3794106,241056,4087531,4035162,85.1831783931667,84.0918208305521,112
-7.6926,53.28823,2022/05/01 23:00:00+00,Mon 02 May 2022,12,26,0,3846487,3794132,241056,4087543,4035188,85.1834284703259,84.0923626643971,113
-7.6926,53.28823,2022/05/02 23:00:00+00,Tue 03 May 2022,96,118,0,3846583,3794250,241056,4087639,4035306,85.1854290875997,84.0948217564628,114
-7.6926,53.28823,2022/05/03 23:00:00+00,Wed 04 May 2022,113,128,0,3846696,3794378,241056,4087752,4035434,85.1877839808491,84.0974892461612,115
-7.6926,53.28823,2022/05/04 23:00:00+00,Thu 05 May 2022,112,165,0,3846808,3794543,241056,4087864,4035599,85.1901180343352,84.1009278071005,116
-7.6926,53.28823,2022/05/05 23:00:00+00,Fri 06 May 2022,138,257,0,3846946,3794800,241056,4088002,4035856,85.1929939216662,84.1062836262605,117
-7.6926,53.28823,2022/05/06 23:00:00+00,Sat 07 May 2022,441,1088,0,3847387,3795888,241056,4088443,4036944,85.2021842572677,84.1289572886968,118
-7.6926,53.28823,2022/05/07 23:00:00+00,Sun 08 May 2022,274,437,0,3847661,3796325,241056,4088717,4037381,85.2078943524033,84.1380642652452,119
-7.6926,53.28823,2022/05/08 23:00:00+00,Mon 09 May 2022,24,32,0,3847685,3796357,241056,4088741,4037413,85.2083945067218,84.1387311376698,120
-7.6926,53.28823,2022/05/09 23:00:00+00,Tue 10 May 2022,80,98,1,3847765,3796455,241057,4088822,4037512,85.2100825275465,84.1407942742334,121
-7.6926,53.28823,2022/05/10 23:00:00+00,Wed 11 May 2022,112,132,0,3847877,3796587,241057,4088934,4037644,85.2124165810326,84.1435451229848,122
-7.6926,53.28823,2022/05/11 23:00:00+00,Thu 12 May 2022,207,398,0,3848084,3796985,241057,4089141,4038042,85.2167304120292,84.1518393487657,123
-7.6926,53.28823,2022/05/12 23:00:00+00,Fri 13 May 2022,173,327,0,3848257,3797312,241057,4089314,4038369,85.2203356910747,84.1586539513546,124
-7.6926,53.28823,2022/05/13 23:00:00+00,Sat 14 May 2022,333,633,0,3848590,3797945,241057,4089647,4039002,85.2272753322431,84.1718455215036,125
-7.6926,53.28823,2022/05/14 23:00:00+00,Sun 15 May 2022,168,254,0,3848758,3798199,241057,4089815,4039256,85.2307764124723,84.1771388213738,126
-7.6926,53.28823,2022/05/15 23:00:00+00,Mon 16 May 2022,31,41,0,3848789,3798240,241057,4089846,4039297,85.2314224451336,84.1779932516679,127
-7.6926,53.28823,2022/05/16 23:00:00+00,Tue 17 May 2022,97,101,0,3848886,3798341,241057,4089943,4039398,85.2334439021706,84.180098067758,128
-7.6926,53.28823,2022/05/17 23:00:00+00,Wed 18 May 2022,98,123,0,3848984,3798464,241057,4090041,4039521,85.235486198971,84.18266135864,129
-7.6926,53.28823,2022/05/18 23:00:00+00,Thu 19 May 2022,73,107,0,3849057,3798571,241057,4090114,4039628,85.2370075016896,84.1848912133098,130
-7.6926,53.28823,2022/05/19 23:00:00+00,Fri 20 May 2022,127,208,0,3849184,3798779,241057,4090241,4039836,85.2396541516247,84.1892258840697,131
-7.6926,53.28823,2022/05/20 23:00:00+00,Sat 21 May 2022,392,762,0,3849576,3799541,241057,4090633,4040598,85.247823338826,84.2051057836804,132
-7.6926,53.28823,2022/05/21 23:00:00+00,Sun 22 May 2022,234,409,0,3849810,3799950,241057,4090867,4041007,85.2526998434309,84.2136292468572,133
-7.6926,53.28823,2022/05/22 23:00:00+00,Mon 23 May 2022,26,35,0,3849836,3799985,241057,4090893,4041042,85.2532416772759,84.2143586385716,134
-7.6926,53.28823,2022/05/23 23:00:00+00,Tue 24 May 2022,64,83,0,3849900,3800068,241057,4090957,4041125,85.254575422125,84.2160883389229,135
-7.6926,53.28823,2022/05/24 23:00:00+00,Wed 25 May 2022,87,134,1,3849987,3800202,241058,4091045,4041260,85.2564093212927,84.2189017069642,136
-7.6926,53.28823,2022/05/25 23:00:00+00,Thu 26 May 2022,97,155,0,3850084,3800357,241058,4091142,4041415,85.2584307783297,84.2221318702708,137
-7.6926,53.28823,2022/05/26 23:00:00+00,Fri 27 May 2022,95,152,1,3850179,3800509,241059,4091238,4041568,85.2604313956035,84.2253203540509,138
-7.6926,53.28823,2021/11/16 00:00:00+00,Tue 16 Nov 2021,1316,1082,5,3644116,3576240,240908,3885024,3817148,80.9629804529272,79.548460681306,139
-7.6926,53.28823,2022/09/09 23:00:00+00,Sat 10 Sep 2022,94,135,0,3857645,3811966,241072,4098717,4053038,85.4162919850896,84.464352438742,140
-7.6926,53.28823,2022/09/10 23:00:00+00,Sun 11 Sep 2022,58,58,0,3857703,3812024,241072,4098775,4053096,85.4175006913592,84.4655611450116,141
-7.6926,53.28823,2021/04/22 23:00:00+00,Fri 23 Apr 2021,33613,12362,3,1015869,424372,275,1016144,424647,21.1762004068339,8.84954295273188,142
-7.6926,53.28823,2021/07/21 23:00:00+00,Thu 22 Jul 2021,33546,15940,6937,2978059,2435174,196243,3174302,2631417,66.1517022231234,54.8381073410358,143
-7.6926,53.28823,2021/11/17 00:00:00+00,Wed 17 Nov 2021,1504,1123,3,3645620,3577363,240911,3886531,3818274,80.9943859761731,79.5719262547465,144
-7.6926,53.28823,2021/11/18 00:00:00+00,Thu 18 Nov 2021,1640,2514,5,3647260,3579877,240916,3888176,3820793,81.02866738675,79.6244216184202,145
-7.6926,53.28823,2021/01/03 00:00:00+00,Sun 03 Jan 2021,24,3,1,4319,27,3,4322,30,0.090069456846998,0.000625192898058755,146
-7.6926,53.28823,2021/04/23 23:00:00+00,Sat 24 Apr 2021,23707,7005,2,1039576,431377,277,1039853,431654,21.6702903541697,8.99556717395513,147
-7.6926,53.28823,2021/07/22 23:00:00+00,Fri 23 Jul 2021,27086,20847,5616,3005145,2456021,201859,3207004,2657880,66.833204161534,55.3895899964135,148
-7.6926,53.28823,2021/11/19 00:00:00+00,Fri 19 Nov 2021,1165,1561,0,3648425,3581438,240916,3889341,3822354,81.0529457109579,79.6569524888825,149
-7.6926,53.28823,2021/01/04 00:00:00+00,Mon 04 Jan 2021,1197,5,0,5516,32,3,5519,35,0.115014653479542,0.000729391714401881,150
-7.6926,53.28823,2022/09/11 23:00:00+00,Mon 12 Sep 2022,13,13,0,3857716,3812037,241072,4098788,4053109,85.4177716082816,84.4658320619341,151
-7.6926,53.28823,2021/04/24 23:00:00+00,Sun 25 Apr 2021,9755,310,3,1049331,431687,280,1049611,431967,21.8736447641449,9.00209001985821,152
-7.6926,53.28823,2021/11/20 00:00:00+00,Sat 20 Nov 2021,1547,2948,12,3649972,3584386,240928,3890900,3825314,81.0854349018937,79.7186381881576,153
-7.6926,53.28823,2022/09/12 23:00:00+00,Tue 13 Sep 2022,29,25,0,3857745,3812062,241072,4098817,4053134,85.4183759614164,84.4663530560158,154
-7.6926,53.28823,2021/07/23 23:00:00+00,Sat 24 Jul 2021,15446,14819,2276,3020591,2470840,204135,3224726,2674975,67.2025264461806,55.7458457494906,155
-7.6926,53.28823,2021/01/05 00:00:00+00,Tue 05 Jan 2021,3543,14,0,9059,46,3,9062,49,0.188849934740281,0.00102114840016263,156
-7.6926,53.28823,2021/04/25 23:00:00+00,Mon 26 Apr 2021,15601,3061,4,1064932,434748,284,1065216,435032,22.1988492699518,9.06596389427655,157
-7.6926,53.28823,2021/11/21 00:00:00+00,Sun 21 Nov 2021,1789,2771,0,3651761,3587157,240928,3892689,3828085,81.1227172383813,79.776385172175,158
-7.6926,53.28823,2021/07/24 23:00:00+00,Sun 25 Jul 2021,14741,13652,1046,3035332,2484492,205181,3240513,2689673,67.5315237889024,56.0521485900129,159
-7.6926,53.28823,2021/01/06 00:00:00+00,Wed 06 Jan 2021,6791,14,0,15850,60,3,15853,63,0.330372767097515,0.00131290508592339,160
-7.6926,53.28823,2022/09/13 23:00:00+00,Wed 14 Sep 2022,36,33,0,3857781,3812095,241072,4098853,4053167,85.4191261928941,84.4670407682037,161
-7.6926,53.28823,2021/04/26 23:00:00+00,Tue 27 Apr 2021,25922,7826,9,1090854,442574,293,1091147,442867,22.7392451712706,9.22924343948623,162
-7.6926,53.28823,2021/11/22 00:00:00+00,Mon 22 Nov 2021,725,521,3,3652486,3587678,240931,3893417,3828609,81.1378885860408,79.7873052081278,163
-7.6926,53.28823,2021/07/25 23:00:00+00,Mon 26 Jul 2021,23851,18322,3422,3059183,2502814,208603,3267786,2711417,68.0998866525276,56.5052884025259,164
-7.6926,53.28823,2021/01/07 00:00:00+00,Thu 07 Jan 2021,11739,9,0,27589,69,3,27592,72,0.575010748107906,0.00150046295534101,165
-7.6926,53.28823,2022/09/14 23:00:00+00,Thu 15 Sep 2022,51,35,0,3857832,3812130,241072,4098904,4053202,85.4201890208208,84.4677701599181,166
-7.6926,53.28823,2021/04/27 23:00:00+00,Wed 28 Apr 2021,26047,8624,5,1116901,451198,298,1117199,451496,23.2821626839448,9.40906975673119,167
-7.6926,53.28823,2021/11/23 00:00:00+00,Tue 23 Nov 2021,2156,1598,8,3654642,3589276,240939,3895581,3830215,81.1829858337541,79.8207738679372,168
-7.6926,53.28823,2021/07/26 23:00:00+00,Tue 27 Jul 2021,25528,23920,3672,3084711,2526734,212275,3296986,2739009,68.7084077399714,57.0802991506338,169
-7.6926,53.28823,2021/01/08 00:00:00+00,Fri 08 Jan 2021,12688,6,0,40277,75,3,40280,78,0.839425664460222,0.00162550153495276,170
-7.6926,53.28823,2022/09/15 23:00:00+00,Fri 16 Sep 2022,38,56,0,3857870,3812186,241072,4098942,4053258,85.420980931825,84.4689371866611,171
-7.6926,53.28823,2021/04/28 23:00:00+00,Thu 29 Apr 2021,31698,11333,6,1148599,462531,304,1148903,462835,23.9428665386133,9.64537183243413,172
-7.6926,53.28823,2021/11/24 00:00:00+00,Wed 24 Nov 2021,1615,3153,2,3656257,3592429,240941,3897198,3833370,81.2166837309595,79.8865233210497,173
-7.6926,53.28823,2021/07/27 23:00:00+00,Wed 28 Jul 2021,23449,25297,3265,3108160,2552031,215540,3323700,2767571,69.2651211759295,57.6755244691122,174
-7.6926,53.28823,2021/07/28 23:00:00+00,Thu 29 Jul 2021,19295,27883,2962,3127455,2579914,218502,3345957,2798416,69.7289517869993,58.318326967133,175
-7.6926,53.28823,2021/07/29 23:00:00+00,Fri 30 Jul 2021,21964,22957,2123,3149419,2602871,220625,3370044,2823496,70.2309191648507,58.8409882299101,176
-7.6926,53.28823,2021/07/30 23:00:00+00,Sat 31 Jul 2021,13755,12496,907,3163174,2615367,221532,3384706,2836899,70.5364717738952,59.1203035769995,177
-7.6926,53.28823,2021/07/31 23:00:00+00,Sun 01 Aug 2021,11146,9350,369,3174320,2624717,221901,3396221,2846618,70.7764416479335,59.3228452362073,178
-7.6926,53.28823,2021/08/01 23:00:00+00,Mon 02 Aug 2021,15033,16048,430,3189353,2640765,222331,3411684,2863096,71.0986869073562,59.6662428553477,179
-7.6926,53.28823,2021/08/02 23:00:00+00,Tue 03 Aug 2021,17355,25462,1111,3206708,2666227,223442,3430150,2889669,71.4835139758746,60.2200178846848,180
-7.6926,53.28823,2021/08/03 23:00:00+00,Wed 04 Aug 2021,22131,17316,1575,3228839,2683543,225017,3453856,2908560,71.9775414039207,60.6137018525924,181
-7.6926,53.28823,2021/08/04 23:00:00+00,Thu 05 Aug 2021,13547,30062,1421,3242386,2713605,226438,3468824,2940043,72.2894709805255,61.2698001195786,182
-7.6926,53.28823,2021/08/05 23:00:00+00,Fri 06 Aug 2021,12223,24754,949,3254609,2738359,227387,3481996,2965746,72.5639723422998,61.805444554872,183
-7.6926,53.28823,2021/08/06 23:00:00+00,Sat 07 Aug 2021,6341,8469,584,3260950,2746828,227971,3488921,2974799,72.708287702935,61.9941069317429,184
-7.6926,53.28823,2021/08/07 23:00:00+00,Sun 08 Aug 2021,8634,11990,153,3269584,2758818,228124,3497708,2986942,72.8914067027764,62.2471641771138,185
-7.6926,53.28823,2021/08/08 23:00:00+00,Mon 09 Aug 2021,5559,23048,601,3275143,2781866,228725,3503868,3010591,73.0197796445111,62.7400037386535,186
-7.6926,53.28823,2021/08/09 23:00:00+00,Tue 10 Aug 2021,9379,26022,717,3284522,2807888,229442,3513964,3037330,73.2301778944712,63.2972381686933,187
-7.6926,53.28823,2021/08/10 23:00:00+00,Wed 11 Aug 2021,7030,31246,666,3291552,2839134,230108,3521660,3069242,73.3905607125865,63.9622766941217,188
-7.6926,53.28823,2021/08/11 23:00:00+00,Thu 12 Aug 2021,6788,38308,865,3298340,2877442,230973,3529313,3108415,73.5500474208813,64.7786327406435,189
-7.6926,53.28823,2021/08/12 23:00:00+00,Fri 13 Aug 2021,10944,28231,875,3309284,2905673,231848,3541132,3137521,73.7963525829532,65.3851948903401,190
-7.6926,53.28823,2021/08/13 23:00:00+00,Sat 14 Aug 2021,18146,5855,281,3327430,2911528,232129,3559559,3143657,74.1803669007042,65.5130676777564,191
-7.6926,53.28823,2021/08/14 23:00:00+00,Sun 15 Aug 2021,17003,3739,52,3344433,2915267,232181,3576614,3147448,74.5357890632506,65.5920712203078,192
-7.6926,53.28823,2021/08/15 23:00:00+00,Mon 16 Aug 2021,10201,23167,386,3354634,2938434,232567,3587201,3171001,74.7564196369755,66.0829101645737,193
-7.6926,53.28823,2021/08/16 23:00:00+00,Tue 17 Aug 2021,12879,26875,530,3367513,2965309,233097,3600610,3198406,75.0358600226445,66.6540238769504,194
-7.6926,53.28823,2021/08/17 23:00:00+00,Wed 18 Aug 2021,15243,25781,658,3382756,2991090,233755,3616511,3224845,75.3672330983789,67.2050063780095,195
-7.6926,53.28823,2021/08/18 23:00:00+00,Thu 19 Aug 2021,11373,25734,545,3394129,3016824,234300,3628429,3251124,75.6156013970144,67.7526545169458,196
-7.6926,53.28823,2021/08/19 23:00:00+00,Fri 20 Aug 2021,14859,22276,686,3408988,3039100,234986,3643974,3274086,75.9395555170251,68.2311771611199,197
-7.6926,53.28823,2021/08/20 23:00:00+00,Sat 21 Aug 2021,11905,7992,246,3420893,3047092,235232,3656125,3282324,76.1927794805022,68.4028551309269,198
-7.6926,53.28823,2021/08/21 23:00:00+00,Sun 22 Aug 2021,8005,12260,162,3428898,3059352,235394,3664292,3294746,76.3629778271171,68.6617266702497,199
-7.6926,53.28823,2021/08/22 23:00:00+00,Mon 23 Aug 2021,10881,15397,291,3439779,3074749,235685,3675464,3310434,76.5957996623542,68.9886608764079,200
-7.6926,53.28823,2021/08/23 23:00:00+00,Tue 24 Aug 2021,9722,22933,384,3449501,3097682,236069,3685570,3333751,76.8064063099469,69.4745816365424,201
-7.6926,53.28823,2021/08/24 23:00:00+00,Wed 25 Aug 2021,9425,19548,318,3458926,3117230,236387,3695313,3353617,77.0094481234731,69.888584373637,202
-7.6926,53.28823,2021/08/25 23:00:00+00,Thu 26 Aug 2021,8596,19453,369,3467522,3136683,236756,3704278,3373439,77.1962766011763,70.3016701611476,203
-7.6926,53.28823,2021/08/26 23:00:00+00,Fri 27 Aug 2021,9732,19226,432,3477254,3155909,237188,3714442,3393097,77.4080919550386,70.7113382274823,204
-7.6926,53.28823,2021/08/27 23:00:00+00,Sat 28 Aug 2021,9932,7942,155,3487186,3163851,237343,3724529,3401194,77.6183026471292,70.8800777906683,205
-7.6926,53.28823,2021/08/28 23:00:00+00,Sun 29 Aug 2021,8803,9198,30,3495989,3173049,237373,3733362,3410422,77.802380276081,71.0723871261112,206
-7.6926,53.28823,2021/08/29 23:00:00+00,Mon 30 Aug 2021,5071,11156,85,3501060,3184205,237458,3738518,3421663,77.909830095494,71.3066469050138,207
-7.6926,53.28823,2021/08/30 23:00:00+00,Tue 31 Aug 2021,4076,12914,145,3505136,3197119,237603,3742739,3434722,77.9977947362509,71.5787933735388,208
-7.6926,53.28823,2021/08/31 23:00:00+00,Wed 01 Sep 2021,4988,12556,184,3510124,3209675,237787,3747911,3447462,78.1055779918762,71.8442919575811,209
-7.6926,53.28823,2021/09/01 23:00:00+00,Thu 02 Sep 2021,5014,12376,249,3515138,3222051,238036,3753174,3460087,78.215257665959,72.1073939688475,210
-7.6926,53.28823,2021/09/02 23:00:00+00,Fri 03 Sep 2021,4783,16099,167,3519921,3238150,238203,3758124,3476353,78.3184144941387,72.4463735581749,211
-7.6926,53.28823,2021/09/03 23:00:00+00,Sat 04 Sep 2021,4632,10590,136,3524553,3248740,238339,3762892,3487079,78.4177784854035,72.6699008589942,212
-7.6926,53.28823,2021/09/04 23:00:00+00,Sun 05 Sep 2021,5310,11911,1,3529863,3260651,238340,3768203,3498991,78.5284584681232,72.9181441190501,213
-7.6926,53.28823,2021/09/05 23:00:00+00,Mon 06 Sep 2021,2170,9697,76,3532033,3270348,238416,3770449,3508764,78.5752645764245,73.1218111254743,214
-7.6926,53.28823,2021/09/06 23:00:00+00,Tue 07 Sep 2021,3035,10037,160,3535068,3280385,238576,3773644,3518961,78.6418476200678,73.3343141915245,215
-7.6926,53.28823,2021/09/07 23:00:00+00,Wed 08 Sep 2021,2614,14806,191,3537682,3295191,238767,3776449,3533958,78.7003031560363,73.6468481212641,216
-7.6926,53.28823,2021/09/08 23:00:00+00,Thu 09 Sep 2021,3129,14824,138,3540811,3310015,238905,3779716,3548920,78.7683866626349,73.9586526592892,217
-7.6926,53.28823,2021/09/09 23:00:00+00,Fri 10 Sep 2021,3391,13950,116,3544202,3323965,239021,3783223,3562986,78.8414717124179,74.2517847694257,218
-7.6926,53.28823,2021/09/10 23:00:00+00,Sat 11 Sep 2021,2563,11346,62,3546765,3335311,239083,3785848,3574394,78.8961760909981,74.4895247887942,219
-7.6926,53.28823,2021/09/11 23:00:00+00,Sun 12 Sep 2021,2043,12885,1,3548808,3348196,239084,3787892,3587280,78.9387725671191,74.7580659782737,220
-7.6926,53.28823,2021/09/12 23:00:00+00,Mon 13 Sep 2021,1624,7750,52,3550432,3355946,239136,3789568,3595082,78.9737000103574,74.9206578112955,221
-7.6926,53.28823,2021/09/13 23:00:00+00,Tue 14 Sep 2021,1556,10796,82,3551988,3366742,239218,3791206,3605960,79.0078355425914,75.1473527561316,222
-7.6926,53.28823,2021/09/14 23:00:00+00,Wed 15 Sep 2021,3290,12379,138,3555278,3379121,239356,3794634,3618477,79.0792742510762,75.408204072965,223
-7.6926,53.28823,2021/09/15 23:00:00+00,Thu 16 Sep 2021,1920,10582,115,3557198,3389703,239471,3796669,3629174,79.1216831693279,75.6311270206495,224
-7.6926,53.28823,2021/09/16 23:00:00+00,Fri 17 Sep 2021,2563,14624,95,3559761,3404327,239566,3799327,3643893,79.1770752600959,75.9378674962004,225
-7.6926,53.28823,2021/09/17 23:00:00+00,Sat 18 Sep 2021,2292,11242,48,3562053,3415569,239614,3801667,3655183,79.2258403061445,76.1731484235032,226
-7.6926,53.28823,2021/09/18 23:00:00+00,Sun 19 Sep 2021,1864,8496,16,3563917,3424065,239630,3803547,3663695,79.2650190610895,76.3505364884457,227
-7.6926,53.28823,2021/09/19 23:00:00+00,Mon 20 Sep 2021,965,5635,35,3564882,3429700,239665,3804547,3669365,79.2858588243581,76.4686979461788,228
-7.6926,53.28823,2021/09/20 23:00:00+00,Tue 21 Sep 2021,1477,6681,90,3566359,3436381,239755,3806114,3676136,79.3185147334,76.6098039832707,229
-7.6926,53.28823,2021/09/21 23:00:00+00,Wed 22 Sep 2021,1902,8160,97,3568261,3444541,239852,3808113,3684393,79.360173420174,76.7818779085797,230
-7.6926,53.28823,2021/09/22 23:00:00+00,Thu 23 Sep 2021,1691,8736,89,3569952,3453277,239941,3809893,3693218,79.3972681987922,76.9657888194253,231
-7.6926,53.28823,2021/09/23 23:00:00+00,Fri 24 Sep 2021,1915,7397,81,3571867,3460674,240022,3811889,3700696,79.4388643662763,77.1216285691481,232
-7.6926,53.28823,2021/09/24 23:00:00+00,Sat 25 Sep 2021,2423,6609,53,3574290,3467283,240075,3814365,3707358,79.4904636201295,77.2604630720437,233
-7.6926,53.28823,2021/09/25 23:00:00+00,Sun 26 Sep 2021,1549,7101,0,3575839,3474384,240075,3815914,3714459,79.5227444134326,77.4084462310142,234
-7.6926,53.28823,2021/09/26 23:00:00+00,Mon 27 Sep 2021,1179,3833,45,3577018,3478217,240120,3817138,3718337,79.5482522836734,77.4892628329699,235
-7.6926,53.28823,2021/09/27 23:00:00+00,Tue 28 Sep 2021,1455,5152,93,3578473,3483369,240213,3818686,3723582,79.5805122372132,77.5985673913139,236
-7.6926,53.28823,2021/09/28 23:00:00+00,Wed 29 Sep 2021,1654,3630,80,3580127,3486999,240293,3820420,3727292,79.616648386721,77.6758829130405,237
-7.6926,53.28823,2021/09/29 23:00:00+00,Thu 30 Sep 2021,1275,3988,78,3581402,3490987,240371,3821773,3731358,79.6448445864234,77.7606173904907,238
-7.6926,53.28823,2021/09/30 23:00:00+00,Fri 01 Oct 2021,1871,5197,42,3583273,3496184,240413,3823686,3736597,79.6847110535563,77.869796910255,239
-7.6926,53.28823,2021/10/01 23:00:00+00,Sat 02 Oct 2021,1684,4103,41,3584957,3500287,240454,3825411,3740741,79.7206596451947,77.9561568892402,240
-7.6926,53.28823,2021/10/02 23:00:00+00,Sun 03 Oct 2021,1197,3022,9,3586154,3503309,240463,3826617,3743772,79.7457923996967,78.0193222117074,241
-7.6926,53.28823,2021/10/03 23:00:00+00,Mon 04 Oct 2021,349,1241,18,3586503,3504550,240481,3826984,3745031,79.7534405928162,78.0455594736626,242
-7.6926,53.28823,2021/10/04 23:00:00+00,Tue 05 Oct 2021,960,2837,70,3587463,3507387,240551,3828014,3747938,79.7749055489829,78.1061406654845,243
-7.6926,53.28823,2021/10/05 23:00:00+00,Wed 06 Oct 2021,972,2581,40,3588435,3509968,240591,3829026,3750559,79.7959953894108,78.1607616850116,244
-7.6926,53.28823,2021/10/06 23:00:00+00,Thu 07 Oct 2021,1213,2716,44,3589648,3512684,240635,3830283,3753319,79.8221909718394,78.218279431633,245
-7.6926,53.28823,2021/10/07 23:00:00+00,Fri 08 Oct 2021,916,2747,48,3590564,3515431,240683,3831247,3756114,79.8422805036304,78.2765265699688,246
-7.6926,53.28823,2021/10/08 23:00:00+00,Sat 09 Oct 2021,724,2368,23,3591288,3517799,240706,3831994,3758505,79.8578478067921,78.3263544439441,247
-7.6926,53.28823,2021/10/09 23:00:00+00,Sun 10 Oct 2021,1518,3926,2,3592806,3521725,240708,3833514,3762433,79.8895242469604,78.4082130340632,248
-7.6926,53.28823,2021/10/10 23:00:00+00,Mon 11 Oct 2021,334,1139,19,3593140,3522864,240727,3833867,3763591,79.8968806833942,78.4323454799283,249
-7.6926,53.28823,2021/10/11 23:00:00+00,Tue 12 Oct 2021,563,1627,21,3593703,3524491,240748,3834451,3765239,79.9090511051431,78.466689409795,250
-7.6926,53.28823,2021/10/12 23:00:00+00,Wed 13 Oct 2021,990,2081,11,3594693,3526572,240759,3835452,3767331,79.929911708175,78.5102861945529,251
-7.6926,53.28823,2021/10/13 23:00:00+00,Thu 14 Oct 2021,654,1613,9,3595347,3528185,240768,3836115,3768953,79.9437284712221,78.5440882905746,252
-7.6926,53.28823,2021/10/14 23:00:00+00,Fri 15 Oct 2021,957,2081,10,3596304,3530266,240778,3837082,3771044,79.9638805223028,78.5876642355693,253
-7.6926,53.28823,2021/10/15 23:00:00+00,Sat 16 Oct 2021,1384,2652,14,3597688,3532918,240792,3838480,3773710,79.9930145113524,78.6432230444435,254
-7.6926,53.28823,2021/10/16 23:00:00+00,Sun 17 Oct 2021,1706,2892,2,3599394,3535810,240794,3840188,3776604,80.0286088270152,78.7035333193429,255
-7.6926,53.28823,2021/10/17 23:00:00+00,Mon 18 Oct 2021,680,1259,6,3600074,3537069,240800,3840874,3777869,80.0429049046174,78.7298956198777,256
-7.6926,53.28823,2021/10/18 23:00:00+00,Tue 19 Oct 2021,1342,1810,13,3601416,3538879,240813,3842229,3779692,80.0711427838464,78.7678865083164,257
-7.6926,53.28823,2021/10/19 23:00:00+00,Wed 20 Oct 2021,2262,2339,0,3603678,3541218,240813,3844491,3782031,80.1182823283601,78.8166307146017,258
-7.6926,53.28823,2021/10/20 23:00:00+00,Thu 21 Oct 2021,1731,1856,11,3605409,3543074,240824,3846233,3783898,80.154585195974,78.8555385526243,259
-7.6926,53.28823,2021/10/21 23:00:00+00,Fri 22 Oct 2021,1508,1937,3,3606917,3545011,240827,3847744,3785838,80.1860740782729,78.8959676933654,260
-7.6926,53.28823,2021/10/22 23:00:00+00,Sat 23 Oct 2021,2018,1710,1,3608935,3546721,240828,3849763,3787549,80.2281495603123,78.931624528318,261
-7.6926,53.28823,2021/10/23 23:00:00+00,Sun 24 Oct 2021,1959,2190,2,3610894,3548911,240830,3851724,3789741,80.269016336082,78.9773052894028,262
-7.6926,53.28823,2021/10/24 23:00:00+00,Mon 25 Oct 2021,1238,863,2,3612132,3549774,240832,3852964,3790606,80.2948576425351,78.9953316846302,263
-7.6926,53.28823,2021/10/25 23:00:00+00,Tue 26 Oct 2021,1247,1237,6,3613379,3551011,240838,3854217,3791849,80.3209698659107,79.0212355103731,264
-7.6926,53.28823,2021/10/26 23:00:00+00,Wed 27 Oct 2021,1568,1434,6,3614947,3552445,240844,3855791,3793289,80.3537716532955,79.0512447694799,265
-7.6926,53.28823,2021/10/27 23:00:00+00,Thu 28 Oct 2021,2159,1701,5,3617106,3554146,240849,3857955,3794995,80.3988689010088,79.0867974056162,266
-7.6926,53.28823,2021/10/28 23:00:00+00,Fri 29 Oct 2021,2145,1379,2,3619251,3555525,240851,3860102,3796376,80.4436118727466,79.1155771186902,267
-7.6926,53.28823,2021/10/29 23:00:00+00,Sat 30 Oct 2021,2021,1455,1,3621272,3556980,240852,3862124,3797832,80.4857498740757,79.1459198140093,268
-7.6926,53.28823,2021/10/30 23:00:00+00,Sun 31 Oct 2021,1599,1320,0,3622871,3558300,240852,3863723,3799152,80.5190726555423,79.1734283015239,269
-7.6926,53.28823,2021/11/01 00:00:00+00,Mon 01 Nov 2021,291,298,2,3623162,3558598,240854,3864016,3799452,80.52517870618,79.1796802305045,270
-7.6926,53.28823,2021/04/29 23:00:00+00,Fri 30 Apr 2021,36102,13545,8,1184701,476076,312,1185013,476388,24.6953903902433,9.92781314401381,271
-7.6926,53.28823,2021/11/25 00:00:00+00,Thu 25 Nov 2021,982,1190,2,3657239,3593619,240943,3898182,3834562,81.2371900580158,79.9113643188659,272
-7.6926,53.28823,2022/09/16 23:00:00+00,Sat 17 Sep 2022,67,149,0,3857937,3812335,241072,4099009,4053407,85.422377195964,84.4720423113882,273
-7.6926,53.28823,2021/11/26 00:00:00+00,Fri 26 Nov 2021,1279,1112,12,3658518,3594731,240955,3899473,3835686,81.2640941923956,79.9347882127798,274
-7.6926,53.28823,2021/04/30 23:00:00+00,Sat 01 May 2021,16614,6700,21,1201315,482776,333,1201648,483109,25.0420598522169,10.0678771929422,275
-7.6926,53.28823,2021/01/09 00:00:00+00,Sat 09 Jan 2021,8078,7,0,48355,82,3,48358,85,1.00776927214418,0.00177137987783314,276
-7.6926,53.28823,2021/11/27 00:00:00+00,Sat 27 Nov 2021,1201,1566,6,3659719,3596297,240961,3900680,3837258,81.2892477866609,79.9675483206381,277
-7.6926,53.28823,2021/01/10 00:00:00+00,Sun 10 Jan 2021,4788,5,1,53143,87,4,53147,91,1.10757089843762,0.00189641845744489,278
-7.6926,53.28823,2022/09/17 23:00:00+00,Sun 18 Sep 2022,30,53,0,3857967,3812388,241072,4099039,4053460,85.4230023888621,84.4731468188414,279
-7.6926,53.28823,2021/11/28 00:00:00+00,Sun 28 Nov 2021,1962,2262,1,3661681,3598559,240962,3902643,3839521,81.3301562419572,80.014708704915,280
-7.6926,53.28823,2021/01/11 00:00:00+00,Mon 11 Jan 2021,8352,8,0,61495,95,4,61499,99,1.28162460125718,0.00206313656359389,281
-7.6926,53.28823,2022/09/18 23:00:00+00,Mon 19 Sep 2022,11,11,0,3857978,3812399,241072,4099050,4053471,85.423231626258,84.4733760562373,282
-7.6926,53.28823,2021/11/29 00:00:00+00,Mon 29 Nov 2021,536,1000,2,3662217,3599559,240964,3903181,3840523,81.3413680345957,80.0355901477102,283
-7.6926,53.28823,2021/05/01 23:00:00+00,Sun 02 May 2021,12471,912,16,1213786,483688,349,1214135,484037,25.3022859761522,10.0872164932555,284
-7.6926,53.28823,2021/01/12 00:00:00+00,Tue 12 Jan 2021,8897,14,0,70392,109,4,70396,113,1.46703597505814,0.00235489324935464,285
-7.6926,53.28823,2022/09/19 23:00:00+00,Tue 20 Sep 2022,39,37,0,3858017,3812436,241072,4099089,4053508,85.4240443770255,84.4741471274783,286
-7.6926,53.28823,2021/11/30 00:00:00+00,Tue 30 Nov 2021,1895,1650,6,3664112,3601209,240970,3905082,3842179,81.3809844245693,80.070100795683,287
-7.6926,53.28823,2021/05/02 23:00:00+00,Mon 03 May 2021,14274,933,21,1228060,484621,370,1228430,484991,25.6001903920772,10.1070976274138,288
-7.6926,53.28823,2021/01/13 00:00:00+00,Wed 13 Jan 2021,9900,4,0,80292,113,4,80296,117,1.67334963141753,0.00243825230242915,289
-7.6926,53.28823,2022/09/20 23:00:00+00,Wed 21 Sep 2022,41,32,0,3858058,3812468,241072,4099130,4053540,85.4248988073195,84.4748139999029,290
-7.6926,53.28823,2021/12/01 00:00:00+00,Wed 01 Dec 2021,1071,1389,4,3665183,3602598,240974,3906157,3843572,81.4033871700831,80.0991305859162,291
-7.6926,53.28823,2021/05/03 23:00:00+00,Tue 04 May 2021,26669,6807,11,1254729,491428,381,1255110,491809,26.1561952760841,10.2491831333793,292
-7.6926,53.28823,2021/01/14 00:00:00+00,Thu 14 Jan 2021,8096,6,0,88388,119,4,88392,123,1.84206835484032,0.0025632908820409,293
-7.6926,53.28823,2022/09/21 23:00:00+00,Thu 22 Sep 2022,61,34,0,3858119,3812502,241072,4099191,4053574,85.4261700328789,84.475522551854,294
-7.6926,53.28823,2021/12/02 00:00:00+00,Thu 02 Dec 2021,1737,1415,0,3666920,3604013,240974,3907894,3844987,81.4395858388807,80.1286188509413,295
-7.6926,53.28823,2021/05/04 23:00:00+00,Wed 05 May 2021,32132,13468,70,1286861,504896,451,1287312,505347,26.8272773328604,10.5313118485099,296
-7.6926,53.28823,2021/01/15 00:00:00+00,Fri 15 Jan 2021,7703,4,0,96091,123,4,96095,127,2.00259705129854,0.0026466499351154,297
-7.6926,53.28823,2022/09/22 23:00:00+00,Fri 23 Sep 2022,38,39,0,3858157,3812541,241072,4099229,4053613,85.4269619438831,84.4763353026215,298
-7.6926,53.28823,2021/12/03 00:00:00+00,Fri 03 Dec 2021,1016,1199,2,3667936,3605212,240976,3908912,3846188,81.4608007178882,80.1536474066269,299
-7.6926,53.28823,2021/05/05 23:00:00+00,Thu 06 May 2021,37300,14385,133,1324161,519281,584,1324745,519865,27.6073721912949,10.8338635316438,300
-7.6926,53.28823,2021/01/16 00:00:00+00,Sat 16 Jan 2021,5247,2,0,101338,125,4,101342,129,2.11194328916901,0.00268832946165265,301
-7.6926,53.28823,2022/09/23 23:00:00+00,Sat 24 Sep 2022,56,104,0,3858213,3812645,241072,4099285,4053717,85.4281289706261,84.4785026380014,302
-7.6926,53.28823,2021/12/04 00:00:00+00,Sat 04 Dec 2021,1204,1703,1,3669140,3606915,240977,3910117,3847892,81.4859126326268,80.1891583632367,303
-7.6926,53.28823,2021/05/06 23:00:00+00,Fri 07 May 2021,40601,15092,98,1364762,534373,682,1365444,535055,28.4555297165646,11.1504195356942,304
-7.6926,53.28823,2021/01/17 00:00:00+00,Sun 17 Jan 2021,1116,5,0,102454,130,4,102458,134,2.1352004649768,0.00279252827799577,305
-7.6926,53.28823,2022/09/24 23:00:00+00,Sun 25 Sep 2022,42,74,0,3858255,3812719,241072,4099327,4053791,85.4290042406834,84.4800447804833,306
-7.6926,53.28823,2021/12/05 00:00:00+00,Sun 05 Dec 2021,1348,1777,2,3670488,3608692,240979,3911467,3849671,81.5140463130395,80.2262323020915,307
-7.6926,53.28823,2021/05/07 23:00:00+00,Sat 08 May 2021,25632,7065,10,1390394,541438,692,1391086,542130,28.9899029262987,11.2978608608198,308
-7.6926,53.28823,2021/01/18 00:00:00+00,Mon 18 Jan 2021,8728,9,1,111182,139,5,111187,144,2.31711075854863,0.00300092591068202,309
-7.6926,53.28823,2022/05/27 23:00:00+00,Sat 28 May 2022,335,580,0,3850514,3801089,241059,4091573,4042148,85.2674127162985,84.2374074167467,310
-7.6926,53.28823,2022/09/25 23:00:00+00,Mon 26 Sep 2022,25,10,0,3858280,3812729,241072,4099352,4053801,85.4295252347652,84.480253178116,311
-7.6926,53.28823,2021/12/06 00:00:00+00,Mon 06 Dec 2021,937,1304,0,3671425,3609996,240979,3912404,3850975,81.5335731712222,80.2534073533938,312
-7.6926,53.28823,2021/05/08 23:00:00+00,Sun 09 May 2021,19677,931,5,1410071,542369,697,1410768,543066,29.4000711469518,11.3173668792392,313
-7.6926,53.28823,2021/01/19 00:00:00+00,Tue 19 Jan 2021,8395,21,0,119577,160,5,119582,165,2.49206057118874,0.00343856093932315,314
-7.6926,53.28823,2022/09/26 23:00:00+00,Tue 27 Sep 2022,30,33,2,3858310,3812762,241074,4099384,4053836,85.4301921071897,84.4809825698304,315
-7.6926,53.28823,2022/05/28 23:00:00+00,Sun 29 May 2022,182,349,0,3850696,3801438,241059,4091755,4042497,85.2712055532134,84.2446804941275,316
-7.6926,53.28823,2021/12/07 00:00:00+00,Tue 07 Dec 2021,483,749,2,3671908,3610745,240981,3912889,3851726,81.5436804564075,80.2690580156086,317
-7.6926,53.28823,2021/05/09 23:00:00+00,Mon 10 May 2021,28857,4659,171,1438928,547028,868,1439796,547896,30.0050077951135,11.4180229358267,318
-7.6926,53.28823,2021/01/20 00:00:00+00,Wed 20 Jan 2021,8453,965,0,128030,1125,5,128035,1130,2.66821909009842,0.0235489324935464,319
-7.6926,53.28823,2021/01/21 00:00:00+00,Thu 21 Jan 2021,9012,966,0,137042,2091,5,137047,2096,2.85602703667527,0.0436801438110384,320
-7.6926,53.28823,2021/01/22 00:00:00+00,Fri 22 Jan 2021,6789,970,0,143831,3061,5,143836,3066,2.99750818950597,0.0638947141816048,321
-7.6926,53.28823,2021/01/23 00:00:00+00,Sat 23 Jan 2021,4201,461,0,148032,3522,5,148037,3527,3.08505603499746,0.073501845048441,322
-7.6926,53.28823,2021/01/24 00:00:00+00,Sun 24 Jan 2021,1187,399,0,149219,3921,5,149224,3926,3.10979283399732,0.0818169105926224,323
-7.6926,53.28823,2021/01/25 00:00:00+00,Mon 25 Jan 2021,1370,1293,0,150589,5214,5,150594,5219,3.13834330967534,0.108762724498955,324
-7.6926,53.28823,2021/01/26 00:00:00+00,Tue 26 Jan 2021,1010,3507,0,151599,8721,5,151604,8726,3.15939147057665,0.181847774282023,325
-7.6926,53.28823,2021/01/27 00:00:00+00,Wed 27 Jan 2021,2188,6708,0,153787,15429,5,153792,15434,3.2049888726084,0.321640906287961,326
-7.6926,53.28823,2021/01/28 00:00:00+00,Thu 28 Jan 2021,1024,11544,0,154811,26973,5,154816,26978,3.22632879019547,0.56221513346097,327
-7.6926,53.28823,2021/01/29 00:00:00+00,Fri 29 Jan 2021,1591,11526,0,156402,38499,5,156407,38504,3.25948485355586,0.802414244895144,328
-7.6926,53.28823,2021/01/30 00:00:00+00,Sat 30 Jan 2021,652,7793,0,157054,46292,5,157059,46297,3.273072379207,0.96481852004754,329
-7.6926,53.28823,2021/01/31 00:00:00+00,Sun 31 Jan 2021,236,4086,0,157290,50378,5,157295,50383,3.2779905633384,1.04996979276314,330
-7.6926,53.28823,2021/02/01 00:00:00+00,Mon 01 Feb 2021,1037,8333,1,158327,58711,6,158333,58717,3.29962223761123,1.22364837984386,331
-7.6926,53.28823,2021/02/02 00:00:00+00,Tue 02 Feb 2021,843,5112,0,159170,63823,6,159176,63829,3.31719015804668,1.33018124967308,332
-7.6926,53.28823,2021/02/03 00:00:00+00,Wed 03 Feb 2021,1411,6870,0,160581,70693,6,160587,70699,3.34659506401871,1.47335042332853,333
-7.6926,53.28823,2021/02/04 00:00:00+00,Thu 04 Feb 2021,1454,10541,1,162035,81234,7,162042,81241,3.37691691957456,1.69304320770638,334
-7.6926,53.28823,2021/02/05 00:00:00+00,Fri 05 Feb 2021,3404,8616,0,165439,89850,7,165446,89857,3.44785547374096,1.87259860802885,335
-7.6926,53.28823,2021/02/06 00:00:00+00,Sat 06 Feb 2021,910,3870,0,166349,93720,7,166356,93727,3.46681965831541,1.95324849187843,336
-7.6926,53.28823,2021/02/07 00:00:00+00,Sun 07 Feb 2021,339,1301,2,166688,95021,9,166697,95030,3.47392601759001,1.98040270341745,337
-7.6926,53.28823,2021/02/08 00:00:00+00,Mon 08 Feb 2021,1195,881,0,167883,95902,9,167892,95911,3.49882953469602,1.99876253485711,338
-7.6926,53.28823,2021/02/09 00:00:00+00,Tue 09 Feb 2021,4274,553,3,172157,96455,12,172169,96467,3.58796120219593,2.01034944323446,339
-7.6926,53.28823,2021/02/10 00:00:00+00,Wed 10 Feb 2021,8833,584,0,180990,97039,12,181002,97051,3.77203883114769,2.02251986498334,340
-7.6926,53.28823,2021/02/11 00:00:00+00,Thu 11 Feb 2021,6199,450,0,187189,97489,12,187201,97501,3.9012245236499,2.03189775845422,341
-7.6926,53.28823,2021/02/12 00:00:00+00,Fri 12 Feb 2021,4402,527,0,191591,98016,12,191603,98028,3.99296116155839,2.04288031369679,342
-7.6926,53.28823,2021/02/13 00:00:00+00,Sat 13 Feb 2021,1220,1918,0,192811,99934,12,192823,99946,4.01838567274611,2.08285097964601,343
-7.6926,53.28823,2021/02/14 00:00:00+00,Sun 14 Feb 2021,2706,27,0,195517,99961,12,195529,99973,4.07477807215101,2.08341365325426,344
-7.6926,53.28823,2021/02/15 00:00:00+00,Mon 15 Feb 2021,1970,7895,0,197487,107856,12,197499,107868,4.1158324057902,2.24794358426006,345
-7.6926,53.28823,2021/02/16 00:00:00+00,Tue 16 Feb 2021,5658,8167,0,203145,116023,12,203157,116035,4.23374378636408,2.41814193087492,346
-7.6926,53.28823,2021/02/17 00:00:00+00,Wed 17 Feb 2021,9757,8466,0,212902,124489,12,212914,124501,4.43707735657606,2.5945713667071,347
-7.6926,53.28823,2021/02/18 00:00:00+00,Thu 18 Feb 2021,8471,8358,1,221373,132847,13,221386,132860,4.61363183098785,2.76877094786954,348
-7.6926,53.28823,2021/02/19 00:00:00+00,Fri 19 Feb 2021,9400,6590,2,230773,139437,15,230788,139452,4.80956728523947,2.90614666733632,349
-7.6926,53.28823,2021/02/20 00:00:00+00,Sat 20 Feb 2021,5899,3576,2,236672,143013,17,236689,143030,4.93254272828762,2.98071134031146,350
-7.6926,53.28823,2021/02/21 00:00:00+00,Sun 21 Feb 2021,1117,1025,6,237789,144038,23,237812,144061,4.95594578243829,3.00219713624141,351
-7.6926,53.28823,2021/02/22 00:00:00+00,Mon 22 Feb 2021,3954,1124,2,241743,145162,25,241768,145187,5.03838788592897,3.02566270968188,352
-7.6926,53.28823,2021/02/23 00:00:00+00,Tue 23 Feb 2021,13370,1074,1,255113,146236,26,255139,146262,5.31703636059376,3.04806545519566,353
-7.6926,53.28823,2021/02/24 00:00:00+00,Wed 24 Feb 2021,16949,2110,5,272062,148346,31,272093,148377,5.67035370705003,3.0921415545088,354
-7.6926,53.28823,2021/02/25 00:00:00+00,Thu 25 Feb 2021,18107,1763,3,290169,150109,34,290203,150143,6.04776181984483,3.12894457644119,355
-7.6926,53.28823,2021/02/26 00:00:00+00,Fri 26 Feb 2021,16093,2775,1,306262,152884,35,306297,152919,6.38315696989008,3.18679575927489,356
-7.6926,53.28823,2021/02/27 00:00:00+00,Sat 27 Feb 2021,9008,706,1,315270,153590,36,315306,153626,6.57090239717713,3.20152947190581,357
-7.6926,53.28823,2021/02/28 00:00:00+00,Sun 28 Feb 2021,2451,59,2,317721,153649,38,317759,153687,6.62202233647507,3.2028006974652,358
-7.6926,53.28823,2021/03/01 00:00:00+00,Mon 01 Mar 2021,5616,806,0,323337,154455,38,323375,154493,6.73905844699167,3.21959754665971,359
-7.6926,53.28823,2021/03/02 00:00:00+00,Tue 02 Mar 2021,12202,1617,0,335539,156072,38,335577,156110,6.99334523839543,3.25329544386508,360
-7.6926,53.28823,2021/03/03 00:00:00+00,Wed 03 Mar 2021,12917,1512,1,348456,157584,39,348495,157623,7.26255330029953,3.28482600569051,361
-7.6926,53.28823,2021/03/04 00:00:00+00,Thu 04 Mar 2021,18734,1697,5,367190,159281,44,367234,159325,7.6530696241903,3.32029528277371,362
-7.6926,53.28823,2021/03/05 00:00:00+00,Fri 05 Mar 2021,18467,2403,6,385657,161684,50,385707,161734,8.03804257105161,3.37049827248782,363
-7.6926,53.28823,2021/03/06 00:00:00+00,Sat 06 Mar 2021,10412,148,5,396069,161832,55,396124,161887,8.25513038502088,3.37368675626792,364
-7.6926,53.28823,2021/03/07 00:00:00+00,Sun 07 Mar 2021,1537,16,3,397606,161848,58,397664,161906,8.28722362045456,3.37408271177003,365
-7.6926,53.28823,2021/03/08 00:00:00+00,Mon 08 Mar 2021,6682,1510,6,404288,163358,64,404352,163422,8.42659995719513,3.40567579288526,366
-7.6926,53.28823,2021/03/09 00:00:00+00,Tue 09 Mar 2021,13852,3112,6,418140,166470,70,418210,166540,8.71539739657173,3.47065417475684,367
-7.6926,53.28823,2021/03/10 00:00:00+00,Wed 10 Mar 2021,13756,3999,3,431896,170469,73,431969,170542,9.00213169938475,3.55405490735787,368
-7.6926,53.28823,2021/03/11 00:00:00+00,Thu 11 Mar 2021,18503,2108,4,450399,172577,77,450476,172654,9.38781319819719,3.59806848738121,369
-7.6926,53.28823,2021/03/12 00:00:00+00,Fri 12 Mar 2021,17350,1348,4,467749,173925,81,467830,174006,9.74946644996091,3.62624384732039,370
-7.6926,53.28823,2021/03/13 00:00:00+00,Sat 13 Mar 2021,8331,180,0,476080,174105,81,476161,174186,9.92308251775183,3.62999500470874,371
-7.6926,53.28823,2021/03/14 00:00:00+00,Sun 14 Mar 2021,393,22,2,476473,174127,83,476556,174210,9.93131422424294,3.63049515902719,372
-7.6926,53.28823,2021/03/15 00:00:00+00,Mon 15 Mar 2021,2673,1002,0,479146,175129,83,479229,175212,9.98701891145997,3.65137660182235,373
-7.6926,53.28823,2021/03/16 00:00:00+00,Tue 16 Mar 2021,8970,3830,2,488116,178959,85,488201,179044,10.1739932675061,3.73123457466773,374
-7.6926,53.28823,2021/03/17 00:00:00+00,Wed 17 Mar 2021,4899,2426,7,493015,181385,92,493107,181477,10.276233146102,3.78193771870029,375
-7.6926,53.28823,2021/03/18 00:00:00+00,Thu 18 Mar 2021,11748,4690,7,504763,186075,99,504862,186174,10.5212045633246,3.87982208677302,376
-7.6926,53.28823,2021/03/19 00:00:00+00,Fri 19 Mar 2021,10393,6142,2,515156,192217,101,515257,192318,10.737833902502,4.00786159229546,377
-7.6926,53.28823,2021/03/20 00:00:00+00,Sat 20 Mar 2021,5259,3127,4,520415,195344,105,520520,195449,10.8475135765848,4.07311089108952,378
-7.6926,53.28823,2021/03/21 00:00:00+00,Sun 21 Mar 2021,3654,59,3,524069,195403,108,524177,195511,10.9237245908581,4.07440295641218,379
-7.6926,53.28823,2021/03/22 00:00:00+00,Mon 22 Mar 2021,7429,2416,1,531498,197819,109,531607,197928,11.078564031944,4.12477266423244,380
-7.6926,53.28823,2021/03/23 00:00:00+00,Tue 23 Mar 2021,12579,7406,4,544077,205225,113,544190,205338,11.3407907731531,4.27919531005296,381
-7.6926,53.28823,2021/03/24 00:00:00+00,Wed 24 Mar 2021,13645,9786,2,557722,215011,115,557837,215126,11.6251910224801,4.48317491292626,382
-7.6926,53.28823,2021/03/25 00:00:00+00,Thu 25 Mar 2021,20889,10230,3,578611,225241,118,578729,225359,12.0605753566882,4.6964282104541,383
-7.6926,53.28823,2021/03/26 00:00:00+00,Fri 26 Mar 2021,19713,9507,1,598324,234748,119,598443,234867,12.4714104497659,4.89457267961219,384
-7.6926,53.28823,2021/03/27 00:00:00+00,Sat 27 Mar 2021,11766,5362,3,610090,240110,122,610212,240232,12.7166736236743,5.00637800954836,385
-7.6926,53.28823,2021/03/28 00:00:00+00,Sun 28 Mar 2021,2498,489,0,612588,240599,122,612710,240721,12.7687313523193,5.01656865378672,386
-7.6926,53.28823,2021/03/28 23:00:00+00,Mon 29 Mar 2021,9290,3130,3,621878,243729,125,622003,243854,12.9623952723747,5.08185963210732,387
-7.6926,53.28823,2021/03/29 23:00:00+00,Tue 30 Mar 2021,13346,8677,4,635224,252406,129,635353,252535,13.2406061120108,5.26276961704226,388
-7.6926,53.28823,2021/03/30 23:00:00+00,Wed 31 Mar 2021,15849,10510,4,651073,262916,133,651206,263049,13.5709788791083,5.48187888804858,389
-7.6926,53.28823,2021/03/31 23:00:00+00,Thu 01 Apr 2021,19721,11589,9,670794,274505,142,670936,274647,13.9821474083983,5.7235784624381,390
-7.6926,53.28823,2021/04/01 23:00:00+00,Fri 02 Apr 2021,20160,13727,9,690954,288232,151,691105,288383,14.4024645937632,6.00983345069593,391
-7.6926,53.28823,2021/04/02 23:00:00+00,Sat 03 Apr 2021,7556,4640,7,698510,292872,158,698668,293030,14.5600757233638,6.10667583060524,392
-7.6926,53.28823,2021/04/03 23:00:00+00,Sun 04 Apr 2021,3046,172,3,701556,293044,161,701717,293205,14.6236161615699,6.11032278917724,393
-7.6926,53.28823,2021/04/04 23:00:00+00,Mon 05 Apr 2021,3450,615,6,705006,293659,167,705173,293826,14.6956383834262,6.12326428216706,394
-7.6926,53.28823,2021/04/05 23:00:00+00,Tue 06 Apr 2021,12011,8162,12,717017,301821,179,717196,302000,14.9461948572049,6.2936085071248,395
-7.6926,53.28823,2021/04/06 23:00:00+00,Wed 07 Apr 2021,18378,10495,12,735395,312316,191,735586,312507,15.3294381037149,6.51257189978825,396
-7.6926,53.28823,2021/04/07 23:00:00+00,Thu 08 Apr 2021,20202,10575,17,755597,322891,208,755805,323099,15.7507972772433,6.73330667232953,397
-7.6926,53.28823,2021/04/08 23:00:00+00,Fri 09 Apr 2021,20684,9170,16,776281,332061,224,776505,332285,16.1821803769038,6.92474073771512,398
-7.6926,53.28823,2022/05/29 23:00:00+00,Mon 30 May 2022,8,23,0,3850704,3801461,241059,4091763,4042520,85.2713722713195,84.2451598086826,399
-7.6926,53.28823,2021/05/10 23:00:00+00,Tue 11 May 2021,33925,14820,153,1472853,561848,1021,1473874,562869,30.7151852477817,11.7300567112478,400
-7.6926,53.28823,2021/12/08 00:00:00+00,Wed 08 Dec 2021,796,1526,2,3672704,3612271,240983,3913687,3853254,81.5603105874958,80.300901173883,401
-7.6926,53.28823,2022/09/27 23:00:00+00,Wed 28 Sep 2022,43,27,0,3858353,3812789,241074,4099427,4053863,85.4310882170103,84.4815452434386,402
-7.6926,53.28823,2021/05/11 23:00:00+00,Wed 12 May 2021,31300,20931,175,1504153,582779,1196,1505349,583975,31.3711167966616,12.1699007547954,403
-7.6926,53.28823,2021/12/09 00:00:00+00,Thu 09 Dec 2021,785,1213,1,3673489,3613484,240984,3914473,3854468,81.576690641425,80.3262006464911,404
-7.6926,53.28823,2022/09/28 23:00:00+00,Thu 29 Sep 2022,31,23,0,3858384,3812812,241074,4099458,4053886,85.4317342496716,84.4820245579938,405
-7.6926,53.28823,2022/05/30 23:00:00+00,Tue 31 May 2022,65,80,2,3850769,3801541,241061,4091830,4042602,85.2727685354585,84.2468686692707,406
-7.6926,53.28823,2021/05/12 23:00:00+00,Thu 13 May 2021,36010,25486,152,1540163,608265,1348,1541511,609613,32.1247243159817,12.7041906054764,407
-7.6926,53.28823,2021/12/10 00:00:00+00,Fri 10 Dec 2021,895,1618,1,3674384,3615102,240985,3915369,3856087,81.5953630693137,80.359940223223,408
-7.6926,53.28823,2022/09/29 23:00:00+00,Fri 30 Sep 2022,39,58,0,3858423,3812870,241074,4099497,4053944,85.4325470004391,84.4832332642634,409
-7.6926,53.28823,2022/05/31 23:00:00+00,Wed 01 Jun 2022,70,102,0,3850839,3801643,241061,4091900,4042704,85.2742273188874,84.2489943251241,410
-7.6926,53.28823,2021/05/13 23:00:00+00,Fri 14 May 2021,38234,27955,237,1578397,636220,1585,1579982,637805,32.9264508486889,13.2917052115455,411
-7.6926,53.28823,2021/12/11 00:00:00+00,Sat 11 Dec 2021,643,845,2,3675027,3615947,240987,3916014,3856934,81.6088047166219,80.3775915027116,412
-7.6926,53.28823,2022/09/30 23:00:00+00,Sat 01 Oct 2022,51,106,0,3858474,3812976,241074,4099548,4054050,85.4336098283658,84.4854422791699,413
-7.6926,53.28823,2022/06/01 23:00:00+00,Thu 02 Jun 2022,91,141,0,3850930,3801784,241061,4091991,4042845,85.2761237373448,84.2519327317449,414
-7.6926,53.28823,2021/05/14 23:00:00+00,Sat 15 May 2021,28878,12465,22,1607275,648685,1607,1608882,650292,33.5287200071522,13.5519313354808,415
-7.6926,53.28823,2021/12/12 00:00:00+00,Sun 12 Dec 2021,685,1193,0,3675712,3617140,240987,3916699,3858127,81.6230799544609,80.402453340291,416
-7.6926,53.28823,2021/12/13 00:00:00+00,Mon 13 Dec 2021,723,1071,1,3676435,3618211,240988,3917423,3859199,81.6381679430674,80.424793566515,417
-7.6926,53.28823,2021/12/14 00:00:00+00,Tue 14 Dec 2021,631,1204,3,3677066,3619415,240991,3918057,3860406,81.6513803529797,80.4499471607802,418
-7.6926,53.28823,2021/12/15 00:00:00+00,Wed 15 Dec 2021,790,1259,1,3677856,3620674,240992,3918848,3861666,81.6678646057252,80.4762052624987,419
-7.6926,53.28823,2021/12/16 00:00:00+00,Thu 16 Dec 2021,1049,1547,8,3678905,3622221,241000,3919905,3863221,81.6898922355002,80.5086110943814,420
-7.6926,53.28823,2021/12/17 00:00:00+00,Fri 17 Dec 2021,1197,2459,1,3680102,3624680,241001,3921103,3865681,81.714858271896,80.5598769120222,421
-7.6926,53.28823,2021/12/18 00:00:00+00,Sat 18 Dec 2021,1251,1185,0,3681353,3625865,241001,3922354,3866866,81.740928815745,80.5845720314956,422
-7.6926,53.28823,2021/12/19 00:00:00+00,Sun 19 Dec 2021,550,890,2,3681903,3626755,241003,3922906,3867758,81.7524323650693,80.6031611003312,423
-7.6926,53.28823,2021/12/20 00:00:00+00,Mon 20 Dec 2021,516,620,1,3682419,3627375,241004,3923423,3868379,81.7632065226792,80.616102593321,424
-7.6926,53.28823,2021/12/21 00:00:00+00,Tue 21 Dec 2021,1406,1819,3,3683825,3629194,241007,3924832,3870201,81.7925697491247,80.6540726419964,425
-7.6926,53.28823,2021/12/22 00:00:00+00,Wed 22 Dec 2021,1165,1601,2,3684990,3630795,241009,3925999,3871804,81.8168897528592,80.687478782516,426
-7.6926,53.28823,2021/12/23 00:00:00+00,Thu 23 Dec 2021,930,1399,0,3685920,3632194,241009,3926929,3873203,81.836270732699,80.7166336113288,427
-7.6926,53.28823,2021/12/24 00:00:00+00,Fri 24 Dec 2021,101,163,0,3686021,3632357,241009,3927030,3873366,81.8383755487891,80.7200304927416,428
-7.6926,53.28823,2021/12/25 00:00:00+00,Sat 25 Dec 2021,1,6,0,3686022,3632363,241009,3927031,3873372,81.8383963885524,80.7201555313212,429
-7.6926,53.28823,2021/12/26 00:00:00+00,Sun 26 Dec 2021,12,13,0,3686034,3632376,241009,3927043,3873385,81.8386464657116,80.7204264482437,430
-7.6926,53.28823,2021/12/27 00:00:00+00,Mon 27 Dec 2021,391,590,0,3686425,3632966,241009,3927434,3873975,81.8467948131496,80.7327219085722,431
-7.6926,53.28823,2021/12/28 00:00:00+00,Tue 28 Dec 2021,467,750,0,3686892,3633716,241009,3927901,3874725,81.8565269825961,80.7483517310237,432
-7.6926,53.28823,2021/12/29 00:00:00+00,Wed 29 Dec 2021,1058,1312,0,3687950,3635028,241009,3928959,3876037,81.8785754521343,80.7756935004321,433
-7.6926,53.28823,2021/12/30 00:00:00+00,Thu 30 Dec 2021,1051,1199,1,3689001,3636227,241010,3930011,3877237,81.9004988830929,80.8007012163545,434
-7.6926,53.28823,2021/12/31 00:00:00+00,Fri 31 Dec 2021,713,1682,0,3689714,3637909,241010,3930724,3878919,81.9153576343034,80.8357536981723,435
-7.6926,53.28823,2022/01/01 00:00:00+00,Sat 01 Jan 2022,68,100,0,3689782,3638009,241010,3930792,3879019,81.9167747382057,80.8378376744992,436
-7.6926,53.28823,2022/01/02 00:00:00+00,Sun 02 Jan 2022,271,629,0,3690053,3638638,241010,3931063,3879648,81.9224223140515,80.8509458855951,437
-7.6926,53.28823,2022/01/03 00:00:00+00,Mon 03 Jan 2022,3632,728,1,3693685,3639366,241011,3934696,3880377,81.9981331740064,80.866138073018,438
-7.6926,53.28823,2022/01/04 00:00:00+00,Tue 04 Jan 2022,1188,785,1,3694873,3640151,241012,3935885,3881163,82.0229116525328,80.8825181269471,439
-7.6926,53.28823,2022/01/05 00:00:00+00,Wed 05 Jan 2022,2139,913,0,3697012,3641064,241012,3938024,3882076,82.0674879061644,80.9015448308113,440
-7.6926,53.28823,2022/01/06 00:00:00+00,Thu 06 Jan 2022,2455,1697,1,3699467,3642761,241013,3940480,3883774,82.1186703647521,80.9369307488415,441
-7.6926,53.28823,2022/01/07 00:00:00+00,Fri 07 Jan 2022,4854,782,2,3704321,3643543,241015,3945336,3884558,82.2198682551846,80.9532691232441,442
-7.6926,53.28823,2022/01/08 00:00:00+00,Sat 08 Jan 2022,9789,745,2,3714110,3644288,241017,3955127,3885305,82.4239103773477,80.9688364264057,443
-7.6926,53.28823,2022/01/09 00:00:00+00,Sun 09 Jan 2022,7116,667,0,3721226,3644955,241017,3962243,3885972,82.5722061327672,80.9827365485059,444
-7.6926,53.28823,2022/01/10 00:00:00+00,Mon 10 Jan 2022,6663,509,1,3727889,3645464,241018,3968907,3886482,82.7110823151893,80.9933648277729,445
-7.6926,53.28823,2022/01/11 00:00:00+00,Tue 11 Jan 2022,4780,1369,1,3732669,3646833,241019,3973688,3887852,82.8107172233766,81.0219153034509,446
-7.6926,53.28823,2022/01/12 00:00:00+00,Wed 12 Jan 2022,7560,927,1,3740229,3647760,241020,3981249,3888780,82.9682866734507,81.0412546037642,447
-7.6926,53.28823,2022/01/13 00:00:00+00,Thu 13 Jan 2022,7321,817,0,3747550,3648577,241020,3988570,3889597,83.1208545803403,81.0582806903547,448
-7.6926,53.28823,2022/01/14 00:00:00+00,Fri 14 Jan 2022,10723,835,0,3758273,3649412,241020,3999293,3890432,83.3443193618698,81.075681892684,449
-7.6926,53.28823,2022/01/15 00:00:00+00,Sat 15 Jan 2022,8363,652,2,3766636,3650064,241022,4007658,3891086,83.5186439816118,81.0893110978617,450
-7.6926,53.28823,2022/01/16 00:00:00+00,Sun 16 Jan 2022,6965,1216,1,3773601,3651280,241023,4014624,3892303,83.6638137725411,81.1146730897596,451
-7.6926,53.28823,2022/01/17 00:00:00+00,Mon 17 Jan 2022,2562,562,0,3776163,3651842,241023,4017186,3892865,83.7172052460353,81.1263850367165,452
-7.6926,53.28823,2022/01/18 00:00:00+00,Tue 18 Jan 2022,4056,452,3,3780219,3652294,241026,4021245,3893320,83.8017938451426,81.1358671290038,453
-7.6926,53.28823,2022/01/19 00:00:00+00,Wed 19 Jan 2022,3487,623,0,3783706,3652917,241026,4024732,3893943,83.8744620996603,81.1488503015201,454
-7.6926,53.28823,2022/01/20 00:00:00+00,Thu 20 Jan 2022,3699,938,0,3787405,3653855,241026,4028431,3894881,83.951548383991,81.1683979994661,455
-7.6926,53.28823,2022/01/21 00:00:00+00,Fri 21 Jan 2022,3252,977,0,3790657,3654832,241026,4031683,3895858,84.0193192941405,81.1887584481795,456
-7.6926,53.28823,2022/01/22 00:00:00+00,Sat 22 Jan 2022,4272,644,0,3794929,3655476,241026,4035955,3896502,84.1083467628241,81.2021792557245,457
-7.6926,53.28823,2022/01/23 00:00:00+00,Sun 23 Jan 2022,3094,680,0,3798023,3656156,241026,4039049,3897182,84.1728249903772,81.2163502947472,458
-7.6926,53.28823,2022/01/24 00:00:00+00,Mon 24 Jan 2022,646,467,0,3798669,3656623,241026,4039695,3897649,84.1862874774488,81.2260824641936,459
-7.6926,53.28823,2022/01/25 00:00:00+00,Tue 25 Jan 2022,692,1836,1,3799361,3658459,241027,4040388,3899486,84.2007294333939,81.2643651093181,460
-7.6926,53.28823,2022/01/26 00:00:00+00,Wed 26 Jan 2022,700,897,0,3800061,3659356,241027,4041088,3900383,84.215317267682,81.2830583769701,461
-7.6926,53.28823,2022/01/27 00:00:00+00,Thu 27 Jan 2022,1274,1178,0,3801335,3660534,241027,4042362,3901561,84.2418671260862,81.3076076181005,462
-7.6926,53.28823,2022/01/28 00:00:00+00,Fri 28 Jan 2022,1028,3095,1,3802363,3663629,241028,4043391,3904657,84.2633112424896,81.3721275251802,463
-7.6926,53.28823,2022/01/29 00:00:00+00,Sat 29 Jan 2022,2328,3445,0,3804691,3667074,241028,4045719,3908102,84.311826211379,81.4439205096406,464
-7.6926,53.28823,2022/01/30 00:00:00+00,Sun 30 Jan 2022,1639,7537,0,3806330,3674611,241028,4047358,3915639,84.3459825833762,81.6009898053962,465
-7.6926,53.28823,2022/01/31 00:00:00+00,Mon 31 Jan 2022,482,1395,0,3806812,3676006,241028,4047840,3917034,84.3560273492717,81.6300612751559,466
-7.6926,53.28823,2022/02/01 00:00:00+00,Tue 01 Feb 2022,749,3418,1,3807561,3679424,241029,4048590,3920453,84.3716571717232,81.7013124257714,467
-7.6926,53.28823,2022/02/02 00:00:00+00,Wed 02 Feb 2022,652,2996,0,3808213,3682420,241029,4049242,3923449,84.3852446973743,81.7637483565242,468
-7.6926,53.28823,2022/02/03 00:00:00+00,Thu 03 Feb 2022,908,2436,1,3809121,3684856,241030,4050151,3925886,84.4041880421855,81.8145348596098,469
-7.6926,53.28823,2022/02/04 00:00:00+00,Fri 04 Feb 2022,1173,6523,0,3810294,3691379,241030,4051324,3932409,84.4286330844996,81.9504726354111,470
-7.6926,53.28823,2022/02/05 00:00:00+00,Sat 05 Feb 2022,1777,5750,0,3812071,3697129,241030,4053101,3938159,84.465665343828,82.0703012742056,471
-7.6926,53.28823,2022/02/06 00:00:00+00,Sun 06 Feb 2022,1407,7555,0,3813478,3704684,241030,4054508,3945714,84.4949868907469,82.2277456857001,472
-7.6926,53.28823,2022/02/07 00:00:00+00,Mon 07 Feb 2022,440,1351,0,3813918,3706035,241030,4054948,3947065,84.5041563865851,82.255900205876,473
-7.6926,53.28823,2022/02/08 00:00:00+00,Tue 08 Feb 2022,899,1238,0,3814817,3707273,241030,4055847,3948303,84.5228913337636,82.2816998328026,474
-7.6926,53.28823,2022/02/09 00:00:00+00,Wed 09 Feb 2022,1335,1784,0,3816152,3709057,241030,4057182,3950087,84.5507124177272,82.3188779704738,475
-7.6926,53.28823,2022/02/10 00:00:00+00,Thu 10 Feb 2022,686,2552,0,3816838,3711609,241030,4057868,3952639,84.5650084953295,82.3720610463353,476
-7.6926,53.28823,2022/02/11 00:00:00+00,Fri 11 Feb 2022,546,4923,0,3817384,3716532,241030,4058414,3957562,84.5763870060742,82.4746552009068,477
-7.6926,53.28823,2022/02/12 00:00:00+00,Sat 12 Feb 2022,1397,5462,0,3818781,3721994,241030,4059811,3963024,84.6055001553604,82.58848198788,478
-7.6926,53.28823,2022/10/01 23:00:00+00,Sun 02 Oct 2022,26,47,0,3858500,3813023,241074,4099574,4054097,85.4341516622108,84.4864217480435,479
-7.6926,53.28823,2021/05/15 23:00:00+00,Sun 16 May 2021,23187,1182,11,1630462,649867,1618,1632080,651485,34.0121608354578,13.5767931730603,480
-7.6926,53.28823,2021/05/16 23:00:00+00,Mon 17 May 2021,35399,3961,120,1665861,653828,1738,1667599,655566,34.7523683869961,13.6618402469595,481
-7.6926,53.28823,2022/06/02 23:00:00+00,Fri 03 Jun 2022,60,143,0,3850990,3801927,241061,4092051,4042988,85.2773741231409,84.2549128178924,482
-7.6926,53.28823,2022/10/02 23:00:00+00,Mon 03 Oct 2022,24,1,0,3858524,3813024,241074,4099598,4054098,85.4346518165292,84.4864425878068,483
-7.6926,53.28823,2021/05/17 23:00:00+00,Tue 18 May 2021,39026,12514,127,1704887,666342,1865,1706752,668207,35.5683076382525,13.9252756944382,484
-7.6926,53.28823,2022/06/03 23:00:00+00,Sat 04 Jun 2022,305,607,0,3851295,3802534,241061,4092356,4043595,85.2837302509378,84.2675625541964,485
-7.6926,53.28823,2022/10/03 23:00:00+00,Tue 04 Oct 2022,31,17,0,3858555,3813041,241074,4099629,4054115,85.4352978491905,84.4867968637823,486
-7.6926,53.28823,2021/05/18 23:00:00+00,Wed 19 May 2021,37044,17606,211,1741931,683948,2076,1744007,686024,36.3446930188252,14.2965777565953,487
-7.6926,53.28823,2022/06/04 23:00:00+00,Sun 05 Jun 2022,143,273,0,3851438,3802807,241061,4092499,4043868,85.2867103370853,84.2732518095687,488
-7.6926,53.28823,2022/10/04 23:00:00+00,Wed 05 Oct 2022,49,37,0,3858604,3813078,241074,4099678,4054152,85.4363189975907,84.4875679350233,489
-7.6926,53.28823,2021/05/19 23:00:00+00,Thu 20 May 2021,39100,19649,137,1781031,703597,2213,1783244,705810,37.1623828101962,14.7089133126283,490
-7.6926,53.28823,2022/06/05 23:00:00+00,Mon 06 Jun 2022,5,7,1,3851443,3802814,241062,4092505,4043876,85.2868353756649,84.2734185276749,491
-7.6926,53.28823,2022/10/05 23:00:00+00,Thu 06 Oct 2022,58,26,0,3858662,3813104,241074,4099736,4054178,85.4375277038603,84.4881097688683,492
-7.6926,53.28823,2021/05/20 23:00:00+00,Fri 21 May 2021,25848,23261,14935,1806879,726858,17148,1824027,744006,38.0122908755806,15.5049089104367,493
-7.6926,53.28823,2022/06/06 23:00:00+00,Tue 07 Jun 2022,29,53,0,3851472,3802867,241062,4092534,4043929,85.2874397287997,84.2745230351281,494
-7.6926,53.28823,2022/10/06 23:00:00+00,Fri 07 Oct 2022,82,40,0,3858744,3813144,241074,4099818,4054218,85.4392365644483,84.488943359399,495
-7.6926,53.28823,2021/05/21 23:00:00+00,Sat 22 May 2021,16597,10260,13523,1823476,737118,30671,1854147,767789,38.6399845452316,16.0005410002545,496
-7.6926,53.28823,2022/06/07 23:00:00+00,Wed 08 Jun 2022,36,76,0,3851508,3802943,241062,4092570,4044005,85.2881899602773,84.2761068571365,497
-7.6926,53.28823,2022/10/07 23:00:00+00,Sat 08 Oct 2022,100,102,0,3858844,3813246,241074,4099918,4054320,85.4413205407752,84.4910690152524,498
-7.6926,53.28823,2021/05/22 23:00:00+00,Sun 23 May 2021,8226,5536,10205,1831702,742654,40876,1872578,783530,39.0240822220356,16.3285797138659,499
-7.6926,53.28823,2022/06/08 23:00:00+00,Thu 09 Jun 2022,73,122,0,3851581,3803065,241062,4092643,4044127,85.2897112629959,84.2786493082553,500
-7.6926,53.28823,2022/10/08 23:00:00+00,Sun 09 Oct 2022,38,28,0,3858882,3813274,241074,4099956,4054348,85.4421124517794,84.4916525286239,501
-7.6926,53.28823,2021/05/23 23:00:00+00,Mon 24 May 2021,22561,8240,8453,1854263,750894,49329,1903592,800223,39.6704066400487,16.676457882109,502
-7.6926,53.28823,2022/06/09 23:00:00+00,Fri 10 Jun 2022,56,108,0,3851637,3803173,241062,4092699,4044235,85.290878289739,84.2809000026883,503
-7.6926,53.28823,2022/10/09 23:00:00+00,Mon 10 Oct 2022,19,2,0,3858901,3813276,241074,4099975,4054350,85.4425084072815,84.4916942081505,504
-7.6926,53.28823,2021/05/24 23:00:00+00,Tue 25 May 2021,30364,16517,3224,1884627,767411,52553,1937180,819964,40.3703726087153,17.087855648795,505
-7.6926,53.28823,2022/06/10 23:00:00+00,Sat 11 Jun 2022,189,562,0,3851826,3803735,241062,4092888,4044797,85.2948170049967,84.2926119496453,506
-7.6926,53.28823,2022/10/10 23:00:00+00,Tue 11 Oct 2022,80,14,0,3858981,3813290,241074,4100055,4054364,85.444175588343,84.4919859648362,507
-7.6926,53.28823,2021/05/25 23:00:00+00,Wed 26 May 2021,19988,25478,3054,1904615,792889,55607,1960222,848496,40.850562433951,17.6824557743754,508
-7.6926,53.28823,2022/06/11 23:00:00+00,Sun 12 Jun 2022,143,288,0,3851969,3804023,241062,4093031,4045085,85.2977970911442,84.2986138014667,509
-7.6926,53.28823,2022/10/11 23:00:00+00,Wed 12 Oct 2022,57,36,0,3859038,3813326,241074,4100112,4054400,85.4453634548493,84.4927361963139,510
-7.6926,53.28823,2021/05/26 23:00:00+00,Thu 27 May 2021,17023,36062,550,1921638,828951,56157,1977795,885108,41.2167795938705,18.4454411871663,511
-7.6926,53.28823,2022/06/12 23:00:00+00,Mon 13 Jun 2022,17,44,0,3851986,3804067,241062,4093048,4045129,85.2981513671197,84.2995307510505,512
-7.6926,53.28823,2022/06/13 23:00:00+00,Tue 14 Jun 2022,37,55,0,3852023,3804122,241062,4093085,4045184,85.2989224383607,84.3006769380303,513
-7.6926,53.28823,2022/06/14 23:00:00+00,Wed 15 Jun 2022,66,123,0,3852089,3804245,241062,4093151,4045307,85.3002978627364,84.3032402289123,514
-7.6926,53.28823,2022/06/15 23:00:00+00,Thu 16 Jun 2022,42,85,0,3852131,3804330,241062,4093193,4045392,85.3011731327937,84.3050116087901,515
-7.6926,53.28823,2022/06/16 23:00:00+00,Fri 17 Jun 2022,58,95,0,3852189,3804425,241062,4093251,4045487,85.3023818390633,84.3069913863006,516
-7.6926,53.28823,2022/06/17 23:00:00+00,Sat 18 Jun 2022,223,488,0,3852412,3804913,241062,4093474,4045975,85.3070291062722,84.3171611907757,517
-7.6926,53.28823,2022/06/18 23:00:00+00,Sun 19 Jun 2022,80,129,0,3852492,3805042,241062,4093554,4046104,85.3086962873336,84.3198495202374,518
-7.6926,53.28823,2022/06/19 23:00:00+00,Mon 20 Jun 2022,9,28,0,3852501,3805070,241062,4093563,4046132,85.3088838452031,84.3204330336089,519
-7.6926,53.28823,2022/06/20 23:00:00+00,Tue 21 Jun 2022,74,169,1,3852575,3805239,241063,4093638,4046302,85.3104468274482,84.3239757933646,520
-7.6926,53.28823,2022/06/21 23:00:00+00,Wed 22 Jun 2022,60,94,0,3852635,3805333,241063,4093698,4046396,85.3116972132443,84.3259347311118,521
-7.6926,53.28823,2022/06/22 23:00:00+00,Thu 23 Jun 2022,64,113,0,3852699,3805446,241063,4093762,4046509,85.3130309580935,84.3282896243612,522
-7.6926,53.28823,2022/06/23 23:00:00+00,Fri 24 Jun 2022,55,93,1,3852754,3805539,241064,4093818,4046603,85.3141979848366,84.3302485621084,523
-7.6926,53.28823,2022/06/24 23:00:00+00,Sat 25 Jun 2022,210,293,0,3852964,3805832,241064,4094028,4046896,85.318574335123,84.3363546127461,524
-7.6926,53.28823,2022/06/25 23:00:00+00,Sun 26 Jun 2022,174,402,0,3853138,3806234,241064,4094202,4047298,85.3222004539317,84.3447321975801,525
-7.6926,53.28823,2022/06/26 23:00:00+00,Mon 27 Jun 2022,4,33,0,3853142,3806267,241064,4094206,4047331,85.3222838129848,84.345419909768,526
-7.6926,53.28823,2022/06/27 23:00:00+00,Tue 28 Jun 2022,48,60,0,3853190,3806327,241064,4094254,4047391,85.3232841216217,84.3466702955641,527
-7.6926,53.28823,2022/06/28 23:00:00+00,Wed 29 Jun 2022,63,81,3,3853253,3806408,241067,4094320,4047475,85.3246595459974,84.3484208356787,528
-7.6926,53.28823,2022/06/29 23:00:00+00,Thu 30 Jun 2022,49,88,0,3853302,3806496,241067,4094369,4047563,85.3256806943976,84.3502547348463,529
-7.6926,53.28823,2022/06/30 23:00:00+00,Fri 01 Jul 2022,46,65,0,3853348,3806561,241067,4094415,4047628,85.3266393235079,84.3516093194588,530
-7.6926,53.28823,2022/07/01 23:00:00+00,Sat 02 Jul 2022,182,228,0,3853530,3806789,241067,4094597,4047856,85.3304321604228,84.356360785484,531
-7.6926,53.28823,2022/07/02 23:00:00+00,Sun 03 Jul 2022,108,273,0,3853638,3807062,241067,4094705,4048129,85.3326828548558,84.3620500408563,532
-7.6926,53.28823,2022/07/03 23:00:00+00,Mon 04 Jul 2022,14,15,0,3853652,3807077,241067,4094719,4048144,85.3329746115416,84.3623626373054,533
-7.6926,53.28823,2022/07/04 23:00:00+00,Tue 05 Jul 2022,51,70,0,3853703,3807147,241067,4094770,4048214,85.3340374394683,84.3638214207342,534
-7.6926,53.28823,2022/07/05 23:00:00+00,Wed 06 Jul 2022,60,83,0,3853763,3807230,241067,4094830,4048297,85.3352878252644,84.3655511210855,535
-7.6926,53.28823,2022/07/06 23:00:00+00,Thu 07 Jul 2022,77,77,0,3853840,3807307,241067,4094907,4048374,85.3368924870361,84.3671557828572,536
-7.6926,53.28823,2022/07/07 23:00:00+00,Fri 08 Jul 2022,99,90,0,3853939,3807397,241067,4095006,4048464,85.3389556235997,84.3690313615514,537
-7.6926,53.28823,2022/07/08 23:00:00+00,Sat 09 Jul 2022,119,143,0,3854058,3807540,241067,4095125,4048607,85.3414355554287,84.3720114476988,538
-7.6926,53.28823,2022/07/09 23:00:00+00,Sun 10 Jul 2022,132,219,0,3854190,3807759,241067,4095257,4048826,85.3441864041801,84.3765753558546,539
-7.6926,53.28823,2022/07/10 23:00:00+00,Mon 11 Jul 2022,11,16,0,3854201,3807775,241067,4095268,4048842,85.3444156415761,84.3769087920669,540
-7.6926,53.28823,2022/07/11 23:00:00+00,Tue 12 Jul 2022,44,81,0,3854245,3807856,241067,4095312,4048923,85.3453325911599,84.3785968128916,541
-7.6926,53.28823,2022/07/12 23:00:00+00,Wed 13 Jul 2022,99,74,0,3854344,3807930,241067,4095411,4048997,85.3473957277235,84.3801389553735,542
-7.6926,53.28823,2022/07/13 23:00:00+00,Thu 14 Jul 2022,71,39,0,3854415,3807969,241067,4095482,4049036,85.3488753509156,84.380951706141,543
-7.6926,53.28823,2022/07/14 23:00:00+00,Fri 15 Jul 2022,80,118,1,3854495,3808087,241068,4095563,4049155,85.3505633717403,84.38343163797,544
-7.6926,53.28823,2022/07/15 23:00:00+00,Sat 16 Jul 2022,124,210,0,3854619,3808297,241068,4095687,4049365,85.3531475023856,84.3878079882564,545
-7.6926,53.28823,2022/07/16 23:00:00+00,Sun 17 Jul 2022,119,165,0,3854738,3808462,241068,4095806,4049530,85.3556274342146,84.3912465491957,546
-7.6926,53.28823,2022/07/17 23:00:00+00,Mon 18 Jul 2022,14,19,0,3854752,3808481,241068,4095820,4049549,85.3559191909004,84.3916425046978,547
-7.6926,53.28823,2022/07/18 23:00:00+00,Tue 19 Jul 2022,30,33,0,3854782,3808514,241068,4095850,4049582,85.3565443837984,84.3923302168857,548
-7.6926,53.28823,2022/07/19 23:00:00+00,Wed 20 Jul 2022,78,66,0,3854860,3808580,241068,4095928,4049648,85.3581698853334,84.3937056412614,549
-7.6926,53.28823,2022/07/20 23:00:00+00,Thu 21 Jul 2022,52,30,0,3854912,3808610,241068,4095980,4049678,85.3592535530233,84.3943308341595,550
-7.6926,53.28823,2022/07/21 23:00:00+00,Fri 22 Jul 2022,74,70,0,3854986,3808680,241068,4096054,4049748,85.3607956955052,84.3957896175883,551
-7.6926,53.28823,2022/07/22 23:00:00+00,Sat 23 Jul 2022,99,175,0,3855085,3808855,241068,4096153,4049923,85.3628588320688,84.3994365761603,552
-7.6926,53.28823,2022/07/23 23:00:00+00,Sun 24 Jul 2022,108,231,0,3855193,3809086,241068,4096261,4050154,85.3651095265018,84.4042505614753,553
-7.6926,53.28823,2022/07/24 23:00:00+00,Mon 25 Jul 2022,14,23,0,3855207,3809109,241068,4096275,4050177,85.3654012831876,84.4047298760305,554
-7.6926,53.28823,2022/07/25 23:00:00+00,Tue 26 Jul 2022,18,16,0,3855225,3809125,241068,4096293,4050193,85.3657763989264,84.4050633122428,555
-7.6926,53.28823,2022/07/26 23:00:00+00,Wed 27 Jul 2022,61,72,1,3855286,3809197,241069,4096355,4050266,85.3670684642491,84.4065846149614,556
-7.6926,53.28823,2022/07/27 23:00:00+00,Thu 28 Jul 2022,49,71,0,3855335,3809268,241069,4096404,4050337,85.3680896126492,84.4080642381535,557
-7.6926,53.28823,2022/07/28 23:00:00+00,Fri 29 Jul 2022,71,105,0,3855406,3809373,241069,4096475,4050442,85.3695692358413,84.4102524132967,558
-7.6926,53.28823,2022/07/29 23:00:00+00,Sat 30 Jul 2022,100,119,0,3855506,3809492,241069,4096575,4050561,85.3716532121682,84.4127323451256,559
-7.6926,53.28823,2022/07/30 23:00:00+00,Sun 31 Jul 2022,32,57,0,3855538,3809549,241069,4096607,4050618,85.3723200845928,84.413920211632,560
-7.6926,53.28823,2022/07/31 23:00:00+00,Mon 01 Aug 2022,10,15,0,3855548,3809564,241069,4096617,4050633,85.3725284822254,84.414232808081,561
-7.6926,53.28823,2022/08/01 23:00:00+00,Tue 02 Aug 2022,36,28,0,3855584,3809592,241069,4096653,4050661,85.3732787137031,84.4148163214525,562
-7.6926,53.28823,2022/08/02 23:00:00+00,Wed 03 Aug 2022,93,139,0,3855677,3809731,241069,4096746,4050800,85.3752168116871,84.4177130485468,563
-7.6926,53.28823,2022/08/03 23:00:00+00,Thu 04 Aug 2022,45,52,0,3855722,3809783,241069,4096791,4050852,85.3761546010342,84.4187967162368,564
-7.6926,53.28823,2022/08/04 23:00:00+00,Fri 05 Aug 2022,96,91,0,3855818,3809874,241069,4096887,4050943,85.378155218308,84.4206931346943,565
-7.6926,53.28823,2022/08/05 23:00:00+00,Sat 06 Aug 2022,74,130,0,3855892,3810004,241069,4096961,4051073,85.3796973607899,84.4234023039192,566
-7.6926,53.28823,2022/08/06 23:00:00+00,Sun 07 Aug 2022,28,80,0,3855920,3810084,241069,4096989,4051153,85.3802808741614,84.4250694849807,567
-7.6926,53.28823,2022/08/07 23:00:00+00,Mon 08 Aug 2022,11,15,0,3855931,3810099,241069,4097000,4051168,85.3805101115573,84.4253820814297,568
-7.6926,53.28823,2022/08/08 23:00:00+00,Tue 09 Aug 2022,47,42,0,3855978,3810141,241069,4097047,4051210,85.381489580431,84.426257351487,569
-7.6926,53.28823,2022/08/09 23:00:00+00,Wed 10 Aug 2022,55,94,1,3856033,3810235,241070,4097103,4051305,85.382656607174,84.4282371289975,570
-7.6926,53.28823,2022/08/10 23:00:00+00,Thu 11 Aug 2022,45,41,0,3856078,3810276,241070,4097148,4051346,85.3835943965211,84.4290915592915,571
-7.6926,53.28823,2022/08/11 23:00:00+00,Fri 12 Aug 2022,70,75,0,3856148,3810351,241070,4097218,4051421,85.3850531799499,84.4306545415367,572
-7.6926,53.28823,2022/08/12 23:00:00+00,Sat 13 Aug 2022,103,151,0,3856251,3810502,241070,4097321,4051572,85.3871996755666,84.4338013457902,573
-7.6926,53.28823,2022/08/13 23:00:00+00,Sun 14 Aug 2022,17,26,0,3856268,3810528,241070,4097338,4051598,85.3875539515421,84.4343431796352,574
-7.6926,53.28823,2022/08/14 23:00:00+00,Mon 15 Aug 2022,7,11,0,3856275,3810539,241070,4097345,4051609,85.387699829885,84.4345724170312,575
-7.6926,53.28823,2022/08/15 23:00:00+00,Tue 16 Aug 2022,41,28,0,3856316,3810567,241070,4097386,4051637,85.388554260179,84.4351559304027,576
-7.6926,53.28823,2022/08/16 23:00:00+00,Wed 17 Aug 2022,51,58,0,3856367,3810625,241070,4097437,4051695,85.3896170881057,84.4363646366723,577
-7.6926,53.28823,2022/08/17 23:00:00+00,Thu 18 Aug 2022,55,39,0,3856422,3810664,241070,4097492,4051734,85.3907632750855,84.4371773874398,578
-7.6926,53.28823,2022/08/18 23:00:00+00,Fri 19 Aug 2022,73,56,0,3856495,3810720,241070,4097565,4051790,85.3922845778041,84.4383444141828,579
-7.6926,53.28823,2022/08/19 23:00:00+00,Sat 20 Aug 2022,109,127,0,3856604,3810847,241070,4097674,4051917,85.3945561120004,84.4409910641179,580
-7.6926,53.28823,2022/08/20 23:00:00+00,Sun 21 Aug 2022,39,36,0,3856643,3810883,241070,4097713,4051953,85.3953688627679,84.4417412955956,581
-7.6926,53.28823,2022/08/21 23:00:00+00,Mon 22 Aug 2022,12,13,0,3856655,3810896,241070,4097725,4051966,85.3956189399271,84.4420122125181,582
-7.6926,53.28823,2022/08/22 23:00:00+00,Tue 23 Aug 2022,78,72,0,3856733,3810968,241070,4097803,4052038,85.397244441462,84.4435126754734,583
-7.6926,53.28823,2022/08/23 23:00:00+00,Wed 24 Aug 2022,53,56,0,3856786,3811024,241070,4097856,4052094,85.3983489489153,84.4446797022164,584
-7.6926,53.28823,2022/08/24 23:00:00+00,Thu 25 Aug 2022,40,49,0,3856826,3811073,241070,4097896,4052143,85.399182539446,84.4457008506166,585
-7.6926,53.28823,2022/08/25 23:00:00+00,Fri 26 Aug 2022,99,90,0,3856925,3811163,241070,4097995,4052233,85.4012456760096,84.4475764293108,586
-7.6926,53.28823,2022/08/26 23:00:00+00,Sat 27 Aug 2022,86,119,0,3857011,3811282,241070,4098081,4052352,85.4030378956507,84.4500563611398,587
-7.6926,53.28823,2022/08/27 23:00:00+00,Sun 28 Aug 2022,44,20,0,3857055,3811302,241070,4098125,4052372,85.4039548452345,84.4504731564051,588
-7.6926,53.28823,2022/08/28 23:00:00+00,Mon 29 Aug 2022,13,12,0,3857068,3811314,241070,4098138,4052384,85.404225762157,84.4507232335643,589
-7.6926,53.28823,2022/08/29 23:00:00+00,Tue 30 Aug 2022,41,44,0,3857109,3811358,241070,4098179,4052428,85.405080192451,84.4516401831482,590
-7.6926,53.28823,2022/08/30 23:00:00+00,Wed 31 Aug 2022,28,30,0,3857137,3811388,241070,4098207,4052458,85.4056637058226,84.4522653760462,591
-7.6926,53.28823,2022/08/31 23:00:00+00,Thu 01 Sep 2022,33,29,0,3857170,3811417,241070,4098240,4052487,85.4063514180104,84.452869729181,592
-7.6926,53.28823,2022/09/01 23:00:00+00,Fri 02 Sep 2022,48,51,0,3857218,3811468,241070,4098288,4052538,85.4073517266473,84.4539325571077,593
-7.6926,53.28823,2022/09/02 23:00:00+00,Sat 03 Sep 2022,73,101,0,3857291,3811569,241070,4098361,4052639,85.4088730293659,84.4560373731979,594
-7.6926,53.28823,2022/09/03 23:00:00+00,Sun 04 Sep 2022,58,82,0,3857349,3811651,241070,4098419,4052721,85.4100817356355,84.4577462337859,595
-7.6926,53.28823,2022/09/04 23:00:00+00,Mon 05 Sep 2022,9,5,0,3857358,3811656,241070,4098428,4052726,85.4102692935049,84.4578504326022,596
-7.6926,53.28823,2022/09/05 23:00:00+00,Tue 06 Sep 2022,42,22,0,3857400,3811678,241070,4098470,4052748,85.4111445635622,84.4583089073941,597
-7.6926,53.28823,2022/09/06 23:00:00+00,Wed 07 Sep 2022,49,42,0,3857449,3811720,241070,4098519,4052790,85.4121657119624,84.4591841774514,598
-7.6926,53.28823,2021/05/27 23:00:00+00,Fri 28 May 2021,27054,31845,1562,1948692,860796,57719,2006411,918515,41.8131302595655,19.1416351586813,599
-7.6926,53.28823,2021/05/28 23:00:00+00,Sat 29 May 2021,24495,7401,537,1973187,868197,58256,2031443,926453,42.3347912137057,19.3070611995076,600
-7.6926,53.28823,2021/05/29 23:00:00+00,Sun 30 May 2021,24260,1688,210,1997447,869885,58466,2055913,928351,42.844740220889,19.3466150701914,601
-7.6926,53.28823,2021/05/30 23:00:00+00,Mon 31 May 2021,22601,7319,3445,2020048,877204,61911,2081959,939115,43.3875326949836,19.5709342820149,602
-7.6926,53.28823,2021/05/31 23:00:00+00,Tue 01 Jun 2021,27606,11533,3655,2047654,888737,65566,2113220,954303,44.0390045345241,19.8874486065388,603
-7.6926,53.28823,2021/06/01 23:00:00+00,Wed 02 Jun 2021,18715,20920,4008,2066369,909657,69574,2135943,979231,44.5125464752771,20.4069422252991,604
-7.6926,53.28823,2021/06/02 23:00:00+00,Thu 03 Jun 2021,16699,30711,1978,2083068,940368,71552,2154620,1011920,44.9017707338452,21.0881732467872,605
-7.6926,53.28823,2021/06/03 23:00:00+00,Fri 04 Jun 2021,28997,23351,153,2112065,963719,71705,2183770,1035424,45.5092498331256,21.577991042653,606
-7.6926,53.28823,2021/06/04 23:00:00+00,Sat 05 Jun 2021,20975,11502,35,2133040,975221,71740,2204780,1046961,45.9470932593994,21.8184193914831,607
-7.6926,53.28823,2021/06/05 23:00:00+00,Sun 06 Jun 2021,19952,3918,47,2152992,979139,71787,2224779,1050926,46.3638676850086,21.9010490528432,608
-7.6926,53.28823,2021/06/06 23:00:00+00,Mon 07 Jun 2021,19844,4606,47,2172836,983745,71834,2244670,1055579,46.7783914161849,21.9980164713321,609
-7.6926,53.28823,2021/06/07 23:00:00+00,Tue 08 Jun 2021,26426,18349,48,2199262,1002094,71882,2271144,1073976,47.3301033089584,22.381405596185,610
-7.6926,53.28823,2021/06/08 23:00:00+00,Wed 09 Jun 2021,32821,20131,175,2232083,1022225,72057,2304140,1094282,48.01773213777,22.8045778291177,611
-7.6926,53.28823,2021/06/09 23:00:00+00,Thu 10 Jun 2021,27711,27510,273,2259794,1049735,72330,2332124,1122065,48.6009120730792,23.3835689720099,612
-7.6926,53.28823,2021/06/10 23:00:00+00,Fri 11 Jun 2021,26455,32915,42,2286249,1082650,72372,2358621,1155022,49.153103280408,24.070385050054,613
-7.6926,53.28823,2021/06/11 23:00:00+00,Sat 12 Jun 2021,12224,19732,105,2298473,1102382,72477,2370950,1174859,49.4100367217469,24.4837834340137,614
-7.6926,53.28823,2021/06/12 23:00:00+00,Sun 13 Jun 2021,8559,18179,835,2307032,1120561,73312,2380344,1193873,49.6058054578923,24.8800306928033,615
-7.6926,53.28823,2021/06/13 23:00:00+00,Mon 14 Jun 2021,16029,31318,52,2323061,1151879,73364,2396425,1225243,49.9409296910151,25.5337740665401,616
-7.6926,53.28823,2021/06/14 23:00:00+00,Tue 15 Jun 2021,14710,41598,206,2337771,1193477,73570,2411341,1267047,50.2517755999299,26.4049595302217,617
-7.6926,53.28823,2021/06/15 23:00:00+00,Wed 16 Jun 2021,13482,48403,219,2351253,1241880,73789,2425042,1315669,50.5373011964733,27.4182304998688,618
-7.6926,53.28823,2021/06/16 23:00:00+00,Thu 17 Jun 2021,21582,42700,535,2372835,1284580,74324,2447159,1358904,50.9982142406855,28.3192376647878,619
-7.6926,53.28823,2021/06/17 23:00:00+00,Fri 18 Jun 2021,12023,50030,554,2384858,1334610,74878,2459736,1409488,51.260315943315,29.373396249968,620
-7.6926,53.28823,2021/06/18 23:00:00+00,Sat 19 Jun 2021,6329,32821,434,2391187,1367431,75312,2466499,1442743,51.4012552623007,30.0664225774661,621
-7.6926,53.28823,2021/06/19 23:00:00+00,Sun 20 Jun 2021,8523,26146,178,2399710,1393577,75490,2475200,1469067,51.582582042501,30.6150085057494,622
-7.6926,53.28823,2021/06/20 23:00:00+00,Mon 21 Jun 2021,15495,32349,575,2415205,1425926,76065,2491270,1501991,51.9174770382278,31.3011368716056,623
-7.6926,53.28823,2021/06/21 23:00:00+00,Tue 22 Jun 2021,15155,43559,722,2430360,1469485,76787,2507147,1546272,52.2483499596438,32.2239424289036,624
-7.6926,53.28823,2021/06/22 23:00:00+00,Wed 23 Jun 2021,20106,39409,885,2450466,1508894,77672,2528138,1586566,52.6857974304155,33.0636598500496,625
-7.6926,53.28823,2021/06/23 23:00:00+00,Thu 24 Jun 2021,19031,44279,1032,2469497,1553173,78704,2548201,1631877,53.1039056008739,34.0079303635142,626
-7.6926,53.28823,2021/06/24 23:00:00+00,Fri 25 Jun 2021,15222,50132,843,2484719,1603305,79547,2564266,1682852,53.4386963977844,35.0702372961324,627
-7.6926,53.28823,2021/06/25 23:00:00+00,Sat 26 Jun 2021,9074,30576,512,2493793,1633881,80059,2573852,1713940,53.6384663684774,35.7181038566274,628
-7.6926,53.28823,2021/06/26 23:00:00+00,Sun 27 Jun 2021,8741,30486,59,2502534,1664367,80118,2582652,1744485,53.8218562852413,36.3546544256676,629
-7.6926,53.28823,2021/06/27 23:00:00+00,Mon 28 Jun 2021,24245,24664,527,2526779,1689031,80645,2607424,1769676,54.3380989009317,36.8796289021675,630
-7.6926,53.28823,2021/06/28 23:00:00+00,Tue 29 Jun 2021,28152,31062,812,2554931,1720093,81457,2636388,1801550,54.9417018042442,37.5438755165917,631
-7.6926,53.28823,2021/06/29 23:00:00+00,Wed 30 Jun 2021,22587,36884,589,2577518,1756977,82046,2659564,1839023,55.4246841577578,38.3248039655569,632
-7.6926,53.28823,2021/06/30 23:00:00+00,Thu 01 Jul 2021,15049,48307,643,2592567,1805284,82689,2675256,1887973,55.7517017229691,39.3449103775561,633
-7.6926,53.28823,2021/07/01 23:00:00+00,Fri 02 Jul 2021,13694,47276,818,2606261,1852560,83507,2689768,1936067,56.0541283675234,40.3471779521973,634
-7.6926,53.28823,2021/07/02 23:00:00+00,Sat 03 Jul 2021,9322,30487,506,2615583,1883047,84013,2699596,1967060,56.2589415609274,40.9930647351818,635
-7.6926,53.28823,2021/07/03 23:00:00+00,Sun 04 Jul 2021,6460,27786,233,2622043,1910833,84246,2706289,1995079,56.3984220964844,41.5769740622054,636
-7.6926,53.28823,2021/07/04 23:00:00+00,Mon 05 Jul 2021,15634,33475,5342,2637677,1944308,89588,2727265,2033896,56.835556970807,42.3859111530037,637
-7.6926,53.28823,2021/07/05 23:00:00+00,Tue 06 Jul 2021,12408,48307,5488,2650085,1992615,95076,2745161,2087691,57.2085053742624,43.5069862180394,638
-7.6926,53.28823,2021/07/06 23:00:00+00,Wed 07 Jul 2021,19712,43771,5059,2669797,2036386,100135,2769932,2136521,57.7247271501895,44.5245918584463,639
-7.6926,53.28823,2021/07/07 23:00:00+00,Thu 08 Jul 2021,17799,45612,5997,2687596,2081998,106132,2793728,2188130,58.2206301569297,45.6001112009768,640
-7.6926,53.28823,2021/07/08 23:00:00+00,Fri 09 Jul 2021,13531,45098,6531,2701127,2127096,112663,2813790,2239759,58.6387174876248,46.6760473387727,641
-7.6926,53.28823,2021/07/09 23:00:00+00,Sat 10 Jul 2021,8645,23884,4365,2709772,2150980,117028,2826800,2268008,58.9098428077496,47.264749811348,642
-7.6926,53.28823,2021/07/10 23:00:00+00,Sun 11 Jul 2021,15244,16121,2153,2725016,2167101,119181,2844197,2286282,59.2723921693339,47.6455756453189,643
-7.6926,53.28823,2021/07/11 23:00:00+00,Mon 12 Jul 2021,17125,31783,6092,2742141,2198884,125273,2867414,2324157,59.7562289531416,48.4348816791181,644
-7.6926,53.28823,2021/07/12 23:00:00+00,Tue 13 Jul 2021,20118,36578,8490,2762259,2235462,133763,2896022,2369225,60.3524129007304,49.3740881301085,645
-7.6926,53.28823,2021/07/13 23:00:00+00,Wed 14 Jul 2021,20804,35731,9335,2783063,2271193,143098,2926161,2414291,60.9805025258835,50.3132529015723,646
-7.6926,53.28823,2021/07/14 23:00:00+00,Thu 15 Jul 2021,23660,28845,9585,2806723,2300038,152683,2959406,2452721,61.673320455749,51.1141250039856,647
-7.6926,53.28823,2021/07/15 23:00:00+00,Fri 16 Jul 2021,23519,27437,9168,2830242,2327475,161851,2992093,2489326,62.3545097977105,51.8769645384336,648
-7.6926,53.28823,2021/07/16 23:00:00+00,Sat 17 Jul 2021,11518,19435,4678,2841760,2346910,166529,3008289,2513439,62.6920306036091,52.37947375013,649
-7.6926,53.28823,2021/07/17 23:00:00+00,Sun 18 Jul 2021,16871,15826,1931,2858631,2362736,168460,3027091,2531196,63.0838598325858,52.749525426491,650
-7.6926,53.28823,2021/07/18 23:00:00+00,Mon 19 Jul 2021,24908,18453,6253,2883539,2381189,174713,3058252,2555902,63.7332476957995,53.2643926178056,651
-7.6926,53.28823,2021/07/19 23:00:00+00,Tue 20 Jul 2021,30603,18193,7699,2914142,2399382,182412,3096554,2581794,64.5314523085144,53.8039757683569,652
-7.6926,53.28823,2021/07/20 23:00:00+00,Wed 21 Jul 2021,30371,19852,6894,2944513,2419234,189306,3133819,2608540,65.3080460867197,54.3613560767395,653
-7.6926,53.28823,2022/10/12 23:00:00+00,Thu 13 Oct 2022,80,29,0,3859118,3813355,241074,4100192,4054429,85.4470306359108,84.4933405494487,654
-7.6926,53.28823,2022/10/13 23:00:00+00,Fri 14 Oct 2022,131,21,0,3859249,3813376,241074,4100323,4054450,85.449760644899,84.4937781844773,655
-7.6926,53.28823,2022/10/14 23:00:00+00,Sat 15 Oct 2022,97,120,0,3859346,3813496,241074,4100420,4054570,85.451782101936,84.4962789560696,656
-7.6926,53.28823,2022/10/15 23:00:00+00,Sun 16 Oct 2022,26,37,1,3859372,3813533,241075,4100447,4054608,85.4523447755443,84.4970708670738,657
-7.6926,53.28823,2022/10/16 23:00:00+00,Mon 17 Oct 2022,57,3,0,3859429,3813536,241075,4100504,4054611,85.4535326420506,84.4971333863636,658
-7.6926,53.28823,2022/10/17 23:00:00+00,Tue 18 Oct 2022,119,17,0,3859548,3813553,241075,4100623,4054628,85.4560125738796,84.4974876623392,659
-7.6926,53.28823,2022/10/18 23:00:00+00,Wed 19 Oct 2022,89,40,0,3859637,3813593,241075,4100712,4054668,85.4578673128105,84.4983212528699,660
-7.6926,53.28823,2022/10/19 23:00:00+00,Thu 20 Oct 2022,125,10,0,3859762,3813603,241075,4100837,4054678,85.460472283219,84.4985296505026,661
-7.6926,53.28823,2022/10/20 23:00:00+00,Fri 21 Oct 2022,133,18,0,3859895,3813621,241075,4100970,4054696,85.4632439717338,84.4989047662414,662
-7.6926,53.28823,2022/10/21 23:00:00+00,Sat 22 Oct 2022,101,56,0,3859996,3813677,241075,4101071,4054752,85.4653487878239,84.5000717929845,663
-7.6926,53.28823,2022/10/22 23:00:00+00,Sun 23 Oct 2022,81,47,0,3860077,3813724,241075,4101152,4054799,85.4670368086487,84.5010512618581,664
-7.6926,53.28823,2022/10/23 23:00:00+00,Mon 24 Oct 2022,76,4,0,3860153,3813728,241075,4101228,4054803,85.4686206306571,84.5011346209112,665
-7.6926,53.28823,2022/10/24 23:00:00+00,Tue 25 Oct 2022,75,27,0,3860228,3813755,241075,4101303,4054830,85.4701836129022,84.5016972945194,666
-7.6926,53.28823,2022/10/25 23:00:00+00,Wed 26 Oct 2022,46,25,0,3860274,3813780,241075,4101349,4054855,85.4711422420126,84.5022182886011,667
-7.6926,53.28823,2022/10/26 23:00:00+00,Thu 27 Oct 2022,64,35,0,3860338,3813815,241075,4101413,4054890,85.4724759868618,84.5029476803155,668
-7.6926,53.28823,2022/10/27 23:00:00+00,Fri 28 Oct 2022,59,19,0,3860397,3813834,241075,4101472,4054909,85.4737055328946,84.5033436358176,669
-7.6926,53.28823,2022/10/28 23:00:00+00,Sat 29 Oct 2022,91,61,0,3860488,3813895,241075,4101563,4054970,85.4756019513521,84.504614861377,670
-7.6926,53.28823,2022/10/29 23:00:00+00,Sun 30 Oct 2022,11,6,0,3860499,3813901,241075,4101574,4054976,85.475831188748,84.5047398999566,671
-7.6926,53.28823,2022/10/31 00:00:00+00,Mon 31 Oct 2022,1,1,0,3860500,3813902,241075,4101575,4054977,85.4758520285113,84.5047607397199,672
-7.6926,53.28823,2022/11/01 00:00:00+00,Tue 01 Nov 2022,96,25,0,3860596,3813927,241075,4101671,4055002,85.4778526457851,84.5052817338016,673
-7.6926,53.28823,2022/11/02 00:00:00+00,Wed 02 Nov 2022,119,12,0,3860715,3813939,241075,4101790,4055014,85.480332577614,84.5055318109608,674
-7.6926,53.28823,2022/11/03 00:00:00+00,Thu 03 Nov 2022,92,28,0,3860807,3813967,241075,4101882,4055042,85.4822498358348,84.5061153243324,675
-7.6926,53.28823,2022/11/04 00:00:00+00,Fri 04 Nov 2022,60,22,0,3860867,3813989,241075,4101942,4055064,85.4835002216309,84.5065737991243,676
-7.6926,53.28823,2022/11/05 00:00:00+00,Sat 05 Nov 2022,47,54,0,3860914,3814043,241075,4101989,4055118,85.4844796905045,84.5076991463408,677
-7.6926,53.28823,2022/11/06 00:00:00+00,Sun 06 Nov 2022,56,77,0,3860970,3814120,241075,4102045,4055195,85.4856467172475,84.5093038081125,678
-7.6926,53.28823,2022/11/07 00:00:00+00,Mon 07 Nov 2022,44,3,0,3861014,3814123,241075,4102089,4055198,85.4865636668314,84.5093663274023,679
-7.6926,53.28823,2022/11/08 00:00:00+00,Tue 08 Nov 2022,70,29,0,3861084,3814152,241075,4102159,4055227,85.4880224502602,84.5099706805371,680
-7.6926,53.28823,2022/11/09 00:00:00+00,Wed 09 Nov 2022,90,32,0,3861174,3814184,241075,4102249,4055259,85.4898980289543,84.5106375529617,681
-7.6926,53.28823,2022/11/10 00:00:00+00,Thu 10 Nov 2022,48,15,0,3861222,3814199,241075,4102297,4055274,85.4908983375912,84.5109501494107,682
-7.6926,53.28823,2022/11/11 00:00:00+00,Fri 11 Nov 2022,50,16,0,3861272,3814215,241075,4102347,4055290,85.4919403257547,84.511283585623,683
-7.6926,53.28823,2022/11/12 00:00:00+00,Sat 12 Nov 2022,74,87,0,3861346,3814302,241075,4102421,4055377,85.4934824682366,84.5130966450273,684
-7.6926,53.28823,2022/11/13 00:00:00+00,Sun 13 Nov 2022,43,61,1,3861389,3814363,241076,4102465,4055439,85.4943994178204,84.51438871035,685
-7.6926,53.28823,2022/11/14 00:00:00+00,Mon 14 Nov 2022,16,2,0,3861405,3814365,241076,4102481,4055441,85.4947328540327,84.5144303898765,686
-7.6926,53.28823,2022/11/15 00:00:00+00,Tue 15 Nov 2022,58,6,0,3861463,3814371,241076,4102539,4055447,85.4959415603022,84.5145554284561,687
-7.6926,53.28823,2022/11/16 00:00:00+00,Wed 16 Nov 2022,47,20,0,3861510,3814391,241076,4102586,4055467,85.4969210291759,84.5149722237215,688
-7.6926,53.28823,2022/11/17 00:00:00+00,Thu 17 Nov 2022,65,8,1,3861575,3814399,241077,4102652,4055476,85.4982964535516,84.5151597815909,689
-7.6926,53.28823,2022/11/18 00:00:00+00,Fri 18 Nov 2022,28,22,0,3861603,3814421,241077,4102680,4055498,85.4988799669231,84.5156182563829,690
-7.6926,53.28823,2022/11/19 00:00:00+00,Sat 19 Nov 2022,54,57,0,3861657,3814478,241077,4102734,4055555,85.5000053141396,84.5168061228892,691
-7.6926,53.28823,2022/11/20 00:00:00+00,Sun 20 Nov 2022,42,54,0,3861699,3814532,241077,4102776,4055609,85.5008805841969,84.5179314701057,692
-7.6926,53.28823,2022/11/21 00:00:00+00,Mon 21 Nov 2022,18,3,0,3861717,3814535,241077,4102794,4055612,85.5012556999358,84.5179939893955,693
-7.6926,53.28823,2022/11/22 00:00:00+00,Tue 22 Nov 2022,49,22,0,3861766,3814557,241077,4102843,4055634,85.5022768483359,84.5184524641874,694
-7.6926,53.28823,2022/11/23 00:00:00+00,Wed 23 Nov 2022,23,16,0,3861789,3814573,241077,4102866,4055650,85.5027561628911,84.5187859003997,695
-7.6926,53.28823,2022/11/24 00:00:00+00,Thu 24 Nov 2022,26,17,0,3861815,3814590,241077,4102892,4055667,85.5032979967361,84.5191401763752,696
-7.6926,53.28823,2022/11/25 00:00:00+00,Fri 25 Nov 2022,19,9,0,3861834,3814599,241077,4102911,4055676,85.5036939522382,84.5193277342447,697
-7.6926,53.28823,2022/11/26 00:00:00+00,Sat 26 Nov 2022,66,62,0,3861900,3814661,241077,4102977,4055738,85.5050693766139,84.5206197995673,698
-7.6926,53.28823,2022/11/27 00:00:00+00,Sun 27 Nov 2022,35,42,0,3861935,3814703,241077,4103012,4055780,85.5057987683283,84.5214950696246,699
-7.6926,53.28823,2022/11/28 00:00:00+00,Mon 28 Nov 2022,17,0,0,3861952,3814703,241077,4103029,4055780,85.5061530443039,84.5214950696246,700
-7.6926,53.28823,2022/11/29 00:00:00+00,Tue 29 Nov 2022,33,18,0,3861985,3814721,241077,4103062,4055798,85.5068407564917,84.5218701853634,701
-7.6926,53.28823,2022/11/30 00:00:00+00,Wed 30 Nov 2022,48,9,0,3862033,3814730,241077,4103110,4055807,85.5078410651286,84.5220577432329,702
-7.6926,53.28823,2022/12/01 00:00:00+00,Thu 01 Dec 2022,20,7,0,3862053,3814737,241077,4103130,4055814,85.508257860394,84.5222036215757,703
-7.6926,53.28823,2022/12/02 00:00:00+00,Fri 02 Dec 2022,20,14,0,3862073,3814751,241077,4103150,4055828,85.5086746556594,84.5224953782615,704
-7.6926,53.28823,2022/12/03 00:00:00+00,Sat 03 Dec 2022,44,61,0,3862117,3814812,241077,4103194,4055889,85.5095916052432,84.5237666038209,705
-7.6926,53.28823,2022/12/04 00:00:00+00,Sun 04 Dec 2022,44,44,0,3862161,3814856,241077,4103238,4055933,85.510508554827,84.5246835534047,706
-7.6926,53.28823,2022/12/05 00:00:00+00,Mon 05 Dec 2022,20,5,0,3862181,3814861,241077,4103258,4055938,85.5109253500924,84.5247877522211,707
-7.6926,53.28823,2022/12/06 00:00:00+00,Tue 06 Dec 2022,38,23,0,3862219,3814884,241077,4103296,4055961,85.5117172610966,84.5252670667762,708
-7.6926,53.28823,2022/12/07 00:00:00+00,Wed 07 Dec 2022,21,18,0,3862240,3814902,241077,4103317,4055979,85.5121548961252,84.5256421825151,709
-7.6926,53.28823,2022/12/08 00:00:00+00,Thu 08 Dec 2022,17,8,1,3862257,3814910,241078,4103335,4055988,85.5125300118641,84.5258297403845,710
-7.6926,53.28823,2022/12/09 00:00:00+00,Fri 09 Dec 2022,27,16,0,3862284,3814926,241078,4103362,4056004,85.5130926854723,84.5261631765968,711
-7.6926,53.28823,2022/12/10 00:00:00+00,Sat 10 Dec 2022,51,42,0,3862335,3814968,241078,4103413,4056046,85.514155513399,84.5270384466541,712
-7.6926,53.28823,2022/12/11 00:00:00+00,Sun 11 Dec 2022,29,37,0,3862364,3815005,241078,4103442,4056083,85.5147598665338,84.527809517895,713
-7.6926,53.28823,2022/12/12 00:00:00+00,Mon 12 Dec 2022,16,2,0,3862380,3815007,241078,4103458,4056085,85.5150933027461,84.5278511974215,714
-7.6926,53.28823,2022/12/13 00:00:00+00,Tue 13 Dec 2022,29,9,0,3862409,3815016,241078,4103487,4056094,85.5156976558809,84.528038755291,715
