X,Y,VaccinationDate,VaccineText,Dose1,Dose2,SingleDose,Dose1Cum,Dose2Cum,SingleDoseCum,PartiallyVacc,FullyVacc,PartialPercent,FullyPercent,ObjectId
-7.6926,53.28823,2020/12/28 00:00:00+00,Mon 28 Dec 2020,298,23,4,298,23,4,302,27,0.00592130274934714,0.000529387994146929,1
-7.6926,53.28823,2020/12/29 00:00:00+00,Tue 29 Dec 2020,81,3,0,379,26,4,383,30,0.00750946673178793,0.000588208882385477,2
-7.6926,53.28823,2020/12/30 00:00:00+00,Wed 30 Dec 2020,1066,2,0,1445,28,4,1449,32,0.0284104890192186,0.000627422807877842,3
-7.6926,53.28823,2020/12/31 00:00:00+00,Thu 31 Dec 2020,1042,2,0,2487,30,4,2491,34,0.0488409442007408,0.000666636733370208,4
-7.6926,53.28823,2021/01/01 00:00:00+00,Fri 01 Jan 2021,829,1,0,3316,31,4,3320,35,0.0650951163173261,0.00068624369611639,5
-7.6926,53.28823,2021/01/02 00:00:00+00,Sat 02 Jan 2021,1021,0,0,4337,31,4,4341,35,0.0851138252811785,0.00068624369611639,6
-7.6926,53.28823,2021/01/03 00:00:00+00,Sun 03 Jan 2021,26,3,1,4363,34,5,4368,39,0.0856432132753255,0.00076467154710112,7
-7.6926,53.28823,2021/01/04 00:00:00+00,Mon 04 Jan 2021,1198,5,0,5561,39,5,5566,44,0.109132354645252,0.000862706360832033,8
-7.6926,53.28823,2021/01/05 00:00:00+00,Tue 05 Jan 2021,3546,14,0,9107,53,5,9112,58,0.178658644543216,0.00113720383927859,9
-7.6926,53.28823,2021/01/06 00:00:00+00,Wed 06 Jan 2021,6797,14,0,15904,67,5,15909,72,0.311927170329019,0.00141170131772515,10
-7.6926,53.28823,2021/01/07 00:00:00+00,Thu 07 Jan 2021,11743,9,0,27647,76,5,27652,81,0.542171733857441,0.00158816398244079,11
-7.6926,53.28823,2021/01/08 00:00:00+00,Fri 08 Jan 2021,12692,8,0,40339,84,5,40344,89,0.79102330503199,0.00174501968441025,12
-7.6926,53.28823,2021/01/09 00:00:00+00,Sat 09 Jan 2021,8081,7,0,48420,91,5,48425,96,0.949467170983891,0.00188226842363353,13
-7.6926,53.28823,2021/01/10 00:00:00+00,Sun 10 Jan 2021,4790,6,1,53210,97,6,53216,103,1.04340412950085,0.00201951716285681,14
-7.6926,53.28823,2021/01/11 00:00:00+00,Mon 11 Jan 2021,8356,8,0,61566,105,6,61572,111,1.20723991020795,0.00217637286482627,15
-7.6926,53.28823,2021/01/12 00:00:00+00,Tue 12 Jan 2021,8902,15,0,70468,120,6,70474,126,1.38178109257447,0.002470477306019,16
-7.6926,53.28823,2021/01/13 00:00:00+00,Wed 13 Jan 2021,9908,6,0,80376,126,6,80382,132,1.57604687946365,0.0025881190824961,17
-7.6926,53.28823,2021/01/14 00:00:00+00,Thu 14 Jan 2021,8101,6,0,88477,132,6,88483,138,1.73488288467047,0.00270576085897319,18
-7.6926,53.28823,2021/01/15 00:00:00+00,Fri 15 Jan 2021,7708,5,0,96185,137,6,96191,143,1.88601335351805,0.00280379567270411,19
-7.6926,53.28823,2021/01/16 00:00:00+00,Sat 16 Jan 2021,5249,3,0,101434,140,6,101440,146,1.98893030097276,0.00286261656094266,20
-7.6926,53.28823,2021/01/17 00:00:00+00,Sun 17 Jan 2021,1117,5,0,102551,145,6,102557,151,2.01083127836025,0.00296065137467357,21
-7.6926,53.28823,2021/01/18 00:00:00+00,Mon 18 Jan 2021,8732,9,1,111283,154,7,111290,161,2.18205888402266,0.00315672100213539,22
-7.6926,53.28823,2021/01/19 00:00:00+00,Tue 19 Jan 2021,8400,21,0,119683,175,7,119690,182,2.34675737109059,0.00356846721980523,23
-7.6926,53.28823,2021/01/20 00:00:00+00,Wed 20 Jan 2021,8459,966,0,128142,1141,7,128149,1148,2.51261266896055,0.0225087932326176,24
-7.6926,53.28823,2021/01/21 00:00:00+00,Thu 21 Jan 2021,9025,967,0,137167,2108,7,137174,2115,2.68956550774485,0.0414687262081761,25
-7.6926,53.28823,2021/01/22 00:00:00+00,Fri 22 Jan 2021,6800,972,0,143967,3080,7,143974,3087,2.82289285441889,0.0605266939974656,26
-7.6926,53.28823,2021/01/23 00:00:00+00,Sat 23 Jan 2021,4201,461,0,148168,3541,7,148175,3548,2.9052617049156,0.0695655038234558,27
-7.6926,53.28823,2021/01/24 00:00:00+00,Sun 24 Jan 2021,1191,400,0,149359,3941,7,149366,3948,2.92861359754631,0.0774082889219288,28
-7.6926,53.28823,2021/01/25 00:00:00+00,Mon 25 Jan 2021,1378,1295,0,150737,5236,7,150744,5243,2.95563199221055,0.102799305678235,29
-7.6926,53.28823,2021/01/26 00:00:00+00,Tue 26 Jan 2021,1012,3508,0,151749,8744,7,151756,8751,2.97547423850968,0.171580530991844,30
-7.6926,53.28823,2021/01/27 00:00:00+00,Wed 27 Jan 2021,2195,6711,0,153944,15455,7,153951,15462,3.01851152173755,0.303162857981475,31
-7.6926,53.28823,2021/01/28 00:00:00+00,Thu 28 Jan 2021,1028,11545,0,154972,27000,7,154979,27007,3.03866747944063,0.529525242886153,32
-7.6926,53.28823,2021/01/29 00:00:00+00,Fri 29 Jan 2021,1597,11527,0,156569,38527,7,156576,38534,3.06997979894628,0.755534702461399,33
-7.6926,53.28823,2021/01/30 00:00:00+00,Sat 30 Jan 2021,657,7794,0,157226,46321,7,157233,46328,3.08286157347052,0.908351370105146,34
-7.6926,53.28823,2021/01/31 00:00:00+00,Sun 31 Jan 2021,241,4088,0,157467,50409,7,157474,50416,3.08758685149235,0.988504633811541,35
-7.6926,53.28823,2021/02/01 00:00:00+00,Mon 01 Feb 2021,1046,8339,1,158513,58748,8,158521,58756,3.10811534148761,1.1520267031147,36
-7.6926,53.28823,2021/02/02 00:00:00+00,Tue 02 Feb 2021,852,5113,1,159365,63861,9,159374,63870,3.1248400807101,1.25229671059868,37
-7.6926,53.28823,2021/02/03 00:00:00+00,Wed 03 Feb 2021,1416,6873,0,160781,70734,9,160790,70743,3.1526035399587,1.38705536555319,38
-7.6926,53.28823,2021/02/04 00:00:00+00,Thu 04 Feb 2021,1459,10542,1,162240,81276,10,162250,81286,3.18122970556812,1.5937715737862,39
-7.6926,53.28823,2021/02/05 00:00:00+00,Fri 05 Feb 2021,3411,8616,0,165651,89892,10,165661,89902,3.24810905549535,1.76270516480731,40
-7.6926,53.28823,2021/02/06 00:00:00+00,Sat 06 Feb 2021,916,3871,0,166567,93763,10,166577,93773,3.26606903337085,1.83860371759778,41
-7.6926,53.28823,2021/02/07 00:00:00+00,Sun 07 Feb 2021,341,1300,2,166908,95063,12,166920,95075,3.27279422159279,1.86413198309331,42
-7.6926,53.28823,2021/02/08 00:00:00+00,Mon 08 Feb 2021,1197,883,0,168105,95946,12,168117,95958,3.29626375599998,1.88144493119819,43
-7.6926,53.28823,2021/02/09 00:00:00+00,Tue 09 Feb 2021,4278,556,3,172383,96502,15,172398,96517,3.38020116351638,1.8924052233733,44
-7.6926,53.28823,2021/02/10 00:00:00+00,Wed 10 Feb 2021,8837,586,0,181220,97088,15,181235,97103,3.5534678933044,1.90389490354257,45
-7.6926,53.28823,2021/02/11 00:00:00+00,Thu 11 Feb 2021,6209,452,0,187429,97540,15,187444,97555,3.67520752499545,1.91275725070384,46
-7.6926,53.28823,2021/02/12 00:00:00+00,Fri 12 Feb 2021,4409,528,0,191838,98068,15,191853,98083,3.76165462374337,1.92310972703383,47
-7.6926,53.28823,2021/02/13 00:00:00+00,Sat 13 Feb 2021,1225,1920,0,193063,99988,15,193078,100003,3.78567315310744,1.9607550955065,48
-7.6926,53.28823,2021/02/14 00:00:00+00,Sun 14 Feb 2021,2712,29,0,195775,100017,15,195790,100032,3.83884723607509,1.96132369742614,49
-7.6926,53.28823,2021/02/15 00:00:00+00,Mon 15 Feb 2021,1978,7898,0,197753,107915,15,197768,107930,3.87762980838703,2.11617948919549,50
-7.6926,53.28823,2021/02/16 00:00:00+00,Tue 16 Feb 2021,5665,8171,0,203418,116086,15,203433,116101,3.98870325234416,2.27638798179454,51
-7.6926,53.28823,2021/02/17 00:00:00+00,Wed 17 Feb 2021,9763,8467,0,213181,124553,15,213196,124568,4.18012602963514,2.44240013536647,52
-7.6926,53.28823,2021/02/18 00:00:00+00,Thu 18 Feb 2021,8478,8362,1,221659,132915,16,221675,132931,4.34637346676002,2.6063731648128,53
-7.6926,53.28823,2021/02/19 00:00:00+00,Fri 19 Feb 2021,9405,6595,2,231064,139510,18,231082,139528,4.53081616531336,2.73572029804936,54
-7.6926,53.28823,2021/02/20 00:00:00+00,Sat 20 Feb 2021,5900,3581,2,236964,143091,20,236984,143111,4.64653645944133,2.80597204556893,55
-7.6926,53.28823,2021/02/21 00:00:00+00,Sun 21 Feb 2021,1121,1026,7,238085,144117,27,238112,144144,4.66865311341903,2.82622603808574,56
-7.6926,53.28823,2021/02/22 00:00:00+00,Mon 22 Feb 2021,3956,1131,2,242041,145248,29,242070,145277,4.74625747196842,2.84844072687717,57
-7.6926,53.28823,2021/02/23 00:00:00+00,Tue 23 Feb 2021,13380,1074,1,255421,146322,30,255451,146352,5.00861824047508,2.86951821182931,58
-7.6926,53.28823,2021/02/24 00:00:00+00,Wed 24 Feb 2021,16958,2113,6,272379,148435,36,272415,148471,5.34123075650133,2.91106536588847,59
-7.6926,53.28823,2021/02/25 00:00:00+00,Thu 25 Feb 2021,18111,1770,3,290490,150205,39,290529,150244,5.69639127968568,2.94582851083745,60
-7.6926,53.28823,2021/02/26 00:00:00+00,Fri 26 Feb 2021,16102,2783,1,306592,152988,40,306632,153028,6.01212220078745,3.00041429512283,61
-7.6926,53.28823,2021/02/27 00:00:00+00,Sat 27 Feb 2021,9012,707,1,315604,153695,41,315645,153736,6.1888397560188,3.01429602474712,62
-7.6926,53.28823,2021/02/28 00:00:00+00,Sun 28 Feb 2021,2454,61,2,318058,153756,43,318101,153799,6.23699445652342,3.01553126340013,63
-7.6926,53.28823,2021/03/01 00:00:00+00,Mon 01 Mar 2021,5640,810,0,323698,154566,43,323741,154609,6.34757772641189,3.03141290322454,64
-7.6926,53.28823,2021/03/02 00:00:00+00,Tue 02 Mar 2021,12215,1622,0,335913,156188,43,335956,156231,6.58707677635651,3.06321539679885,65
-7.6926,53.28823,2021/03/03 00:00:00+00,Wed 03 Mar 2021,12930,1516,1,348843,157704,44,348887,157748,6.8406144116274,3.09295915928481,66
-7.6926,53.28823,2021/03/04 00:00:00+00,Thu 04 Mar 2021,18746,1700,5,367589,159404,49,367638,159453,7.20826457008107,3.12638903076705,67
-7.6926,53.28823,2021/03/05 00:00:00+00,Fri 05 Mar 2021,18480,2408,6,386069,161812,55,386124,161867,7.570718883407,3.17372023883633,68
-7.6926,53.28823,2021/03/06 00:00:00+00,Sat 06 Mar 2021,10418,151,5,396487,161963,60,396547,162023,7.77508225611046,3.17677892502474,69
-7.6926,53.28823,2021/03/07 00:00:00+00,Sun 07 Mar 2021,1540,18,5,398027,161981,65,398092,162046,7.80537501355331,3.1772298851679,70
-7.6926,53.28823,2021/03/08 00:00:00+00,Mon 08 Mar 2021,6687,1514,6,404714,163495,71,404785,163566,7.93660441521351,3.2070324685421,71
-7.6926,53.28823,2021/03/09 00:00:00+00,Tue 09 Mar 2021,13866,3116,7,418580,166611,78,418658,166689,8.2086118093913,3.26826501319843,72
-7.6926,53.28823,2021/03/10 00:00:00+00,Wed 10 Mar 2021,13767,4009,3,432347,170620,81,432428,170701,8.47859968640624,3.34692814773611,73
-7.6926,53.28823,2021/03/11 00:00:00+00,Thu 11 Mar 2021,18515,2109,4,450862,172729,85,450947,172814,8.84170102950279,3.3883576600188,74
-7.6926,53.28823,2021/03/12 00:00:00+00,Fri 12 Mar 2021,17366,1353,4,468228,174082,89,468317,174171,9.18227397240398,3.41496430846537,75
-7.6926,53.28823,2021/03/13 00:00:00+00,Sat 13 Mar 2021,8341,181,0,476569,174263,89,476658,174352,9.34581564866989,3.41851316872242,76
-7.6926,53.28823,2021/03/14 00:00:00+00,Sun 14 Mar 2021,402,24,3,476971,174287,92,477063,174379,9.3537564685821,3.41904255671657,77
-7.6926,53.28823,2021/03/15 00:00:00+00,Mon 15 Mar 2021,2681,1007,0,479652,175294,92,479744,175386,9.40632273570461,3.43878676820198,78
-7.6926,53.28823,2021/03/16 00:00:00+00,Tue 16 Mar 2021,8980,3834,2,488632,179128,94,488726,179222,9.58243247509082,3.51399907729633,79
-7.6926,53.28823,2021/03/17 00:00:00+00,Wed 17 Mar 2021,4915,2430,8,493547,181558,102,493649,181660,9.67895755269028,3.56180085247153,80
-7.6926,53.28823,2021/03/18 00:00:00+00,Thu 18 Mar 2021,11757,4693,8,505304,186251,110,505414,186361,9.90963346939912,3.65397318434133,81
-7.6926,53.28823,2021/03/19 00:00:00+00,Fri 19 Mar 2021,10400,6144,2,515704,192395,112,515816,192507,10.1135850958849,3.77447757737937,82
-7.6926,53.28823,2021/03/20 00:00:00+00,Sat 20 Mar 2021,5266,3131,4,520970,195526,116,521086,195642,10.2169137895573,3.83594540558865,83
-7.6926,53.28823,2021/03/21 00:00:00+00,Sun 21 Mar 2021,3661,59,3,524631,195585,119,524750,195704,10.2887537010593,3.83716103727891,84
-7.6926,53.28823,2021/03/22 00:00:00+00,Mon 22 Mar 2021,7436,2422,1,532067,198007,120,532187,198127,10.4345706830027,3.88466870801291,85
-7.6926,53.28823,2021/03/23 00:00:00+00,Tue 23 Mar 2021,12584,7412,6,544651,205419,126,544777,205545,10.6814223439771,4.0301131576641,86
-7.6926,53.28823,2021/03/24 00:00:00+00,Wed 24 Mar 2021,13652,9790,2,558303,215209,128,558431,215337,10.9491358133135,4.22210453687472,87
-7.6926,53.28823,2021/03/25 00:00:00+00,Thu 25 Mar 2021,20901,10236,3,579204,225445,131,579335,225576,11.3589997625597,4.42286022843288,88
-7.6926,53.28823,2021/03/26 00:00:00+00,Fri 26 Mar 2021,19722,9517,1,598926,234962,132,599058,235094,11.7457078888026,4.60947929985105,89
-7.6926,53.28823,2021/03/27 00:00:00+00,Sat 27 Mar 2021,11777,5365,3,610703,240327,135,610838,240462,11.9766779099527,4.71472947587255,90
-7.6926,53.28823,2021/03/28 00:00:00+00,Sun 28 Mar 2021,2505,490,0,613208,240817,135,613343,240952,12.0257933516319,4.72433688761818,91
-7.6926,53.28823,2021/03/28 23:00:00+00,Mon 29 Mar 2021,9298,3132,3,622506,243949,138,622644,244087,12.2081577121341,4.78580471582747,92
-7.6926,53.28823,2021/03/29 23:00:00+00,Tue 30 Mar 2021,13356,8685,4,635862,252634,142,636004,252776,12.4701067344231,4.95616961512905,93
-7.6926,53.28823,2021/03/30 23:00:00+00,Wed 31 Mar 2021,15860,10519,4,651722,263153,146,651868,263299,12.7811515914285,5.16249368410713,94
-7.6926,53.28823,2021/03/31 23:00:00+00,Thu 01 Apr 2021,19737,11596,9,671459,274749,155,671614,274904,13.1683106778147,5.39003248677657,95
-7.6926,53.28823,2021/04/01 23:00:00+00,Fri 02 Apr 2021,20167,13731,9,691626,288480,164,691790,288644,13.5639007581816,5.65943215490912,96
-7.6926,53.28823,2021/04/02 23:00:00+00,Sat 03 Apr 2021,7564,4644,7,699190,293124,171,699361,293295,13.712345073133,5.75062413864162,97
-7.6926,53.28823,2021/04/03 23:00:00+00,Sun 04 Apr 2021,3051,175,3,702241,293299,174,702415,293473,13.7722247373598,5.75411417801044,98
-7.6926,53.28823,2021/04/04 23:00:00+00,Mon 05 Apr 2021,3456,618,6,705697,293917,180,705877,294097,13.8401040423871,5.76634892276406,99
-7.6926,53.28823,2021/04/05 23:00:00+00,Tue 06 Apr 2021,12020,8162,14,717717,302079,194,717911,302273,14.0760542320747,5.92665545017685,100
-7.6926,53.28823,2021/04/06 23:00:00+00,Wed 07 Apr 2021,18389,10500,12,736106,312579,206,736312,312785,14.4368419535672,6.13276384256472,101
-7.6926,53.28823,2021/10/26 23:00:00+00,Wed 27 Oct 2021,1569,1442,6,3618100,3555327,240976,3859076,3796303,75.6647593666873,74.4339714942211,102
-7.6926,53.28823,2021/10/27 23:00:00+00,Thu 28 Oct 2021,2162,1715,5,3620262,3557042,240981,3861243,3798023,75.7072476549582,74.4676954701446,103
-7.6926,53.28823,2021/10/28 23:00:00+00,Fri 29 Oct 2021,2148,1390,3,3622410,3558432,240984,3863394,3799416,75.7494222318253,74.49500796925,104
-7.6926,53.28823,2021/10/29 23:00:00+00,Sat 30 Oct 2021,2021,1465,1,3624431,3559897,240985,3865416,3800882,75.7890675104981,74.5237517766359,105
-7.6926,53.28823,2021/10/30 23:00:00+00,Sun 31 Oct 2021,1601,1321,0,3626032,3561218,240985,3867017,3802203,75.8204582578547,74.5496525744236,106
-7.6926,53.28823,2021/11/01 00:00:00+00,Mon 01 Nov 2021,297,307,2,3626329,3561525,240987,3867316,3802512,75.8263207397158,74.5557111259122,107
-7.6926,53.28823,2021/11/02 00:00:00+00,Tue 02 Nov 2021,1100,1101,10,3627429,3562626,240997,3868426,3803623,75.8480844683641,74.5774944615232,108
-7.6926,53.28823,2021/11/03 00:00:00+00,Wed 03 Nov 2021,2540,1889,7,3629969,3564515,241004,3870973,3805519,75.8980234024786,74.61466926289,109
-7.6926,53.28823,2021/11/04 00:00:00+00,Thu 04 Nov 2021,1539,1298,2,3631508,3565813,241006,3872514,3806819,75.9282377320705,74.64015831446,110
-7.6926,53.28823,2021/11/05 00:00:00+00,Fri 05 Nov 2021,1630,1113,4,3633138,3566926,241010,3874148,3807936,75.9602755091977,74.6620592918475,111
-7.6926,53.28823,2021/11/06 00:00:00+00,Sat 06 Nov 2021,1825,1366,6,3634963,3568292,241016,3875979,3809308,75.996175857986,74.6889600447352,112
-7.6926,53.28823,2021/11/07 00:00:00+00,Sun 07 Nov 2021,698,775,0,3635661,3569067,241016,3876677,3810083,76.0098615179828,74.7041554408635,113
-7.6926,53.28823,2021/11/08 00:00:00+00,Mon 08 Nov 2021,521,541,4,3636182,3569608,241020,3877202,3810628,76.0201551734246,74.7148412355602,114
-7.6926,53.28823,2021/11/09 00:00:00+00,Tue 09 Nov 2021,1375,1077,4,3637557,3570685,241024,3878581,3811709,76.0471931750515,74.7360363622888,115
-7.6926,53.28823,2021/11/10 00:00:00+00,Wed 10 Nov 2021,1604,1371,2,3639161,3572056,241026,3880187,3813082,76.0786819572219,74.7629567221393,116
-7.6926,53.28823,2021/11/11 00:00:00+00,Thu 11 Nov 2021,1396,1129,2,3640557,3573185,241028,3881585,3814213,76.1060924911411,74.7851321970053,117
-7.6926,53.28823,2021/11/12 00:00:00+00,Fri 12 Nov 2021,1145,1162,6,3641702,3574347,241034,3882736,3815381,76.1286601052619,74.8080331294928,118
-7.6926,53.28823,2021/11/13 00:00:00+00,Sat 13 Nov 2021,1397,1386,0,3643099,3575733,241034,3884133,3816767,76.1560510322184,74.835208379859,119
-7.6926,53.28823,2021/11/14 00:00:00+00,Sun 14 Nov 2021,1648,1808,1,3644747,3577541,241035,3885782,3818576,76.1883829137868,74.8706773754669,120
-7.6926,53.28823,2021/11/15 00:00:00+00,Mon 15 Nov 2021,1244,601,1,3645991,3578142,241036,3887027,3819178,76.2127935824058,74.8824807670401,121
-7.6926,53.28823,2021/11/16 00:00:00+00,Tue 16 Nov 2021,1320,1086,5,3647311,3579228,241041,3888352,3820269,76.2387728080445,74.9038719633962,122
-7.6926,53.28823,2021/11/17 00:00:00+00,Wed 17 Nov 2021,1504,1130,3,3648815,3580358,241044,3889859,3821402,76.268320500903,74.9260866521876,123
-7.6926,53.28823,2021/11/18 00:00:00+00,Thu 18 Nov 2021,1642,2521,5,3650457,3582879,241049,3891506,3823928,76.300613168546,74.9756138400844,124
-7.6926,53.28823,2021/11/19 00:00:00+00,Fri 19 Nov 2021,1166,1568,0,3651623,3584447,241049,3892672,3825496,76.323474887108,75.0063575576704,125
-7.6926,53.28823,2021/11/20 00:00:00+00,Sat 20 Nov 2021,1548,2954,12,3653171,3587401,241061,3894232,3828462,76.3540617489921,75.0645118091756,126
-7.6926,53.28823,2021/11/21 00:00:00+00,Sun 21 Nov 2021,1790,2772,0,3654961,3590173,241061,3896022,3831234,76.3891582123077,75.118862309908,127
-7.6926,53.28823,2021/11/22 00:00:00+00,Mon 22 Nov 2021,724,522,3,3655685,3590695,241064,3896749,3831759,76.4034124742242,75.1291559653498,128
-7.6926,53.28823,2021/11/23 00:00:00+00,Tue 23 Nov 2021,2160,1605,8,3657845,3592300,241072,3898917,3833372,76.4459203694579,75.1607819962594,129
-7.6926,53.28823,2021/11/24 00:00:00+00,Wed 24 Nov 2021,1615,3155,2,3659460,3595455,241074,3900534,3836529,76.4776248282185,75.2226811776491,130
-7.6926,53.28823,2021/11/25 00:00:00+00,Thu 25 Nov 2021,982,1193,2,3660442,3596648,241076,3901518,3837724,76.4969180795607,75.2461114981308,131
-7.6926,53.28823,2021/11/26 00:00:00+00,Fri 26 Nov 2021,1279,1116,12,3661721,3597764,241088,3902809,3838852,76.5222306684661,75.2682281521085,132
-7.6926,53.28823,2021/11/27 00:00:00+00,Sat 27 Nov 2021,1200,1569,6,3662921,3599333,241094,3904015,3840427,76.545876665538,75.2991091184337,133
-7.6926,53.28823,2021/11/28 00:00:00+00,Sun 28 Nov 2021,1961,2265,1,3664882,3601598,241095,3905977,3842693,76.584345526446,75.3435384960165,134
-7.6926,53.28823,2021/11/29 00:00:00+00,Mon 29 Nov 2021,537,1005,2,3665419,3602603,241097,3906516,3843700,76.5949136793662,75.363282707502,135
-7.6926,53.28823,2021/11/30 00:00:00+00,Tue 30 Nov 2021,1899,1656,6,3667318,3604259,241103,3908421,3845362,76.6322649433976,75.3958694795861,136
-7.6926,53.28823,2021/12/01 00:00:00+00,Wed 01 Dec 2021,1076,1392,4,3668394,3605651,241107,3909501,3846758,76.6534404631635,75.4232407995798,137
-7.6926,53.28823,2021/12/02 00:00:00+00,Thu 02 Dec 2021,1738,1420,0,3670132,3607071,241107,3911239,3848178,76.6875173644164,75.4510826866794,138
-7.6926,53.28823,2021/12/03 00:00:00+00,Fri 03 Dec 2021,1017,1208,2,3671149,3608279,241109,3912258,3849388,76.7074968594547,75.4748071116022,139
-7.6926,53.28823,2021/12/04 00:00:00+00,Sat 04 Dec 2021,1206,1707,3,3672355,3609986,241112,3913467,3851098,76.7312016774149,75.5083350178982,140
-7.6926,53.28823,2021/12/05 00:00:00+00,Sun 05 Dec 2021,1349,1779,2,3673704,3611765,241114,3914818,3852879,76.757690684085,75.5432550185492,141
-7.6926,53.28823,2021/12/06 00:00:00+00,Mon 06 Dec 2021,941,1306,0,3674645,3613071,241114,3915759,3854185,76.7761408360291,75.5688617118957,142
-7.6926,53.28823,2021/12/07 00:00:00+00,Tue 07 Dec 2021,487,753,2,3675132,3613824,241116,3916248,3854940,76.785728640812,75.583664968769,143
-7.6926,53.28823,2021/12/08 00:00:00+00,Wed 08 Dec 2021,798,1528,2,3675930,3615352,241118,3917048,3856470,76.801414211009,75.6136636217707,144
-7.6926,53.28823,2021/12/09 00:00:00+00,Thu 09 Dec 2021,787,1217,1,3676717,3616569,241119,3917836,3857688,76.8168644976529,75.6375449023956,145
-7.6926,53.28823,2021/12/10 00:00:00+00,Fri 10 Dec 2021,895,1623,1,3677612,3618192,241120,3918732,3859312,76.8344323362735,75.6693866098954,146
-7.6926,53.28823,2021/12/11 00:00:00+00,Sat 11 Dec 2021,645,851,2,3678257,3619043,241122,3919379,3860165,76.8471180411703,75.6861113491179,147
-7.6926,53.28823,2021/12/12 00:00:00+00,Sun 12 Dec 2021,686,1193,0,3678943,3620236,241122,3920065,3861358,76.8605684176142,75.7095024556741,148
-7.6926,53.28823,2021/12/13 00:00:00+00,Mon 13 Dec 2021,725,1073,1,3679668,3621309,241123,3920791,3862432,76.8748030725679,75.7305603336634,149
-7.6926,53.28823,2021/12/14 00:00:00+00,Tue 14 Dec 2021,631,1206,3,3680299,3622515,241126,3921425,3863641,76.887233886949,75.7542651516236,150
-7.6926,53.28823,2021/12/15 00:00:00+00,Wed 15 Dec 2021,793,1260,1,3681092,3623775,241127,3922219,3864902,76.9028018153695,75.7789895316465,151
-7.6926,53.28823,2021/12/16 00:00:00+00,Thu 16 Dec 2021,1048,1553,8,3682140,3625328,241135,3923275,3866463,76.9235067680294,75.8095960004933,152
-7.6926,53.28823,2021/12/17 00:00:00+00,Fri 17 Dec 2021,1199,2461,2,3683339,3627789,241137,3924476,3868926,76.9470547302876,75.8578879497372,153
-7.6926,53.28823,2021/12/18 00:00:00+00,Sat 18 Dec 2021,1252,1185,0,3684591,3628974,241137,3925728,3870111,76.9716026476458,75.8811222005914,154
-7.6926,53.28823,2021/12/19 00:00:00+00,Sun 19 Dec 2021,554,894,3,3685145,3629868,241140,3926285,3871008,76.9825237258954,75.8987096461747,155
-7.6926,53.28823,2021/12/20 00:00:00+00,Mon 20 Dec 2021,516,624,1,3685661,3630492,241141,3926802,3871633,76.9926605256352,75.9109639978911,156
-7.6926,53.28823,2021/12/21 00:00:00+00,Tue 21 Dec 2021,1406,1825,3,3687067,3632317,241144,3928211,3873461,77.0202867361446,75.9468055257911,157
-7.6926,53.28823,2021/12/22 00:00:00+00,Wed 22 Dec 2021,1170,1606,2,3688237,3633923,241146,3929383,3875069,77.0432660964831,75.978333521887,158
-7.6926,53.28823,2021/12/23 00:00:00+00,Thu 23 Dec 2021,932,1406,0,3689169,3635329,241146,3930315,3876475,77.0615397857626,76.0059009115081,159
-7.6926,53.28823,2021/12/24 00:00:00+00,Fri 24 Dec 2021,101,165,0,3689270,3635494,241146,3930416,3876640,77.0635200889999,76.0091360603612,160
-7.6926,53.28823,2021/12/25 00:00:00+00,Sat 25 Dec 2021,2,7,0,3689272,3635501,241146,3930418,3876647,77.0635593029254,76.0092733091004,161
-7.6926,53.28823,2021/12/26 00:00:00+00,Sun 26 Dec 2021,12,13,0,3689284,3635514,241146,3930430,3876660,77.0637945864784,76.0095281996161,162
-7.6926,53.28823,2021/12/27 00:00:00+00,Mon 27 Dec 2021,393,591,0,3689677,3636105,241146,3930823,3877251,77.0715001228376,76.0211159145991,163
-7.6926,53.28823,2021/12/28 00:00:00+00,Tue 28 Dec 2021,469,752,0,3690146,3636857,241146,3931292,3878003,77.0806957883656,76.0358603505843,164
-7.6926,53.28823,2021/12/29 00:00:00+00,Wed 29 Dec 2021,1061,1319,0,3691207,3638176,241146,3932353,3879322,77.1014987758393,76.0617219344465,165
-7.6926,53.28823,2021/12/30 00:00:00+00,Thu 30 Dec 2021,1051,1205,1,3692258,3639381,241147,3933405,3880528,77.1221253006483,76.0853679315184,166
-7.6926,53.28823,2021/12/31 00:00:00+00,Fri 31 Dec 2021,716,1682,0,3692974,3641063,241147,3934121,3882210,77.1361638859745,76.1183468428574,167
-7.6926,53.28823,2022/01/01 00:00:00+00,Sat 01 Jan 2022,73,101,0,3693047,3641164,241147,3934194,3882311,77.137595194255,76.1203271460948,168
-7.6926,53.28823,2022/01/02 00:00:00+00,Sun 02 Jan 2022,271,629,0,3693318,3641793,241147,3934465,3882940,77.1429086811592,76.1326599256622,169
-7.6926,53.28823,2022/01/03 00:00:00+00,Mon 03 Jan 2022,3634,730,1,3696952,3642523,241148,3938100,3883671,77.2141799907416,76.1469926154296,170
-7.6926,53.28823,2022/01/04 00:00:00+00,Tue 04 Jan 2022,1190,790,1,3698142,3643313,241149,3939291,3884462,77.2375318833723,76.1625017229618,171
-7.6926,53.28823,2022/01/05 00:00:00+00,Wed 05 Jan 2022,2139,917,0,3700281,3644230,241149,3941430,3885379,77.2794711766864,76.1804813078001,172
-7.6926,53.28823,2022/01/06 00:00:00+00,Thu 06 Jan 2022,2454,1699,1,3702735,3645929,241150,3943885,3887079,77.3276062702283,76.2138131444686,173
-7.6926,53.28823,2022/01/07 00:00:00+00,Fri 07 Jan 2022,4857,785,2,3707592,3646714,241152,3948744,3887866,77.422876502212,76.2292438241499,174
-7.6926,53.28823,2022/01/08 00:00:00+00,Sat 08 Jan 2022,9789,746,2,3717381,3647460,241154,3958535,3888614,77.6148482744598,76.243909832284,175
-7.6926,53.28823,2022/01/09 00:00:00+00,Sun 09 Jan 2022,7116,667,0,3724497,3648127,241154,3965651,3889281,77.7543714213617,76.2569876764357,176
-7.6926,53.28823,2022/01/10 00:00:00+00,Mon 10 Jan 2022,6668,512,1,3731165,3648639,241155,3972320,3889794,77.885130255916,76.2670460483245,177
-7.6926,53.28823,2022/01/11 00:00:00+00,Tue 11 Jan 2022,4781,1372,1,3735946,3650011,241156,3977102,3891167,77.9788907517682,76.293966408175,178
-7.6926,53.28823,2022/01/12 00:00:00+00,Wed 12 Jan 2022,7560,928,1,3743506,3650939,241157,3984663,3892096,78.1271389970921,76.3121812765662,179
-7.6926,53.28823,2022/01/13 00:00:00+00,Thu 13 Jan 2022,7323,819,0,3750829,3651758,241157,3991986,3892915,78.2707207852824,76.3282393790553,180
-7.6926,53.28823,2022/01/14 00:00:00+00,Fri 14 Jan 2022,10725,839,0,3761554,3652597,241157,4002711,3893754,78.4810054607352,76.3446896207994,181
-7.6926,53.28823,2022/01/15 00:00:00+00,Sat 15 Jan 2022,8363,654,2,3769917,3653251,241159,4011076,3894410,78.645017704107,76.3575517883609,182
-7.6926,53.28823,2022/01/16 00:00:00+00,Sun 16 Jan 2022,6965,1216,1,3776882,3654467,241160,4018042,3895627,78.7815998065969,76.381413462023,183
-7.6926,53.28823,2022/01/17 00:00:00+00,Mon 17 Jan 2022,2565,564,0,3779447,3655031,241160,4020607,3896191,78.8318916660409,76.3924717890118,184
-7.6926,53.28823,2022/01/18 00:00:00+00,Tue 18 Jan 2022,4056,456,3,3783503,3655487,241163,4024666,3896650,78.9114763278276,76.4014713849123,185
-7.6926,53.28823,2022/01/19 00:00:00+00,Wed 19 Jan 2022,3487,626,0,3786990,3656113,241163,4028153,3897276,78.9798458069236,76.4137453435914,186
-7.6926,53.28823,2022/01/20 00:00:00+00,Thu 20 Jan 2022,3699,940,1,3790689,3657053,241164,4031853,3898217,79.0523915690844,76.4321954955356,187
-7.6926,53.28823,2022/01/21 00:00:00+00,Fri 21 Jan 2022,3253,977,0,3793942,3658030,241164,4035106,3899194,79.1161730188978,76.4513514981386,188
-7.6926,53.28823,2022/01/22 00:00:00+00,Sat 22 Jan 2022,4274,645,0,3798216,3658675,241164,4039380,3899839,79.199973177675,76.4639979891099,189
-7.6926,53.28823,2022/01/23 00:00:00+00,Sun 23 Jan 2022,3094,680,0,3801310,3659355,241164,4042474,3900519,79.2606371204116,76.4773307237773,190
-7.6926,53.28823,2022/01/24 00:00:00+00,Mon 24 Jan 2022,646,469,0,3801956,3659824,241164,4043120,3900988,79.2733032183457,76.4865263893053,191
-7.6926,53.28823,2022/12/05 00:00:00+00,Mon 05 Dec 2022,12,5,0,3864180,3818225,241220,4105400,4059445,80.4944248581779,79.5933868851771,192
-7.6926,53.28823,2022/01/25 00:00:00+00,Tue 25 Jan 2022,692,1838,1,3802648,3661662,241165,4043813,3902827,79.2868908435288,76.5225835937955,193
-7.6926,53.28823,2022/01/26 00:00:00+00,Wed 26 Jan 2022,700,899,0,3803348,3662561,241165,4044513,3903726,79.3006157174511,76.5402102533043,194
-7.6926,53.28823,2021/04/07 23:00:00+00,Thu 08 Apr 2021,20208,10585,18,756314,323164,224,756538,323388,14.8334123820715,6.34065646856249,195
-7.6926,53.28823,2022/01/27 00:00:00+00,Thu 27 Jan 2022,1278,1179,0,3804626,3663740,241165,4045791,3904905,79.3256734158407,76.5633268623821,196
-7.6926,53.28823,2022/01/28 00:00:00+00,Fri 28 Jan 2022,1031,3096,1,3805657,3666836,241166,4046823,3908002,79.3459078013948,76.624049626007,197
-7.6926,53.28823,2022/01/29 00:00:00+00,Sat 29 Jan 2022,2330,3446,0,3807987,3670282,241166,4049153,3911448,79.3915920245934,76.6916152196303,198
-7.6926,53.28823,2022/01/30 00:00:00+00,Sun 30 Jan 2022,1639,7538,0,3809626,3677820,241166,4050792,3918986,79.4237278365344,76.8394125048111,199
-7.6926,53.28823,2022/01/31 00:00:00+00,Mon 31 Jan 2022,483,1397,0,3810109,3679217,241166,4051275,3920383,79.4331979995408,76.8668034317675,200
-7.6926,53.28823,2022/02/01 00:00:00+00,Tue 01 Feb 2022,752,3423,1,3810861,3682640,241167,4052028,3923807,79.4479620424887,76.9339376722104,201
-7.6926,53.28823,2022/08/25 23:00:00+00,Fri 26 Aug 2022,99,90,0,3860288,3814469,241212,4101500,4055681,80.4179577034678,79.5195862774005,202
-7.6926,53.28823,2022/02/02 00:00:00+00,Wed 02 Feb 2022,652,3000,0,3811513,3685640,241167,4052680,3926807,79.4607457821992,76.9927585604489,203
-7.6926,53.28823,2022/02/05 00:00:00+00,Sat 05 Feb 2022,1777,5751,0,3815371,3700351,241168,4056539,3941519,79.5364090514367,77.2812161963708,204
-7.6926,53.28823,2022/02/03 00:00:00+00,Thu 03 Feb 2022,908,2436,1,3812421,3688076,241168,4053589,3929244,79.4785685113355,77.0405407286614,205
-7.6926,53.28823,2021/07/17 23:00:00+00,Sun 18 Jul 2021,16879,15843,1934,2861124,2364134,168557,3029681,2532691,59.4028424998172,49.6583780845919,206
-7.6926,53.28823,2022/02/04 00:00:00+00,Fri 04 Feb 2022,1173,6524,0,3813594,3694600,241168,4054762,3935768,79.5015674786367,77.1684565536175,207
-7.6926,53.28823,2021/04/08 23:00:00+00,Fri 09 Apr 2021,20690,9174,16,777004,332338,240,777244,332578,15.2393941526939,6.52084445619991,208
-7.6926,53.28823,2022/08/26 23:00:00+00,Sat 27 Aug 2022,86,119,0,3860374,3814588,241212,4101586,4055800,80.419643902264,79.5219195059673,209
-7.6926,53.28823,2022/02/06 00:00:00+00,Sun 06 Feb 2022,1407,7556,0,3816778,3707907,241168,4057946,3949075,79.5639960480206,77.4293664068809,210
-7.6926,53.28823,2021/07/18 23:00:00+00,Mon 19 Jul 2021,24928,18475,6254,2886052,2382609,174811,3060863,2557420,60.0142268121686,50.1432386663422,211
-7.6926,53.28823,2021/04/09 23:00:00+00,Sat 10 Apr 2021,11195,4191,12,788199,336529,252,788451,336781,15.4591293841904,6.60325252062211,212
-7.6926,53.28823,2022/08/27 23:00:00+00,Sun 28 Aug 2022,44,21,0,3860418,3814609,241212,4101630,4055821,80.4205066086248,79.522331252185,213
-7.6926,53.28823,2022/02/07 00:00:00+00,Mon 07 Feb 2022,443,1353,0,3817221,3709260,241168,4058389,3950428,79.5726819325172,77.4558946274765,214
-7.6926,53.28823,2022/12/06 00:00:00+00,Tue 06 Dec 2022,25,30,0,3864205,3818255,241220,4105425,4059475,80.4949150322466,79.5939750940595,215
-7.6926,53.28823,2021/07/19 23:00:00+00,Tue 20 Jul 2021,30617,18213,7700,2916669,2400822,182511,3099180,2583333,60.7655068037141,50.6513138919841,216
-7.6926,53.28823,2021/04/10 23:00:00+00,Sun 11 Apr 2021,2878,371,9,791077,336900,261,791338,337161,15.5157346856386,6.61070316646566,217
-7.6926,53.28823,2022/08/28 23:00:00+00,Mon 29 Aug 2022,13,12,0,3860431,3814621,241212,4101643,4055833,80.4207614991405,79.5225665357379,218
-7.6926,53.28823,2022/02/08 00:00:00+00,Tue 08 Feb 2022,900,1239,0,3818121,3710499,241168,4059289,3951667,79.5903281989887,77.4801876543191,219
-7.6926,53.28823,2022/12/07 00:00:00+00,Wed 07 Dec 2022,19,23,0,3864224,3818278,241220,4105444,4059498,80.4952875645388,79.5944260542027,220
-7.6926,53.28823,2021/07/20 23:00:00+00,Wed 21 Jul 2021,30387,19868,6895,2947056,2420690,189406,3136462,2610096,61.4964935888173,51.1760550359602,221
-7.6926,53.28823,2021/04/11 23:00:00+00,Mon 12 Apr 2021,7798,2811,14,798875,339711,275,799150,339986,15.6689042786118,6.66609283622363,222
-7.6926,53.28823,2022/08/29 23:00:00+00,Tue 30 Aug 2022,42,44,1,3860473,3814665,241213,4101686,4055878,80.4216045985386,79.5234488490615,223
-7.6926,53.28823,2022/02/09 00:00:00+00,Wed 09 Feb 2022,1335,1785,0,3819456,3712284,241168,4060624,3953452,79.6165034942549,77.515186082821,224
-7.6926,53.28823,2022/12/08 00:00:00+00,Thu 08 Dec 2022,12,13,1,3864236,3818291,241221,4105457,4059512,80.4955424550545,79.5947005516811,225
-7.6926,53.28823,2021/07/21 23:00:00+00,Thu 22 Jul 2021,33564,15957,6938,2980620,2436647,196344,3176964,2632991,62.2906147939632,51.624956448034,226
-7.6926,53.28823,2021/04/12 23:00:00+00,Tue 13 Apr 2021,11536,8600,1,810411,348311,276,810687,348587,15.8951098078145,6.83473232280355,227
-7.6926,53.28823,2022/08/30 23:00:00+00,Wed 31 Aug 2022,28,29,0,3860501,3814694,241213,4101714,4055907,80.4221535934955,79.5240174509811,228
-7.6926,53.28823,2022/02/10 00:00:00+00,Thu 10 Feb 2022,687,2555,1,3820143,3714839,241169,4061312,3956008,79.6299930846242,77.5653014796002,229
-7.6926,53.28823,2022/12/09 00:00:00+00,Fri 09 Dec 2022,13,17,0,3864249,3818308,241221,4105470,4059529,80.4957973455702,79.5950338700478,230
-7.6926,53.28823,2021/07/22 23:00:00+00,Fri 23 Jul 2021,27109,20875,5616,3007729,2457522,201960,3209689,2659482,62.932252649832,52.1443644981431,231
-7.6926,53.28823,2021/04/13 23:00:00+00,Wed 14 Apr 2021,20362,6604,2,830773,354915,278,831051,355193,16.2943859971778,6.96425591870483,232
-7.6926,53.28823,2022/08/31 23:00:00+00,Thu 01 Sep 2022,36,31,0,3860537,3814725,241213,4101750,4055938,80.4228594441544,79.5246252668262,233
-7.6926,53.28823,2022/02/11 00:00:00+00,Fri 11 Feb 2022,546,4927,0,3820689,3719766,241169,4061858,3960935,79.6406984862837,77.6619049850507,234
-7.6926,53.28823,2022/12/10 00:00:00+00,Sat 10 Dec 2022,45,44,0,3864294,3818352,241221,4105515,4059573,80.4966796588937,79.5958965764086,235
-7.6926,53.28823,2021/07/23 23:00:00+00,Sat 24 Jul 2021,15459,14834,2277,3023188,2472356,204237,3227425,2676593,63.2800017410983,52.479859237693,236
-7.6926,53.28823,2021/04/14 23:00:00+00,Thu 15 Apr 2021,27125,10826,1,857898,365741,279,858177,366020,16.8262444686307,7.17654050435775,237
-7.6926,53.28823,2022/09/01 23:00:00+00,Fri 02 Sep 2022,48,51,0,3860585,3814776,241213,4101798,4055989,80.4238005783662,79.5256252219263,238
-7.6926,53.28823,2022/02/12 00:00:00+00,Sat 12 Feb 2022,1397,5463,0,3822086,3725229,241169,4063255,3966398,79.6680894132401,77.7690178225331,239
-7.6926,53.28823,2022/12/11 00:00:00+00,Sun 11 Dec 2022,28,42,0,3864322,3818394,241221,4105543,4059615,80.4972286538506,79.596720068844,240
-7.6926,53.28823,2021/07/24 23:00:00+00,Sun 25 Jul 2021,14748,13663,1046,3037936,2486019,205283,3243219,2691302,63.5896741107115,52.7682580527267,241
-7.6926,53.28823,2021/07/25 23:00:00+00,Mon 26 Jul 2021,23871,18343,3422,3061807,2504362,208705,3270512,2713067,64.1248069449431,53.1950035968973,242
-7.6926,53.28823,2022/05/16 23:00:00+00,Tue 17 May 2022,97,101,0,3852226,3801631,241196,4093422,4042827,80.2595726584042,79.267558378261,243
-7.6926,53.28823,2021/07/26 23:00:00+00,Tue 27 Jul 2021,25540,23942,3672,3087347,2528304,212377,3299724,2740681,64.6975655406845,53.7364302661704,244
-7.6926,53.28823,2021/07/27 23:00:00+00,Wed 28 Jul 2021,23458,25327,3265,3110805,2553631,215642,3326447,2769273,65.2215224061508,54.2970325450093,245
-7.6926,53.28823,2021/07/28 23:00:00+00,Thu 29 Jul 2021,19307,27901,2966,3130112,2581532,218608,3348720,2800140,65.6582282873965,54.9022406640957,246
-7.6926,53.28823,2021/07/29 23:00:00+00,Fri 30 Jul 2021,21979,22979,2125,3152091,2604511,220733,3372824,2825244,66.1308345174305,55.3944538568758,247
-7.6926,53.28823,2021/07/30 23:00:00+00,Sat 31 Jul 2021,13769,12516,907,3165860,2617027,221640,3387500,2838667,66.4185863026935,55.6576381178178,248
-7.6926,53.28823,2021/07/31 23:00:00+00,Sun 01 Aug 2021,11167,9370,369,3177027,2626397,222009,3399036,2848406,66.6447722249334,55.8485903280029,249
-7.6926,53.28823,2021/08/01 23:00:00+00,Mon 02 Aug 2021,15047,16076,431,3192074,2642473,222440,3414514,2864913,66.9482487943188,56.1722424620542,250
-7.6926,53.28823,2021/08/02 23:00:00+00,Tue 03 Aug 2021,17366,25471,1111,3209440,2667944,223551,3432991,2891495,67.3105266449801,56.6934347457732,251
-7.6926,53.28823,2021/08/03 23:00:00+00,Wed 04 Aug 2021,22148,17346,1576,3231588,2685290,225127,3456715,2910417,67.7756822291705,57.0644376948565,252
-7.6926,53.28823,2021/08/04 23:00:00+00,Thu 05 Aug 2021,13562,30084,1421,3245150,2715374,226548,3471698,2941922,68.0694533519965,57.6821550561749,253
-7.6926,53.28823,2021/08/05 23:00:00+00,Fri 06 Aug 2021,12242,24780,949,3257392,2740154,227497,3484889,2967651,68.3280887975814,58.1866226006715,254
-7.6926,53.28823,2021/08/06 23:00:00+00,Sat 07 Aug 2021,6352,8493,585,3263744,2748647,228082,3491826,2976729,68.4641022981517,58.3646146084813,255
-7.6926,53.28823,2021/08/07 23:00:00+00,Sun 08 Aug 2021,8636,12007,153,3272380,2760654,228235,3500615,2988889,68.6364278937279,58.6030352754749,256
-7.6926,53.28823,2021/08/08 23:00:00+00,Mon 09 Aug 2021,5573,23061,601,3277953,2783715,228836,3506789,3012551,68.7574812817228,59.0669752279751,257
-7.6926,53.28823,2021/08/09 23:00:00+00,Tue 10 Aug 2021,9387,26046,718,3287340,2809761,229554,3516894,3039315,68.955609640273,59.5917359789139,258
-7.6926,53.28823,2021/08/10 23:00:00+00,Wed 11 Aug 2021,7046,31260,668,3294386,2841021,230222,3524608,3071243,69.1068577508971,60.217747085474,259
-7.6926,53.28823,2021/08/11 23:00:00+00,Thu 12 Aug 2021,6799,38324,865,3301185,2879345,231087,3532272,3110432,69.2571255133838,60.9861243485342,260
-7.6926,53.28823,2021/08/12 23:00:00+00,Fri 13 Aug 2021,10957,28253,875,3312142,2907598,231962,3544104,3139560,69.4891150965966,61.557235959405,261
-7.6926,53.28823,2021/08/13 23:00:00+00,Sat 14 Aug 2021,18156,5866,281,3330298,2913464,232243,3562541,3145707,69.850608668748,61.6777599594057,262
-7.6926,53.28823,2021/08/14 23:00:00+00,Sun 15 Aug 2021,17007,3745,53,3347305,2917209,232296,3579601,3149505,70.1851034531979,61.7522272039157,263
-7.6926,53.28823,2021/08/15 23:00:00+00,Mon 16 Aug 2021,10208,23185,386,3357513,2940394,232682,3590195,3173076,70.3928196165309,62.214382922806,264
-7.6926,53.28823,2021/08/16 23:00:00+00,Tue 17 Aug 2021,12886,26890,532,3370399,2967284,233214,3603613,3200498,70.6559058426592,62.7520450552318,265
-7.6926,53.28823,2021/08/17 23:00:00+00,Wed 18 Aug 2021,15253,25803,658,3385652,2993087,233872,3619524,3226959,70.9678722269137,63.2708648964586,266
-7.6926,53.28823,2021/08/18 23:00:00+00,Thu 19 Aug 2021,11383,25747,545,3397035,3018834,234417,3631452,3253251,71.2017440785502,63.7863711609812,267
-7.6926,53.28823,2021/08/19 23:00:00+00,Fri 20 Aug 2021,14873,22298,686,3411908,3041132,235103,3647011,3276235,71.506808811918,64.2370175927395,268
-7.6926,53.28823,2021/08/20 23:00:00+00,Sat 21 Aug 2021,11920,8005,246,3423828,3049137,235349,3659177,3284486,71.7453471206881,64.3987946423582,269
-7.6926,53.28823,2021/08/21 23:00:00+00,Sun 22 Aug 2021,8011,12268,162,3431839,3061405,235511,3667350,3296916,71.9055948272127,64.6425091892933,270
-7.6926,53.28823,2021/08/22 23:00:00+00,Mon 23 Aug 2021,10892,15425,294,3442731,3076830,235805,3678536,3312635,72.1249183124915,64.9507110367005,271
-7.6926,53.28823,2021/08/23 23:00:00+00,Tue 24 Aug 2021,9726,22945,384,3452457,3099775,236189,3688646,3335964,72.3231447058554,65.4081218706062,272
-7.6926,53.28823,2021/08/24 23:00:00+00,Wed 25 Aug 2021,9426,19561,318,3461883,3119336,236507,3698390,3355843,72.5141949508542,65.7978886830376,273
-7.6926,53.28823,2021/08/25 23:00:00+00,Thu 26 Aug 2021,8605,19470,370,3470488,3138806,236877,3707365,3375683,72.6901674415011,66.1868908239218,274
-7.6926,53.28823,2021/08/26 23:00:00+00,Fri 27 Aug 2021,9739,19251,432,3480227,3158057,237309,3717536,3395366,72.8895898595926,66.5728146716549,275
-7.6926,53.28823,2021/08/27 23:00:00+00,Sat 28 Aug 2021,9939,7952,155,3490166,3166009,237464,3727630,3403473,73.0875025415526,66.7317683186382,276
-7.6926,53.28823,2021/08/28 23:00:00+00,Sun 29 Aug 2021,8808,9207,30,3498974,3175216,237494,3736468,3412710,73.2607888783033,66.9128778335247,277
-7.6926,53.28823,2021/08/29 23:00:00+00,Mon 30 Aug 2021,5077,11181,85,3504051,3186397,237579,3741630,3423976,73.3620000199991,67.1337698758232,278
-7.6926,53.28823,2021/08/30 23:00:00+00,Tue 31 Aug 2021,4087,12924,146,3508138,3199321,237725,3745863,3437046,73.4449962933037,67.3900328789158,279
-7.6926,53.28823,2021/08/31 23:00:00+00,Wed 01 Sep 2021,5008,12580,184,3513146,3211901,237909,3751055,3449810,73.5467956438819,67.6402961514081,280
-7.6926,53.28823,2021/09/01 23:00:00+00,Thu 02 Sep 2021,5016,12396,249,3518162,3224297,238158,3756320,3462455,73.6500263027405,67.8882261953336,281
-7.6926,53.28823,2021/09/02 23:00:00+00,Fri 03 Sep 2021,4789,16126,167,3522951,3240423,238325,3761276,3478748,73.7471984101106,68.2076824393571,282
-7.6926,53.28823,2021/09/03 23:00:00+00,Sat 04 Sep 2021,4635,10601,136,3527586,3251024,238461,3766047,3489485,73.8407432293726,68.4182023983629,283
-7.6926,53.28823,2021/09/04 23:00:00+00,Sun 05 Sep 2021,5310,11914,1,3532896,3262938,238462,3771358,3501400,73.9448758085176,68.6518193594837,284
-7.6926,53.28823,2021/09/05 23:00:00+00,Mon 06 Sep 2021,2174,9715,76,3535070,3272653,238538,3773608,3511191,73.9889914746965,68.8437911317315,285
-7.6926,53.28823,2021/09/06 23:00:00+00,Tue 07 Sep 2021,3043,10052,162,3538113,3282705,238700,3776813,3521405,74.051831790298,69.044056649221,286
-7.6926,53.28823,2021/09/07 23:00:00+00,Wed 08 Sep 2021,2617,14829,191,3540730,3297534,238891,3779621,3536425,74.1068881416893,69.3385532296687,287
-7.6926,53.28823,2021/09/08 23:00:00+00,Thu 09 Sep 2021,3133,14846,138,3543863,3312380,239029,3782892,3551409,74.1710225168321,69.6323439594575,288
-7.6926,53.28823,2021/09/09 23:00:00+00,Fri 10 Sep 2021,3398,13964,116,3547261,3326344,239145,3786406,3565489,74.2399213839222,69.9084099949238,289
-7.6926,53.28823,2021/09/10 23:00:00+00,Sat 11 Sep 2021,2567,11355,62,3549828,3337699,239207,3789035,3576906,74.2914680889819,70.1322626885969,290
-7.6926,53.28823,2021/09/11 23:00:00+00,Sun 12 Sep 2021,2045,12889,1,3551873,3350588,239208,3791081,3589796,74.3315839347606,70.3849964383952,291
-7.6926,53.28823,2021/09/12 23:00:00+00,Mon 13 Sep 2021,1628,7765,52,3553501,3358353,239260,3792761,3597613,74.3645236321742,70.5382640661821,292
-7.6926,53.28823,2021/09/13 23:00:00+00,Tue 14 Sep 2021,1560,10808,82,3555061,3369161,239342,3794403,3608503,74.3967182650034,70.7517838904881,293
-7.6926,53.28823,2021/09/14 23:00:00+00,Wed 15 Sep 2021,3294,12395,138,3558355,3381556,239480,3797835,3621036,74.4640093611483,70.997517954586,294
-7.6926,53.28823,2021/09/15 23:00:00+00,Thu 16 Sep 2021,1922,10591,116,3560277,3392147,239596,3799873,3631743,74.503968351225,71.2074497047093,295
-7.6926,53.28823,2021/09/16 23:00:00+00,Fri 17 Sep 2021,2568,14634,96,3562845,3406781,239692,3802537,3646473,74.5562012999808,71.4962602659606,296
-7.6926,53.28823,2021/09/17 23:00:00+00,Sat 18 Sep 2021,2292,11248,48,3565137,3418029,239740,3804877,3657769,74.6020815928069,71.7177405171415,297
-7.6926,53.28823,2021/09/18 23:00:00+00,Sun 19 Sep 2021,1866,8500,16,3567003,3426529,239756,3806759,3666285,74.6389818966952,71.884713411888,298
-7.6926,53.28823,2021/09/19 23:00:00+00,Mon 20 Sep 2021,969,5651,35,3567972,3432180,239791,3807763,3671971,74.6586672872924,71.9961986020628,299
-7.6926,53.28823,2021/09/20 23:00:00+00,Tue 21 Sep 2021,1480,6695,90,3569452,3438875,239881,3809333,3678756,74.6894502188039,72.1292318442956,300
-7.6926,53.28823,2021/09/21 23:00:00+00,Wed 22 Sep 2021,1904,8175,97,3571356,3447050,239978,3811334,3687028,74.728683751259,72.291420640132,301
-7.6926,53.28823,2021/09/22 23:00:00+00,Thu 23 Sep 2021,1693,8745,89,3573049,3455795,240067,3813116,3695862,74.7636233588727,72.4646285490318,302
-7.6926,53.28823,2021/09/23 23:00:00+00,Fri 24 Sep 2021,1917,7412,81,3574966,3463207,240148,3815114,3703355,74.8027980704396,72.611543520889,303
-7.6926,53.28823,2021/09/24 23:00:00+00,Sat 25 Sep 2021,2426,6624,53,3577392,3469831,240201,3817593,3710032,74.8514037310874,72.7424592111452,304
-7.6926,53.28823,2021/09/25 23:00:00+00,Sun 26 Sep 2021,1550,7104,0,3578942,3476935,240201,3819143,3717136,74.8817945233439,72.8817470744941,305
-7.6926,53.28823,2021/09/26 23:00:00+00,Mon 27 Sep 2021,1181,3848,45,3580123,3480783,240246,3820369,3721029,74.9058326596708,72.958076980465,306
-7.6926,53.28823,2021/09/27 23:00:00+00,Tue 28 Sep 2021,1459,5164,94,3581582,3485947,240340,3821922,3726287,74.9362822728156,73.0611703905844,307
-7.6926,53.28823,2021/09/28 23:00:00+00,Wed 29 Sep 2021,1656,3644,80,3583238,3489591,240420,3823658,3730011,74.970319960143,73.1341867198512,308
-7.6926,53.28823,2021/09/29 23:00:00+00,Thu 30 Sep 2021,1279,4006,79,3584517,3493597,240499,3825016,3734096,74.9969462155523,73.2142811626694,309
-7.6926,53.28823,2021/09/30 23:00:00+00,Fri 01 Oct 2021,1875,5216,42,3586392,3498813,240541,3826933,3739354,75.0345327631367,73.3173745727888,310
-7.6926,53.28823,2021/10/01 23:00:00+00,Sat 02 Oct 2021,1684,4114,41,3588076,3502927,240582,3828658,3743509,75.0683547738739,73.3988415029992,311
-7.6926,53.28823,2021/10/02 23:00:00+00,Sun 03 Oct 2021,1197,3027,9,3589273,3505954,240591,3829864,3746545,75.0920007709458,73.4583682418966,312
-7.6926,53.28823,2021/10/03 23:00:00+00,Mon 04 Oct 2021,352,1248,18,3589625,3507202,240609,3830234,3747811,75.0992553471619,73.4831906567333,313
-7.6926,53.28823,2021/10/04 23:00:00+00,Tue 05 Oct 2021,961,2847,70,3590586,3510049,240679,3831265,3750728,75.1194701257532,73.5403841670639,314
-7.6926,53.28823,2021/10/05 23:00:00+00,Wed 06 Oct 2021,974,2587,40,3591560,3512636,240719,3832279,3753355,75.1393515859778,73.5918916581981,315
-7.6926,53.28823,2021/10/06 23:00:00+00,Thu 07 Oct 2021,1214,2726,44,3592774,3515362,240763,3833537,3756125,75.1640171451125,73.646202945005,316
-7.6926,53.28823,2021/10/07 23:00:00+00,Fri 08 Oct 2021,916,2767,48,3593690,3518129,240811,3834501,3758940,75.1829182571998,73.7013965451355,317
-7.6926,53.28823,2021/10/08 23:00:00+00,Sat 09 Oct 2021,725,2374,23,3594415,3520503,240834,3835249,3761337,75.197584265334,73.7483944348381,318
-7.6926,53.28823,2021/10/09 23:00:00+00,Sun 10 Oct 2021,1521,3931,3,3595936,3524434,240837,3836773,3765271,75.2274652765591,73.8255282262816,319
-7.6926,53.28823,2021/10/10 23:00:00+00,Mon 11 Oct 2021,335,1152,20,3596271,3525586,240857,3837128,3766443,75.234425748334,73.8485075866201,320
-7.6926,53.28823,2021/10/11 23:00:00+00,Tue 12 Oct 2021,563,1634,21,3596834,3527220,240878,3837712,3768098,75.2458762145778,73.8809571099651,321
-7.6926,53.28823,2021/10/12 23:00:00+00,Wed 13 Oct 2021,991,2093,11,3597825,3529313,240889,3838714,3770202,75.2655223912495,73.922210159583,322
-7.6926,53.28823,2021/10/13 23:00:00+00,Thu 14 Oct 2021,656,1625,9,3598481,3530938,240898,3839379,3771836,75.2785610214757,73.9542479367103,323
-7.6926,53.28823,2021/10/14 23:00:00+00,Fri 15 Oct 2021,958,2095,10,3599439,3533033,240908,3840347,3773941,75.297540561414,73.995520593291,324
-7.6926,53.28823,2021/10/15 23:00:00+00,Sat 16 Oct 2021,1384,2668,14,3600823,3535701,240922,3841745,3776623,75.3249510953332,74.0481064673763,325
-7.6926,53.28823,2021/10/16 23:00:00+00,Sun 17 Oct 2021,1709,2894,3,3602532,3538595,240925,3843457,3779520,75.3585182155546,74.104907838452,326
-7.6926,53.28823,2021/10/17 23:00:00+00,Mon 18 Oct 2021,681,1269,6,3603213,3539864,240931,3844144,3780795,75.3719881989613,74.1299067159533,327
-7.6926,53.28823,2021/10/18 23:00:00+00,Tue 19 Oct 2021,1343,1821,13,3604556,3541685,240944,3845500,3782629,75.3985752404451,74.1658658856298,328
-7.6926,53.28823,2021/10/19 23:00:00+00,Wed 20 Oct 2021,2264,2355,1,3606820,3544040,240945,3847765,3784985,75.4429850110652,74.2120598898598,329
-7.6926,53.28823,2021/10/20 23:00:00+00,Thu 21 Oct 2021,1732,1869,11,3608552,3545909,240956,3849508,3786865,75.4771599471318,74.2489209798227,330
-7.6926,53.28823,2021/10/21 23:00:00+00,Fri 22 Oct 2021,1510,1947,3,3610062,3547856,240959,3851021,3788815,75.5068252817668,74.2871545571777,331
-7.6926,53.28823,2021/10/22 23:00:00+00,Sat 23 Oct 2021,2019,1716,1,3612081,3549572,240960,3853041,3790532,75.5464313465141,74.3208197122129,332
-7.6926,53.28823,2021/10/23 23:00:00+00,Sun 24 Oct 2021,1960,2194,2,3614041,3551766,240962,3855003,3792728,75.5849002074221,74.3638766024035,333
-7.6926,53.28823,2021/10/24 23:00:00+00,Mon 25 Oct 2021,1243,871,2,3615284,3552637,240964,3856248,3793601,75.6093108760411,74.3809934808809,334
-7.6926,53.28823,2021/10/25 23:00:00+00,Tue 26 Oct 2021,1247,1248,6,3616531,3553885,240970,3857501,3794855,75.633878400362,74.4055806121647,335
-7.6926,53.28823,2022/09/02 23:00:00+00,Sat 03 Sep 2022,73,101,0,3860658,3814877,241213,4101871,4056090,80.4252318866467,79.5276055251637,336
-7.6926,53.28823,2022/05/17 23:00:00+00,Wed 18 May 2022,99,123,0,3852325,3801754,241196,4093521,4042950,80.261513747716,79.2699700346788,337
-7.6926,53.28823,2022/02/13 00:00:00+00,Sun 13 Feb 2022,1566,4706,0,3823652,3729935,241169,4064821,3971104,79.6987939169006,77.8612881892166,338
-7.6926,53.28823,2022/09/03 23:00:00+00,Sun 04 Sep 2022,58,82,0,3860716,3814959,241213,4101929,4056172,80.4263690904859,79.5292132961089,339
-7.6926,53.28823,2022/05/18 23:00:00+00,Thu 19 May 2022,73,107,0,3852398,3801861,241196,4093594,4043057,80.2629450559965,79.2720679796927,340
-7.6926,53.28823,2021/04/15 23:00:00+00,Fri 16 Apr 2021,27982,9853,1,885880,375594,280,886160,375874,17.3749061071571,7.36974751525863,341
-7.6926,53.28823,2022/02/14 00:00:00+00,Mon 14 Feb 2022,175,954,0,3823827,3730889,241169,4064996,3972058,79.7022251353812,77.8799932316765,342
-7.6926,53.28823,2022/12/12 00:00:00+00,Mon 12 Dec 2022,4,2,0,3864326,3818396,241221,4105547,4059617,80.4973070817016,79.5967592827695,343
-7.6926,53.28823,2022/09/04 23:00:00+00,Mon 05 Sep 2022,10,5,0,3860726,3814964,241213,4101939,4056177,80.4265651601134,79.5293113309226,344
-7.6926,53.28823,2022/05/19 23:00:00+00,Fri 20 May 2022,128,210,0,3852526,3802071,241196,4093722,4043267,80.265454747228,79.2761854418694,345
-7.6926,53.28823,2021/04/16 23:00:00+00,Sat 17 Apr 2021,15864,4569,3,901744,380163,283,902027,380446,17.6860097850508,7.45939054893418,346
-7.6926,53.28823,2022/02/15 00:00:00+00,Tue 15 Feb 2022,650,817,1,3824477,3731706,241170,4065647,3972876,79.7149892681289,77.8960317272028,347
-7.6926,53.28823,2022/12/13 00:00:00+00,Tue 13 Dec 2022,19,15,0,3864345,3818411,241221,4105566,4059632,80.4976796139938,79.5970533872107,348
-7.6926,53.28823,2022/09/05 23:00:00+00,Tue 06 Sep 2022,42,22,0,3860768,3814986,241213,4101981,4056199,80.4273886525487,79.529742684103,349
-7.6926,53.28823,2022/05/20 23:00:00+00,Sat 21 May 2022,392,762,0,3852918,3802833,241196,4094114,4044029,80.2731406766245,79.291125947482,350
-7.6926,53.28823,2021/04/17 23:00:00+00,Sun 18 Apr 2021,1082,490,0,902826,380653,283,903109,380936,17.7072245187422,7.4689979606798,351
-7.6926,53.28823,2022/02/16 00:00:00+00,Wed 16 Feb 2022,799,1787,0,3825276,3733493,241170,4066446,3974663,79.7306552313631,77.9310693696303,352
-7.6926,53.28823,2022/12/14 00:00:00+00,Wed 14 Dec 2022,14,20,0,3864359,3818431,241221,4105580,4059652,80.4979541114723,79.5974455264656,353
-7.6926,53.28823,2022/09/06 23:00:00+00,Wed 07 Sep 2022,48,42,0,3860816,3815028,241213,4102029,4056241,80.4283297867606,79.5305661765384,354
-7.6926,53.28823,2022/05/21 23:00:00+00,Sun 22 May 2022,234,410,0,3853152,3803243,241196,4094348,4044439,80.2777287059071,79.2991648022079,355
-7.6926,53.28823,2021/04/18 23:00:00+00,Mon 19 Apr 2021,6774,2271,0,909600,382924,283,909883,383207,17.8400420843848,7.51352537307639,356
-7.6926,53.28823,2022/02/17 00:00:00+00,Thu 17 Feb 2022,791,1194,2,3826067,3734687,241172,4067239,3975859,79.7462035528209,77.9545192970747,357
-7.6926,53.28823,2022/12/15 00:00:00+00,Thu 15 Dec 2022,13,9,0,3864372,3818440,241221,4105593,4059661,80.498209001988,79.5976219891303,358
-7.6926,53.28823,2022/09/07 23:00:00+00,Thu 08 Sep 2022,39,52,2,3860855,3815080,241215,4102070,4056295,80.4291336722331,79.5316249525266,359
-7.6926,53.28823,2022/05/22 23:00:00+00,Mon 23 May 2022,26,35,0,3853178,3803278,241196,4094374,4044474,80.2782384869385,79.299851045904,360
-7.6926,53.28823,2021/04/19 23:00:00+00,Tue 20 Apr 2021,15107,7336,1,924707,390260,284,924991,390544,18.1362640775542,7.65738165874513,361
-7.6926,53.28823,2022/02/18 00:00:00+00,Fri 18 Feb 2022,792,3296,0,3826859,3737983,241172,4068031,3979155,79.7617322673158,78.0191438462861,362
-7.6926,53.28823,2022/12/16 00:00:00+00,Fri 16 Dec 2022,11,4,0,3864383,3818444,241221,4105604,4059665,80.4984246785782,79.5977004169813,363
-7.6926,53.28823,2022/09/08 23:00:00+00,Fri 09 Sep 2022,64,60,0,3860919,3815140,241215,4102134,4056355,80.4303885178489,79.5328013702914,364
-7.6926,53.28823,2022/05/23 23:00:00+00,Tue 24 May 2022,65,83,0,3853243,3803361,241196,4094439,4044557,80.279512939517,79.301478423812,365
-7.6926,53.28823,2021/04/20 23:00:00+00,Wed 21 Apr 2021,26753,9908,4,951460,400168,288,951748,400456,18.6608875797538,7.85172587348529,366
-7.6926,53.28823,2022/02/19 00:00:00+00,Sat 19 Feb 2022,980,3557,0,3827839,3741540,241172,4069011,3982712,79.7809470908071,78.0888858127743,367
-7.6926,53.28823,2022/12/17 00:00:00+00,Sat 17 Dec 2022,19,43,0,3864402,3818487,241221,4105623,4059708,80.4987972108703,79.5985435163794,368
-7.6926,53.28823,2022/09/09 23:00:00+00,Sat 10 Sep 2022,94,135,0,3861013,3815275,241215,4102228,4056490,80.432231572347,79.5354483102621,369
-7.6926,53.28823,2022/05/24 23:00:00+00,Wed 25 May 2022,87,133,1,3853330,3803494,241197,4094527,4044691,80.2812383522387,79.3041057568199,370
-7.6926,53.28823,2021/04/21 23:00:00+00,Thu 22 Apr 2021,31648,12200,1,983108,412368,289,983397,412657,19.2814283437077,8.09095042595146,371
-7.6926,53.28823,2022/02/20 00:00:00+00,Sun 20 Feb 2022,1365,3588,0,3829204,3745128,241172,4070376,3986300,79.8077105949556,78.1592355951076,372
-7.6926,53.28823,2022/12/18 00:00:00+00,Sun 18 Dec 2022,29,35,0,3864431,3818522,241221,4105652,4059743,80.49936581279,79.5992297600755,373
-7.6926,53.28823,2022/09/10 23:00:00+00,Sun 11 Sep 2022,58,58,0,3861071,3815333,241215,4102286,4056548,80.4333687761863,79.5365855141014,374
-7.6926,53.28823,2022/05/25 23:00:00+00,Thu 26 May 2022,99,155,0,3853429,3803649,241197,4094626,4044846,80.2831794415506,79.3071448360456,375
-7.6926,53.28823,2021/04/22 23:00:00+00,Fri 23 Apr 2021,33626,12368,3,1016734,424736,292,1017026,425028,19.9407908938991,8.33350816208449,376
-7.6926,53.28823,2022/02/21 00:00:00+00,Mon 21 Feb 2022,255,997,1,3829459,3746125,241173,4070632,3987298,79.8127299774187,78.1788033439283,377
-7.6926,53.28823,2022/12/19 00:00:00+00,Mon 19 Dec 2022,4,1,0,3864435,3818523,241221,4105656,4059744,80.499444240641,79.5992493670382,378
-7.6926,53.28823,2022/09/11 23:00:00+00,Mon 12 Sep 2022,13,13,0,3861084,3815346,241215,4102299,4056561,80.433623666702,79.5368404046171,379
-7.6926,53.28823,2022/05/26 23:00:00+00,Fri 27 May 2022,95,152,1,3853524,3803801,241198,4094722,4044999,80.2850617099742,79.3101447013458,380
-7.6926,53.28823,2021/04/23 23:00:00+00,Sat 24 Apr 2021,23714,7018,2,1040448,431754,294,1040742,432048,20.4057896223875,8.47114904056269,381
-7.6926,53.28823,2022/02/22 00:00:00+00,Tue 22 Feb 2022,477,988,1,3829936,3747113,241174,4071110,3988287,79.8221021056113,78.1981946300843,382
-7.6926,53.28823,2022/12/20 00:00:00+00,Tue 20 Dec 2022,17,18,0,3864452,3818541,241221,4105673,4059762,80.4997775590076,79.5996022923676,383
-7.6926,53.28823,2022/09/12 23:00:00+00,Tue 13 Sep 2022,29,25,0,3861113,3815371,241215,4102328,4056586,80.4341922686217,79.5373305786858,384
-7.6926,53.28823,2022/05/27 23:00:00+00,Sat 28 May 2022,335,580,0,3853859,3804381,241198,4095057,4045579,80.2916300424942,79.3215167397386,385
-7.6926,53.28823,2021/04/24 23:00:00+00,Sun 25 Apr 2021,9760,312,3,1050208,432066,297,1050505,432363,20.5972123996785,8.47732523382774,386
-7.6926,53.28823,2022/02/23 00:00:00+00,Wed 23 Feb 2022,829,1273,1,3830765,3748386,241175,4071940,3989561,79.8383758846907,78.2231739006229,387
-7.6926,53.28823,2022/02/24 00:00:00+00,Thu 24 Feb 2022,653,1237,0,3831418,3749623,241175,4072593,3990798,79.8511792313639,78.2474277135399,388
-7.6926,53.28823,2022/02/25 00:00:00+00,Fri 25 Feb 2022,693,1228,0,3832111,3750851,241175,4073286,3992026,79.864766856547,78.2715050637922,389
-7.6926,53.28823,2022/02/26 00:00:00+00,Sat 26 Feb 2022,960,2094,0,3833071,3752945,241175,4074246,3994120,79.8835895407834,78.3125620437827,390
-7.6926,53.28823,2022/02/27 00:00:00+00,Sun 27 Feb 2022,671,1783,0,3833742,3754728,241175,4074917,3995903,79.8967458127861,78.3475212583592,391
-7.6926,53.28823,2022/02/28 00:00:00+00,Mon 28 Feb 2022,81,437,0,3833823,3755165,241175,4074998,3996340,79.8983339767685,78.3560895010793,392
-7.6926,53.28823,2022/03/01 00:00:00+00,Tue 01 Mar 2022,135,938,0,3833958,3756103,241175,4075133,3997278,79.9009809167392,78.3744808321352,393
-7.6926,53.28823,2022/03/02 00:00:00+00,Wed 02 Mar 2022,207,997,2,3834165,3757100,241177,4075342,3998277,79.9050787719532,78.3940681879186,394
-7.6926,53.28823,2022/03/03 00:00:00+00,Thu 03 Mar 2022,279,1278,0,3834444,3758378,241177,4075621,3999555,79.9105491145594,78.4191258863082,395
-7.6926,53.28823,2022/03/04 00:00:00+00,Fri 04 Mar 2022,735,1509,1,3835179,3759887,241178,4076357,4001065,79.9249798391405,78.448732400055,396
-7.6926,53.28823,2022/03/05 00:00:00+00,Sat 05 Mar 2022,963,3343,0,3836142,3763230,241178,4077320,4004408,79.9438613442651,78.5142784765155,397
-7.6926,53.28823,2022/03/06 00:00:00+00,Sun 06 Mar 2022,455,1916,0,3836597,3765146,241178,4077775,4006324,79.9527825123146,78.5518454171372,398
-7.6926,53.28823,2022/03/07 00:00:00+00,Mon 07 Mar 2022,117,125,1,3836714,3765271,241179,4077893,4006450,79.9550961339187,78.5543158944432,399
-7.6926,53.28823,2022/03/08 00:00:00+00,Tue 08 Mar 2022,120,493,0,3836834,3765764,241179,4078013,4006943,79.9574489694482,78.563982127077,400
-7.6926,53.28823,2022/03/09 00:00:00+00,Wed 09 Mar 2022,130,344,1,3836964,3766108,241180,4078144,4007288,79.960017481568,78.5707465292245,401
-7.6926,53.28823,2022/03/10 00:00:00+00,Thu 10 Mar 2022,259,508,0,3837223,3766616,241180,4078403,4007796,79.9650956849192,78.5807068662995,402
-7.6926,53.28823,2022/03/11 00:00:00+00,Fri 11 Mar 2022,493,2184,0,3837716,3768800,241180,4078896,4009980,79.9747619175531,78.6235284729372,403
-7.6926,53.28823,2022/03/12 00:00:00+00,Sat 12 Mar 2022,473,2393,2,3838189,3771193,241182,4079371,4012375,79.9840752248575,78.6704871487143,404
-7.6926,53.28823,2022/03/13 00:00:00+00,Sun 13 Mar 2022,359,1082,0,3838548,3772275,241182,4079730,4013457,79.9911141244834,78.6917018824057,405
-7.6926,53.28823,2022/03/14 00:00:00+00,Mon 14 Mar 2022,109,123,0,3838657,3772398,241182,4079839,4013580,79.9932512834228,78.6941135388234,406
-7.6926,53.28823,2022/03/15 00:00:00+00,Tue 15 Mar 2022,222,755,1,3838879,3773153,241183,4080062,4014336,79.9976236361152,78.7089364026596,407
-7.6926,53.28823,2022/03/16 00:00:00+00,Wed 16 Mar 2022,195,799,0,3839074,3773952,241183,4080257,4015135,80.0014469938507,78.7246023658938,408
-7.6926,53.28823,2022/03/17 00:00:00+00,Thu 17 Mar 2022,1,4,0,3839075,3773956,241183,4080258,4015139,80.0014666008134,78.7246807937448,409
-7.6926,53.28823,2022/03/18 00:00:00+00,Fri 18 Mar 2022,4,7,0,3839079,3773963,241183,4080262,4015146,80.0015450286644,78.724818042484,410
-7.6926,53.28823,2022/03/19 00:00:00+00,Sat 19 Mar 2022,743,2779,0,3839822,3776742,241183,4081005,4017925,80.0161130019848,78.7793057919556,411
-7.6926,53.28823,2022/03/20 00:00:00+00,Sun 20 Mar 2022,395,1402,0,3840217,3778144,241183,4081400,4019327,80.0238577522695,78.8067947537258,412
-7.6926,53.28823,2022/03/21 00:00:00+00,Mon 21 Mar 2022,57,112,0,3840274,3778256,241183,4081457,4019439,80.0249753491461,78.8089907335533,413
-7.6926,53.28823,2022/03/22 00:00:00+00,Tue 22 Mar 2022,141,575,0,3840415,3778831,241183,4081598,4020014,80.0277399308933,78.8202647371324,414
-7.6926,53.28823,2022/03/23 00:00:00+00,Wed 23 Mar 2022,102,221,0,3840517,3779052,241183,4081700,4020235,80.0297398410934,78.8245978758993,415
-7.6926,53.28823,2022/03/24 00:00:00+00,Thu 24 Mar 2022,147,245,0,3840664,3779297,241183,4081847,4020480,80.0326220646171,78.8294015817721,416
-7.6926,53.28823,2022/03/25 00:00:00+00,Fri 25 Mar 2022,434,1625,0,3841098,3780922,241183,4082281,4022105,80.0411314864489,78.8612628962347,417
-7.6926,53.28823,2022/03/26 00:00:00+00,Sat 26 Mar 2022,874,1848,1,3841972,3782770,241184,4083156,4023954,80.0582875788518,78.8975161703524,418
-7.6926,53.28823,2022/03/27 00:00:00+00,Sun 27 Mar 2022,380,804,0,3842352,3783574,241184,4083536,4024758,80.0657382246954,78.9132801684003,419
-7.6926,53.28823,2022/03/27 23:00:00+00,Mon 28 Mar 2022,44,53,1,3842396,3783627,241185,4083581,4024812,80.066620538019,78.9143389443886,420
-7.6926,53.28823,2022/03/28 23:00:00+00,Tue 29 Mar 2022,138,193,3,3842534,3783820,241188,4083722,4025008,80.0693851197662,78.9181819090868,421
-7.6926,53.28823,2022/03/29 23:00:00+00,Wed 30 Mar 2022,109,138,0,3842643,3783958,241188,4083831,4025146,80.0715222787055,78.9208876699458,422
-7.6926,53.28823,2022/03/30 23:00:00+00,Thu 31 Mar 2022,227,361,0,3842870,3784319,241188,4084058,4025507,80.0759730592489,78.9279657834972,423
-7.6926,53.28823,2022/03/31 23:00:00+00,Fri 01 Apr 2022,311,906,0,3843181,3785225,241188,4084369,4026413,80.082070824663,78.9457296917452,424
-7.6926,53.28823,2022/04/01 23:00:00+00,Sat 02 Apr 2022,729,1538,1,3843910,3786763,241189,4085099,4027952,80.0963839074677,78.9759048074116,425
-7.6926,53.28823,2022/04/02 23:00:00+00,Sun 03 Apr 2022,538,817,0,3844448,3787580,241189,4085637,4028769,80.1069324534251,78.9919236959752,426
-7.6926,53.28823,2022/04/03 23:00:00+00,Mon 04 Apr 2022,50,53,0,3844498,3787633,241189,4085687,4028822,80.1079128015624,78.9929628650008,427
-7.6926,53.28823,2022/04/04 23:00:00+00,Tue 05 Apr 2022,132,170,0,3844630,3787803,241189,4085819,4028992,80.1105009206449,78.9962960486676,428
-7.6926,53.28823,2022/04/05 23:00:00+00,Wed 06 Apr 2022,158,211,0,3844788,3788014,241189,4085977,4029203,80.1135988207588,79.0004331178071,429
-7.6926,53.28823,2022/04/06 23:00:00+00,Thu 07 Apr 2022,117,181,0,3844905,3788195,241189,4086094,4029384,80.1158928354001,79.0039819780641,430
-7.6926,53.28823,2022/04/07 23:00:00+00,Fri 08 Apr 2022,256,422,2,3845161,3788617,241191,4086352,4029808,80.1209514317887,79.0122953302685,431
-7.6926,53.28823,2022/04/08 23:00:00+00,Sat 09 Apr 2022,559,1019,0,3845720,3789636,241191,4086911,4030827,80.1319117239638,79.0322748253069,432
-7.6926,53.28823,2022/04/09 23:00:00+00,Sun 10 Apr 2022,413,720,0,3846133,3790356,241191,4087324,4031547,80.1400093995779,79.0463918384841,433
-7.6926,53.28823,2022/04/10 23:00:00+00,Mon 11 Apr 2022,70,93,1,3846203,3790449,241192,4087395,4031641,80.1414014939329,79.0482348929823,434
-7.6926,53.28823,2022/04/11 23:00:00+00,Tue 12 Apr 2022,196,178,0,3846399,3790627,241192,4087591,4031819,80.1452444586312,79.0517249323511,435
-7.6926,53.28823,2022/04/12 23:00:00+00,Wed 13 Apr 2022,142,235,0,3846541,3790862,241192,4087733,4032054,80.1480286473411,79.0563325685964,436
-7.6926,53.28823,2022/04/13 23:00:00+00,Thu 14 Apr 2022,359,431,0,3846900,3791293,241192,4088092,4032485,80.155067546967,79.06478316954,437
-7.6926,53.28823,2022/04/14 23:00:00+00,Fri 15 Apr 2022,446,990,0,3847346,3792283,241192,4088538,4033475,80.1638122523518,79.0841940626588,438
-7.6926,53.28823,2022/04/15 23:00:00+00,Sat 16 Apr 2022,43,88,0,3847389,3792371,241192,4088581,4033563,80.1646553517499,79.0859194753804,439
-7.6926,53.28823,2022/04/16 23:00:00+00,Sun 17 Apr 2022,1,1,0,3847390,3792372,241192,4088582,4033564,80.1646749587126,79.0859390823432,440
-7.6926,53.28823,2022/04/17 23:00:00+00,Mon 18 Apr 2022,36,62,1,3847426,3792434,241193,4088619,4033627,80.1654004163342,79.0871743209962,441
-7.6926,53.28823,2022/04/18 23:00:00+00,Tue 19 Apr 2022,218,271,1,3847644,3792705,241194,4088838,4033899,80.1696943411757,79.0925074148631,442
-7.6926,53.28823,2022/04/19 23:00:00+00,Wed 20 Apr 2022,252,607,0,3847896,3793312,241194,4089090,4034506,80.1746352957877,79.1044088412501,443
-7.6926,53.28823,2022/04/20 23:00:00+00,Thu 21 Apr 2022,170,236,0,3848066,3793548,241194,4089260,4034742,80.1779684794545,79.1090360844582,444
-7.6926,53.28823,2022/04/21 23:00:00+00,Fri 22 Apr 2022,195,254,0,3848261,3793802,241194,4089455,4034996,80.18179183719,79.1140162529957,445
-7.6926,53.28823,2022/04/22 23:00:00+00,Sat 23 Apr 2022,323,1010,0,3848584,3794812,241194,4089778,4036006,80.1881248861571,79.1338192853693,446
-7.6926,53.28823,2022/04/23 23:00:00+00,Sun 24 Apr 2022,181,252,0,3848765,3795064,241194,4089959,4036258,80.1916737464141,79.1387602399814,447
-7.6926,53.28823,2022/04/24 23:00:00+00,Mon 25 Apr 2022,41,60,1,3848806,3795124,241195,4090001,4036319,80.1924972388495,79.1399562647089,448
-7.6926,53.28823,2022/04/25 23:00:00+00,Tue 26 Apr 2022,144,238,0,3848950,3795362,241195,4090145,4036557,80.1953206414849,79.1446227218425,449
-7.6926,53.28823,2022/04/26 23:00:00+00,Wed 27 Apr 2022,123,207,0,3849073,3795569,241195,4090268,4036764,80.1977322979027,79.1486813631309,450
-7.6926,53.28823,2022/04/27 23:00:00+00,Thu 28 Apr 2022,100,130,0,3849173,3795699,241195,4090368,4036894,80.1996929941773,79.1512302682879,451
-7.6926,53.28823,2022/04/28 23:00:00+00,Fri 29 Apr 2022,169,222,0,3849342,3795921,241195,4090537,4037116,80.2030065708814,79.1555830140176,452
-7.6926,53.28823,2022/04/29 23:00:00+00,Sat 30 Apr 2022,281,724,0,3849623,3796645,241195,4090818,4037840,80.2085161274131,79.1697784550458,453
-7.6926,53.28823,2022/04/30 23:00:00+00,Sun 01 May 2022,191,749,0,3849814,3797394,241195,4091009,4038589,80.2122610572976,79.1844640701427,454
-7.6926,53.28823,2022/05/01 23:00:00+00,Mon 02 May 2022,12,26,0,3849826,3797420,241195,4091021,4038615,80.2124963408506,79.1849738511741,455
-7.6926,53.28823,2022/05/02 23:00:00+00,Tue 03 May 2022,96,117,0,3849922,3797537,241195,4091117,4038732,80.2143786092742,79.1872678658154,456
-7.6926,53.28823,2022/05/03 23:00:00+00,Wed 04 May 2022,113,129,0,3850035,3797666,241195,4091230,4038861,80.2165941960645,79.1897971640097,457
-7.6926,53.28823,2022/05/04 23:00:00+00,Thu 05 May 2022,112,166,0,3850147,3797832,241195,4091342,4039027,80.2187901758921,79.1930519198256,458
-7.6926,53.28823,2022/05/05 23:00:00+00,Fri 06 May 2022,138,257,0,3850285,3798089,241195,4091480,4039284,80.2214959367511,79.1980909092513,459
-7.6926,53.28823,2022/05/06 23:00:00+00,Sat 07 May 2022,441,1088,0,3850726,3799177,241195,4091921,4040372,80.2301426073221,79.2194232847192,460
-7.6926,53.28823,2022/05/07 23:00:00+00,Sun 08 May 2022,274,437,0,3851000,3799614,241195,4092195,4040809,80.2355149151146,79.2279915274393,461
-7.6926,53.28823,2022/05/08 23:00:00+00,Mon 09 May 2022,24,32,0,3851024,3799646,241195,4092219,4040841,80.2359854822205,79.2286189502471,462
-7.6926,53.28823,2022/05/09 23:00:00+00,Tue 10 May 2022,81,99,1,3851105,3799745,241196,4092301,4040941,80.2375932531657,79.2305796465218,463
-7.6926,53.28823,2022/05/10 23:00:00+00,Wed 11 May 2022,112,132,0,3851217,3799877,241196,4092413,4041073,80.2397892329933,79.2331677656043,464
-7.6926,53.28823,2022/05/11 23:00:00+00,Thu 12 May 2022,207,398,0,3851424,3800275,241196,4092620,4041471,80.2438478742817,79.2409713367772,465
-7.6926,53.28823,2022/05/12 23:00:00+00,Fri 13 May 2022,173,327,0,3851597,3800602,241196,4092793,4041798,80.2472398788368,79.2473828135952,466
-7.6926,53.28823,2022/05/13 23:00:00+00,Sat 14 May 2022,333,633,0,3851930,3801235,241196,4093126,4042431,80.2537689974313,79.2597940210136,467
-7.6926,53.28823,2022/05/14 23:00:00+00,Sun 15 May 2022,168,254,0,3852098,3801489,241196,4093294,4042685,80.2570629671727,79.2647741895511,468
-7.6926,53.28823,2022/05/15 23:00:00+00,Mon 16 May 2022,31,41,0,3852129,3801530,241196,4093325,4042726,80.2576707830178,79.2655780750237,469
-7.6926,53.28823,2022/12/21 00:00:00+00,Wed 21 Dec 2022,16,28,0,3864468,3818569,241221,4105689,4059790,80.5000912704116,79.6001512873246,470
-7.6926,53.28823,2022/09/13 23:00:00+00,Wed 14 Sep 2022,36,34,0,3861149,3815405,241215,4102364,4056620,80.4348981192805,79.5379972154192,471
-7.6926,53.28823,2022/05/28 23:00:00+00,Sun 29 May 2022,181,349,0,3854040,3804730,241198,4095238,4045928,80.2951789027512,79.328359569737,472
-7.6926,53.28823,2022/09/14 23:00:00+00,Thu 15 Sep 2022,51,36,0,3861200,3815441,241215,4102415,4056656,80.4358980743806,79.538703066078,473
-7.6926,53.28823,2022/12/22 00:00:00+00,Thu 22 Dec 2022,6,15,0,3864474,3818584,241221,4105695,4059805,80.5002089121881,79.6004453917657,474
-7.6926,53.28823,2022/12/23 00:00:00+00,Fri 23 Dec 2022,19,6,0,3864493,3818590,241221,4105714,4059811,80.5005814444802,79.6005630335422,475
-7.6926,53.28823,2021/04/25 23:00:00+00,Mon 26 Apr 2021,15608,3064,4,1065816,435130,301,1066117,435431,20.9033163020719,8.53747939553302,476
-7.6926,53.28823,2022/09/15 23:00:00+00,Fri 16 Sep 2022,38,56,0,3861238,3815497,241215,4102453,4056712,80.4366431389649,79.5398010559918,477
-7.6926,53.28823,2022/12/28 00:00:00+00,Wed 28 Dec 2022,19,24,0,3864512,3818614,241221,4105733,4059835,80.5009539767724,79.6010336006481,478
-7.6926,53.28823,2022/05/29 23:00:00+00,Mon 30 May 2022,9,24,0,3854049,3804754,241198,4095247,4045952,80.2953553654159,79.3288301368429,479
-7.6926,53.28823,2021/04/26 23:00:00+00,Tue 27 Apr 2021,25937,7829,9,1091753,442959,310,1092063,443269,21.4120385574844,8.6911587695376,480
-7.6926,53.28823,2022/09/16 23:00:00+00,Sat 17 Sep 2022,66,149,0,3861304,3815646,241215,4102519,4056861,80.4379371985062,79.542722493441,481
-7.6926,53.28823,2022/12/29 00:00:00+00,Thu 29 Dec 2022,15,12,0,3864527,3818626,241221,4105748,4059847,80.5012480812136,79.6012688842011,482
-7.6926,53.28823,2022/05/30 23:00:00+00,Tue 31 May 2022,65,80,2,3854114,3804834,241200,4095314,4046034,80.2966690319199,79.3304379077881,483
-7.6926,53.28823,2021/04/27 23:00:00+00,Wed 28 Apr 2021,26061,8635,7,1117814,451594,317,1118131,451911,21.9231528623519,8.86060214159011,484
-7.6926,53.28823,2021/04/28 23:00:00+00,Thu 29 Apr 2021,31709,11340,7,1149523,462934,324,1149847,463258,22.5450072928098,9.08308234787105,485
-7.6926,53.28823,2021/04/29 23:00:00+00,Fri 30 Apr 2021,36119,13547,8,1185642,476481,332,1185974,476813,23.2533480359411,9.34885472789555,486
-7.6926,53.28823,2021/04/30 23:00:00+00,Sat 01 May 2021,16648,6705,21,1202290,483186,353,1202643,483539,23.5801764979572,9.48073115932637,487
-7.6926,53.28823,2021/05/01 23:00:00+00,Sun 02 May 2021,12487,915,16,1214777,484101,369,1215146,484470,23.8253223531728,9.49898524164307,488
-7.6926,53.28823,2021/05/02 23:00:00+00,Mon 03 May 2021,14287,942,21,1229064,485043,390,1229454,485433,24.1058587761452,9.51786674676764,489
-7.6926,53.28823,2021/05/03 23:00:00+00,Tue 04 May 2021,26684,6814,11,1255748,491857,401,1256149,492258,24.6292666466545,9.65168426751034,490
-7.6926,53.28823,2021/05/04 23:00:00+00,Wed 05 May 2021,32157,13476,70,1287905,505333,471,1288376,505804,25.2611402350757,9.91728018487013,491
-7.6926,53.28823,2021/05/05 23:00:00+00,Thu 06 May 2021,37318,14389,133,1325223,519722,604,1325827,520326,25.995440596883,10.2020124978702,492
-7.6926,53.28823,2021/05/06 23:00:00+00,Fri 07 May 2021,40619,15102,99,1365842,534824,703,1366545,535527,26.7937969059821,10.5000579385749,493
-7.6926,53.28823,2021/05/07 23:00:00+00,Sat 08 May 2021,25647,7073,10,1391489,541897,713,1392202,542610,27.2968527491609,10.6389340557061,494
-7.6926,53.28823,2021/05/08 23:00:00+00,Sun 09 May 2021,19688,936,5,1411177,542833,718,1411895,543551,27.6829726665214,10.6573842076503,495
-7.6926,53.28823,2021/05/09 23:00:00+00,Mon 10 May 2021,28877,4667,172,1440054,547500,890,1440944,548390,28.2525353273353,10.7522623003791,496
-7.6926,53.28823,2021/05/10 23:00:00+00,Tue 11 May 2021,33936,14828,153,1473990,562328,1043,1475033,563371,28.9209170803899,11.0459942092796,497
-7.6926,53.28823,2021/05/11 23:00:00+00,Wed 12 May 2021,31325,20940,176,1505315,583268,1219,1506534,584487,29.5385560138574,11.460014834628,498
-7.6926,53.28823,2021/05/12 23:00:00+00,Thu 13 May 2021,36025,25491,153,1541340,608759,1372,1542712,610131,30.2478967120888,11.9628157872911,499
-7.6926,53.28823,2021/05/13 23:00:00+00,Fri 14 May 2021,38251,27961,237,1579591,636720,1609,1581200,638329,31.0025294942639,12.515692922808,500
-7.6926,53.28823,2021/05/14 23:00:00+00,Sat 15 May 2021,28895,12471,22,1608486,649191,1631,1610117,650822,31.5695040359952,12.760642708396,501
-7.6926,53.28823,2021/05/15 23:00:00+00,Sun 16 May 2021,23200,1188,11,1631686,650379,1642,1633328,652021,32.0246012482969,12.7841514567287,502
-7.6926,53.28823,2021/05/16 23:00:00+00,Mon 17 May 2021,35413,3967,120,1667099,654346,1762,1668861,656108,32.721295455557,12.8642851134724,503
-7.6926,53.28823,2021/05/17 23:00:00+00,Tue 18 May 2021,39051,12519,127,1706150,666865,1889,1708039,668754,33.4894570420269,13.1122347643606,504
-7.6926,53.28823,2021/05/18 23:00:00+00,Wed 19 May 2021,37056,17621,212,1743206,684486,2101,1745307,686587,34.2201693296517,13.4618857310133,505
-7.6926,53.28823,2021/05/19 23:00:00+00,Thu 20 May 2021,39122,19647,138,1782328,704133,2239,1784567,706372,34.9899386870668,13.8498094889465,506
-7.6926,53.28823,2021/05/20 23:00:00+00,Fri 21 May 2021,25870,23270,14937,1808198,727403,17176,1825374,744579,35.7900400158503,14.5989327145899,507
-7.6926,53.28823,2021/05/21 23:00:00+00,Sat 22 May 2021,16621,10264,13524,1824819,737667,30700,1855519,768367,36.3810919078339,15.0653431443961,508
-7.6926,53.28823,2021/05/22 23:00:00+00,Sun 23 May 2021,8239,5544,10205,1833058,743211,40905,1873963,784116,36.7427227287245,15.3741332006857,509
-7.6926,53.28823,2021/05/23 23:00:00+00,Mon 24 May 2021,22580,8254,8453,1855638,751465,49358,1904996,800823,37.3511856036268,15.7017067272862,510
-7.6926,53.28823,2021/05/24 23:00:00+00,Tue 25 May 2021,30392,16533,3225,1886030,767998,52583,1938613,820581,38.0103128702652,16.0891010972252,511
-7.6926,53.28823,2021/05/25 23:00:00+00,Wed 26 May 2021,20009,25492,3055,1906039,793490,55638,1961677,849128,38.4625278590432,16.6488210627405,512
-7.6926,53.28823,2021/05/26 23:00:00+00,Thu 27 May 2021,17049,36072,550,1923088,829562,56188,1979276,885750,38.8075907964133,17.3668672524312,513
-7.6926,53.28823,2021/05/27 23:00:00+00,Fri 28 May 2021,27075,31851,1562,1950163,861413,57750,2007913,919163,39.3690753885757,18.0219946986694,514
-7.6926,53.28823,2021/05/28 23:00:00+00,Sat 29 May 2021,24517,7408,538,1974680,868821,58288,2032968,927109,39.8603278401813,18.1777916246506,515
-7.6926,53.28823,2021/05/29 23:00:00+00,Sun 30 May 2021,24278,1697,210,1998958,870518,58498,2057456,929016,40.3404631439098,18.2151821026075,516
-7.6926,53.28823,2021/05/30 23:00:00+00,Mon 31 May 2021,22626,7325,3445,2021584,877843,61943,2083527,939786,40.8516362696655,18.4263490913839,517
-7.6926,53.28823,2021/05/31 23:00:00+00,Tue 01 Jun 2021,27652,11543,3657,2049236,889386,65600,2114836,954986,41.4655106662858,18.7243749251259,518
-7.6926,53.28823,2021/06/01 23:00:00+00,Wed 02 Jun 2021,18738,20925,4010,2067974,910311,69610,2137584,979921,41.9115298548359,19.213274541202,519
-7.6926,53.28823,2021/06/02 23:00:00+00,Thu 03 Jun 2021,16731,30720,1978,2084705,941031,71588,2156293,1012619,42.2783565208543,19.8543830090767,520
-7.6926,53.28823,2021/06/03 23:00:00+00,Fri 04 Jun 2021,29034,23358,155,2113739,964389,71743,2185482,1036132,42.8506641564526,20.3154015241276,521
-7.6926,53.28823,2021/06/04 23:00:00+00,Sat 05 Jun 2021,20996,11514,37,2134735,975903,71780,2206515,1047683,43.263057403893,20.5418815508088,522
-7.6926,53.28823,2021/06/05 23:00:00+00,Sun 06 Jun 2021,19976,3927,47,2154711,979830,71827,2226538,1051657,43.6556476189599,20.6197996207621,523
-7.6926,53.28823,2021/06/06 23:00:00+00,Mon 07 Jun 2021,19862,4617,48,2174573,984447,71875,2246448,1056322,44.0460222472364,20.7112661019731,524
-7.6926,53.28823,2021/06/07 23:00:00+00,Tue 08 Jun 2021,26452,18360,48,2201025,1002807,71923,2272948,1074730,44.5656067600102,21.0721910722048,525
-7.6926,53.28823,2021/06/08 23:00:00+00,Wed 09 Jun 2021,32852,20142,178,2233877,1022949,72101,2305978,1095050,45.2132247395166,21.4706045552072,526
-7.6926,53.28823,2021/06/09 23:00:00+00,Thu 10 Jun 2021,27735,27516,273,2261612,1050465,72374,2333986,1122839,45.7623765521117,22.0154624429609,527
-7.6926,53.28823,2021/06/10 23:00:00+00,Fri 11 Jun 2021,26489,32923,44,2288101,1083388,72418,2360519,1155806,46.2826080946561,22.6618451838143,528
-7.6926,53.28823,2021/06/11 23:00:00+00,Sat 12 Jun 2021,12243,19743,105,2300344,1103131,72523,2372867,1175654,46.524714870646,23.0510041804005,529
-7.6926,53.28823,2021/06/12 23:00:00+00,Sun 13 Jun 2021,8567,18189,835,2308911,1121320,73358,2382269,1194678,46.7090595343856,23.4240070396839,530
-7.6926,53.28823,2021/06/13 23:00:00+00,Mon 14 Jun 2021,16051,31330,55,2324962,1152650,73413,2398375,1226063,47.0248492763756,24.0393715654728,531
-7.6926,53.28823,2021/06/14 23:00:00+00,Tue 15 Jun 2021,14744,41611,207,2339706,1194261,73620,2413326,1267881,47.3179929763938,24.8592955335927,532
-7.6926,53.28823,2021/06/15 23:00:00+00,Wed 16 Jun 2021,13511,48412,220,2353217,1242673,73840,2427057,1316513,47.5872161818616,25.8128213458651,533
-7.6926,53.28823,2021/06/16 23:00:00+00,Thu 17 Jun 2021,21607,42712,536,2374824,1285385,74376,2449200,1359761,48.0213731579504,26.660783270712,534
-7.6926,53.28823,2021/06/17 23:00:00+00,Fri 18 Jun 2021,12039,50049,555,2386863,1335434,74931,2461794,1410365,48.2683032467758,27.6529740135198,535
-7.6926,53.28823,2021/06/18 23:00:00+00,Sat 19 Jun 2021,6349,32829,434,2393212,1368263,75365,2468577,1443628,48.4012972750831,28.3051604153461,536
-7.6926,53.28823,2021/06/19 23:00:00+00,Sun 20 Jun 2021,8542,26158,178,2401754,1394421,75543,2477297,1469964,48.5722699902298,28.8215293862295,537
-7.6926,53.28823,2021/06/20 23:00:00+00,Mon 21 Jun 2021,15519,32365,575,2417273,1426786,76118,2493391,1502904,48.8878244486669,29.4673827390888,538
-7.6926,53.28823,2021/06/21 23:00:00+00,Tue 22 Jun 2021,15173,43578,723,2432446,1470364,76841,2509287,1547205,49.1994967284802,30.3359907957074,539
-7.6926,53.28823,2021/06/22 23:00:00+00,Wed 23 Jun 2021,20109,39418,887,2452555,1509782,77728,2530283,1587510,49.6111645182991,31.1262494291923,540
-7.6926,53.28823,2021/06/23 23:00:00+00,Thu 24 Jun 2021,19056,44288,1033,2471611,1554070,78761,2550372,1632831,50.0050487929071,32.014856587812,541
-7.6926,53.28823,2021/06/24 23:00:00+00,Fri 25 Jun 2021,15238,50144,844,2486849,1604214,79605,2566454,1683819,50.3203679677912,33.0145764043144,542
-7.6926,53.28823,2021/06/25 23:00:00+00,Sat 26 Jun 2021,9095,30599,513,2495944,1634813,80118,2576062,1714931,50.5087516658566,33.6245882292736,543
-7.6926,53.28823,2021/06/26 23:00:00+00,Sun 27 Jun 2021,8750,30497,59,2504694,1665310,80177,2584871,1745487,50.6814694006877,34.223698582946,544
-7.6926,53.28823,2021/06/27 23:00:00+00,Mon 28 Jun 2021,24260,24686,528,2528954,1689996,80705,2609659,1770701,51.1674867932401,34.7180685416282,545
-7.6926,53.28823,2021/06/28 23:00:00+00,Tue 29 Jun 2021,28168,31075,812,2557122,1721071,81517,2638639,1802588,51.7356965736244,35.3432757627158,546
-7.6926,53.28823,2021/06/29 23:00:00+00,Wed 30 Jun 2021,22615,36910,593,2579737,1757981,82110,2661847,1840091,52.1907349650378,36.0785956865858,547
-7.6926,53.28823,2021/06/30 23:00:00+00,Thu 01 Jul 2021,15079,48344,644,2594816,1806325,82754,2677570,1889079,52.4990152402961,37.0391015775958,548
-7.6926,53.28823,2021/07/01 23:00:00+00,Fri 02 Jul 2021,13718,47310,819,2608534,1853635,83573,2692107,1937208,52.7840416577373,37.9827650876069,549
-7.6926,53.28823,2021/07/02 23:00:00+00,Sat 03 Jul 2021,9337,30507,507,2617871,1884142,84080,2701951,1968222,52.9770525990108,38.590855430217,550
-7.6926,53.28823,2021/07/03 23:00:00+00,Sun 04 Jul 2021,6469,27798,233,2624340,1911940,84313,2708653,1996253,53.1084584633357,39.1404582029552,551
-7.6926,53.28823,2021/07/04 23:00:00+00,Mon 05 Jul 2021,15654,33498,5344,2639994,1945438,89657,2729651,2035095,53.52016546708,39.9020318499424,552
-7.6926,53.28823,2021/07/05 23:00:00+00,Tue 06 Jul 2021,12425,48325,5491,2652419,1993763,95148,2747567,2088911,53.8714438116406,40.957200157091,553
-7.6926,53.28823,2021/07/06 23:00:00+00,Wed 07 Jul 2021,19730,43796,5061,2672149,2037559,100209,2772358,2137768,54.3575200250812,41.9151375359812,554
-7.6926,53.28823,2021/07/07 23:00:00+00,Thu 08 Jul 2021,17814,45634,6003,2689963,2083193,106212,2796175,2189405,54.824499056807,42.9275822713059,555
-7.6926,53.28823,2021/07/08 23:00:00+00,Fri 09 Jul 2021,13543,45127,6534,2703506,2128320,112746,2816252,2241066,55.2181480478622,43.9404975737364,556
-7.6926,53.28823,2021/07/09 23:00:00+00,Sat 10 Jul 2021,8666,23902,4365,2712172,2152222,117111,2829283,2269333,55.4736463794077,44.4947275896827,557
-7.6926,53.28823,2021/07/10 23:00:00+00,Sun 11 Jul 2021,15250,16136,2153,2727422,2168358,119264,2846686,2287622,55.8148663520795,44.8533193313477,558
-7.6926,53.28823,2021/07/11 23:00:00+00,Mon 12 Jul 2021,17140,31792,6095,2744562,2200150,125359,2869921,2325509,56.270434131487,45.5961683289123,559
-7.6926,53.28823,2021/07/12 23:00:00+00,Tue 13 Jul 2021,20128,36603,8490,2764690,2236753,133849,2898539,2370602,56.8315461913573,46.4803051000259,560
-7.6926,53.28823,2021/07/13 23:00:00+00,Wed 14 Jul 2021,20813,35746,9335,2785503,2272499,143184,2928687,2415683,57.4226569042292,47.3642065875866,561
-7.6926,53.28823,2021/07/14 23:00:00+00,Thu 15 Jul 2021,23680,28875,9588,2809183,2301374,152772,2961955,2454146,58.0749413408692,48.118349195693,562
-7.6926,53.28823,2021/07/15 23:00:00+00,Fri 16 Jul 2021,23537,27458,9169,2832720,2328832,161941,2994661,2490773,58.7162066644458,48.8364934201974,563
-7.6926,53.28823,2021/07/16 23:00:00+00,Sat 17 Jul 2021,11525,19459,4682,2844245,2348291,166623,3010868,2514914,59.0339767096732,49.309825107853,564
-7.6926,53.28823,2022/09/17 23:00:00+00,Sun 18 Sep 2022,30,53,0,3861334,3815699,241215,4102549,4056914,80.4385254073886,79.5437616624665,565
-7.6926,53.28823,2022/12/30 00:00:00+00,Fri 30 Dec 2022,66,31,0,3864593,3818657,241221,4105814,4059878,80.5025421407549,79.6018767000462,566
-7.6926,53.28823,2022/12/31 00:00:00+00,Sat 31 Dec 2022,34,26,0,3864627,3818683,241221,4105848,4059904,80.5032087774882,79.6023864810776,567
-7.6926,53.28823,2022/05/31 23:00:00+00,Wed 01 Jun 2022,74,102,0,3854188,3804936,241200,4095388,4046136,80.2981199471632,79.3324378179882,568
-7.6926,53.28823,2022/09/18 23:00:00+00,Mon 19 Sep 2022,11,11,0,3861345,3815710,241215,4102560,4056925,80.4387410839788,79.5439773390567,569
-7.6926,53.28823,2023/01/01 00:00:00+00,Sun 01 Jan 2023,1,0,0,3864628,3818683,241221,4105849,4059904,80.503228384451,79.6023864810776,570
-7.6926,53.28823,2022/06/01 23:00:00+00,Thu 02 Jun 2022,92,142,0,3854280,3805078,241200,4095480,4046278,80.2999237877358,79.3352220066981,571
-7.6926,53.28823,2022/09/19 23:00:00+00,Tue 20 Sep 2022,39,37,0,3861384,3815747,241215,4102599,4056962,80.4395057555259,79.5447027966784,572
-7.6926,53.28823,2023/01/03 00:00:00+00,Tue 03 Jan 2023,8,14,0,3864636,3818697,241221,4105857,4059918,80.503385240153,79.6026609785561,573
-7.6926,53.28823,2022/06/02 23:00:00+00,Fri 03 Jun 2022,59,143,0,3854339,3805221,241200,4095539,4046421,80.3010805985378,79.3380258023708,574
-7.6926,53.28823,2022/09/20 23:00:00+00,Wed 21 Sep 2022,42,32,0,3861426,3815779,241215,4102641,4056994,80.4403292479612,79.5453302194862,575
-7.6926,53.28823,2023/01/04 00:00:00+00,Wed 04 Jan 2023,52,28,0,3864688,3818725,241221,4105909,4059946,80.5044048022157,79.603209973513,576
-7.6926,53.28823,2022/06/03 23:00:00+00,Sat 04 Jun 2022,305,607,0,3854644,3805828,241200,4095844,4047028,80.3070607221754,79.3499272287578,577
-7.6926,53.28823,2022/09/21 23:00:00+00,Thu 22 Sep 2022,59,34,0,3861485,3815813,241215,4102700,4057028,80.4414860587632,79.5459968562196,578
-7.6926,53.28823,2023/01/05 00:00:00+00,Thu 05 Jan 2023,24,16,0,3864712,3818741,241221,4105933,4059962,80.5048753693217,79.6035236849169,579
-7.6926,53.28823,2022/06/04 23:00:00+00,Sun 05 Jun 2022,143,273,0,3854787,3806101,241200,4095987,4047301,80.3098645178481,79.3552799295875,580
-7.6926,53.28823,2022/06/05 23:00:00+00,Mon 06 Jun 2022,5,7,1,3854792,3806108,241201,4095993,4047309,80.3099821596246,79.3554367852894,581
-7.6926,53.28823,2022/06/06 23:00:00+00,Tue 07 Jun 2022,29,54,0,3854821,3806162,241201,4096022,4047363,80.3105507615442,79.3564955612777,582
-7.6926,53.28823,2022/06/07 23:00:00+00,Wed 08 Jun 2022,36,76,0,3854857,3806238,241201,4096058,4047439,80.3112566122031,79.3579856904465,583
-7.6926,53.28823,2022/06/08 23:00:00+00,Thu 09 Jun 2022,74,122,0,3854931,3806360,241201,4096132,4047561,80.3127075274463,79.3603777399015,584
-7.6926,53.28823,2022/06/09 23:00:00+00,Fri 10 Jun 2022,56,108,0,3854987,3806468,241201,4096188,4047669,80.3138055173601,79.3624952918781,585
-7.6926,53.28823,2022/06/10 23:00:00+00,Sat 11 Jun 2022,190,562,0,3855177,3807030,241201,4096378,4048231,80.3175308402819,79.3735144049414,586
-7.6926,53.28823,2022/06/11 23:00:00+00,Sun 12 Jun 2022,143,288,0,3855320,3807318,241201,4096521,4048519,80.3203346359546,79.3791612102123,587
-7.6926,53.28823,2022/06/12 23:00:00+00,Mon 13 Jun 2022,17,42,0,3855337,3807360,241201,4096538,4048561,80.3206679543213,79.3799847026477,588
-7.6926,53.28823,2022/06/13 23:00:00+00,Tue 14 Jun 2022,37,55,0,3855374,3807415,241201,4096575,4048616,80.3213934119429,79.3810630855987,589
-7.6926,53.28823,2022/06/14 23:00:00+00,Wed 15 Jun 2022,66,124,0,3855440,3807539,241201,4096641,4048740,80.3226874714841,79.3834943489792,590
-7.6926,53.28823,2022/06/15 23:00:00+00,Thu 16 Jun 2022,43,84,0,3855483,3807623,241201,4096684,4048824,80.3235305708822,79.3851413338499,591
-7.6926,53.28823,2022/06/16 23:00:00+00,Fri 17 Jun 2022,59,95,0,3855542,3807718,241201,4096743,4048919,80.3246873816842,79.3870039953108,592
-7.6926,53.28823,2022/06/17 23:00:00+00,Sat 18 Jun 2022,223,488,0,3855765,3808206,241201,4096966,4049407,80.3290597343766,79.3965721931309,593
-7.6926,53.28823,2022/06/18 23:00:00+00,Sun 19 Jun 2022,79,129,0,3855844,3808335,241201,4097045,4049536,80.3306086844336,79.3991014913252,594
-7.6926,53.28823,2022/06/19 23:00:00+00,Mon 20 Jun 2022,9,28,0,3855853,3808363,241201,4097054,4049564,80.3307851470983,79.3996504862821,595
-7.6926,53.28823,2022/06/20 23:00:00+00,Tue 21 Jun 2022,74,169,2,3855927,3808532,241203,4097130,4049735,80.332275276267,79.4030032769117,596
-7.6926,53.28823,2022/06/21 23:00:00+00,Wed 22 Jun 2022,60,96,0,3855987,3808628,241203,4097190,4049831,80.3334516940318,79.4048855453353,597
-7.6926,53.28823,2022/06/22 23:00:00+00,Thu 23 Jun 2022,64,113,0,3856051,3808741,241203,4097254,4049944,80.3347065396475,79.4071011321256,598
-7.6926,53.28823,2022/06/23 23:00:00+00,Fri 24 Jun 2022,55,93,1,3856106,3808834,241204,4097310,4050038,80.3358045295613,79.4089441866238,599
-7.6926,53.28823,2022/06/24 23:00:00+00,Sat 25 Jun 2022,210,293,0,3856316,3809127,241204,4097520,4050331,80.339921991738,79.4146890267084,600
-7.6926,53.28823,2022/06/25 23:00:00+00,Sun 26 Jun 2022,174,402,0,3856490,3809529,241204,4097694,4050733,80.3433336032559,79.4225710257324,601
-7.6926,53.28823,2022/06/26 23:00:00+00,Mon 27 Jun 2022,5,35,0,3856495,3809564,241204,4097699,4050768,80.3434316380696,79.4232572694285,602
-7.6926,53.28823,2022/06/27 23:00:00+00,Tue 28 Jun 2022,49,60,0,3856544,3809624,241204,4097748,4050828,80.3443923792441,79.4244336871933,603
-7.6926,53.28823,2022/06/28 23:00:00+00,Wed 29 Jun 2022,63,81,4,3856607,3809705,241208,4097815,4050913,80.3457060457481,79.4261002790267,604
-7.6926,53.28823,2022/06/29 23:00:00+00,Thu 30 Jun 2022,48,89,0,3856655,3809794,241208,4097863,4051002,80.34664717996,79.4278452987111,605
-7.6926,53.28823,2022/06/30 23:00:00+00,Fri 01 Jul 2022,46,66,0,3856701,3809860,241208,4097909,4051068,80.3475491002463,79.4291393582523,606
-7.6926,53.28823,2022/07/01 23:00:00+00,Sat 02 Jul 2022,182,228,0,3856883,3810088,241208,4098091,4051296,80.3511175674661,79.4336097457585,607
-7.6926,53.28823,2022/07/02 23:00:00+00,Sun 03 Jul 2022,108,274,0,3856991,3810362,241208,4098199,4051570,80.3532351194427,79.4389820535509,608
-7.6926,53.28823,2022/07/03 23:00:00+00,Mon 04 Jul 2022,15,15,0,3857006,3810377,241208,4098214,4051585,80.3535292238839,79.4392761579921,609
-7.6926,53.28823,2022/07/04 23:00:00+00,Tue 05 Jul 2022,51,69,0,3857057,3810446,241208,4098265,4051654,80.3545291789839,79.4406290384216,610
-7.6926,53.28823,2022/07/05 23:00:00+00,Wed 06 Jul 2022,60,83,0,3857117,3810529,241208,4098325,4051737,80.3557055967487,79.4422564163295,611
-7.6926,53.28823,2022/07/06 23:00:00+00,Thu 07 Jul 2022,77,77,0,3857194,3810606,241208,4098402,4051814,80.3572153328801,79.443766152461,612
-7.6926,53.28823,2022/07/07 23:00:00+00,Fri 08 Jul 2022,99,91,0,3857293,3810697,241208,4098501,4051905,80.359156422192,79.4455503860709,613
-7.6926,53.28823,2022/07/08 23:00:00+00,Sat 09 Jul 2022,119,144,0,3857412,3810841,241208,4098620,4052049,80.3614896507588,79.4483737887063,614
-7.6926,53.28823,2022/07/09 23:00:00+00,Sun 10 Jul 2022,134,219,0,3857546,3811060,241208,4098754,4052268,80.3641169837668,79.4526677135478,615
-7.6926,53.28823,2022/07/10 23:00:00+00,Mon 11 Jul 2022,11,16,0,3857557,3811076,241208,4098765,4052284,80.364332660357,79.4529814249517,616
-7.6926,53.28823,2022/07/11 23:00:00+00,Tue 12 Jul 2022,44,81,0,3857601,3811157,241208,4098809,4052365,80.3651953667178,79.4545695889341,617
-7.6926,53.28823,2022/07/12 23:00:00+00,Wed 13 Jul 2022,99,74,1,3857700,3811231,241209,4098909,4052440,80.3671560629925,79.4560401111401,618
-7.6926,53.28823,2022/07/13 23:00:00+00,Thu 14 Jul 2022,73,39,0,3857773,3811270,241209,4098982,4052479,80.3685873712729,79.4568047826872,619
-7.6926,53.28823,2022/07/14 23:00:00+00,Fri 15 Jul 2022,80,118,1,3857853,3811388,241210,4099063,4052598,80.3701755352554,79.459138011254,620
-7.6926,53.28823,2022/07/15 23:00:00+00,Sat 16 Jul 2022,124,209,0,3857977,3811597,241210,4099187,4052807,80.3726067986359,79.463235866468,621
-7.6926,53.28823,2022/07/16 23:00:00+00,Sun 17 Jul 2022,119,165,0,3858096,3811762,241210,4099306,4052972,80.3749400272027,79.4664710153211,622
-7.6926,53.28823,2022/07/17 23:00:00+00,Mon 18 Jul 2022,14,18,0,3858110,3811780,241210,4099320,4052990,80.3752145246812,79.4668239406505,623
-7.6926,53.28823,2022/07/18 23:00:00+00,Tue 19 Jul 2022,30,34,0,3858140,3811814,241210,4099350,4053024,80.3758027335635,79.4674905773839,624
-7.6926,53.28823,2022/07/19 23:00:00+00,Wed 20 Jul 2022,78,66,0,3858218,3811880,241210,4099428,4053090,80.3773320766577,79.4687846369251,625
-7.6926,53.28823,2022/07/20 23:00:00+00,Thu 21 Jul 2022,52,30,0,3858270,3811910,241210,4099480,4053120,80.3783516387205,79.4693728458075,626
-7.6926,53.28823,2022/07/21 23:00:00+00,Fri 22 Jul 2022,75,70,0,3858345,3811980,241210,4099555,4053190,80.3798221609265,79.4707453331997,627
-7.6926,53.28823,2022/07/22 23:00:00+00,Sat 23 Jul 2022,100,175,0,3858445,3812155,241210,4099655,4053365,80.3817828572011,79.4741765516803,628
-7.6926,53.28823,2022/07/23 23:00:00+00,Sun 24 Jul 2022,108,230,0,3858553,3812385,241210,4099763,4053595,80.3839004091777,79.4786861531119,629
-7.6926,53.28823,2022/07/24 23:00:00+00,Mon 25 Jul 2022,14,23,0,3858567,3812408,241210,4099777,4053618,80.3841749066561,79.4791371132551,630
-7.6926,53.28823,2022/07/25 23:00:00+00,Tue 26 Jul 2022,18,16,0,3858585,3812424,241210,4099795,4053634,80.3845278319856,79.4794508246591,631
-7.6926,53.28823,2022/07/26 23:00:00+00,Wed 27 Jul 2022,61,72,1,3858646,3812496,241211,4099857,4053707,80.3857434636759,79.4808821329395,632
-7.6926,53.28823,2022/07/27 23:00:00+00,Thu 28 Jul 2022,49,73,0,3858695,3812569,241211,4099906,4053780,80.3867042048504,79.48231344122,633
-7.6926,53.28823,2022/07/28 23:00:00+00,Fri 29 Jul 2022,71,105,0,3858766,3812674,241211,4099977,4053885,80.3880962992054,79.4843721723083,634
-7.6926,53.28823,2022/07/29 23:00:00+00,Sat 30 Jul 2022,100,119,0,3858866,3812793,241211,4100077,4054004,80.39005699548,79.4867054008751,635
-7.6926,53.28823,2022/07/30 23:00:00+00,Sun 31 Jul 2022,32,57,0,3858898,3812850,241211,4100109,4054061,80.3906844182879,79.4878229977517,636
-7.6926,53.28823,2022/07/31 23:00:00+00,Mon 01 Aug 2022,10,15,0,3858908,3812865,241211,4100119,4054076,80.3908804879154,79.4881171021929,637
-7.6926,53.28823,2022/08/01 23:00:00+00,Tue 02 Aug 2022,37,30,0,3858945,3812895,241211,4100156,4054106,80.391605945537,79.4887053110753,638
-7.6926,53.28823,2022/08/02 23:00:00+00,Wed 03 Aug 2022,93,139,0,3859038,3813034,241211,4100249,4054245,80.3934293930724,79.491430678897,639
-7.6926,53.28823,2022/08/03 23:00:00+00,Thu 04 Aug 2022,46,53,0,3859084,3813087,241211,4100295,4054298,80.3943313133587,79.4924698479225,640
-7.6926,53.28823,2022/08/04 23:00:00+00,Fri 05 Aug 2022,96,91,0,3859180,3813178,241211,4100391,4054389,80.3962135817823,79.4942540815324,641
-7.6926,53.28823,2022/08/05 23:00:00+00,Sat 06 Aug 2022,74,130,0,3859254,3813308,241211,4100465,4054519,80.3976644970255,79.4968029866894,642
-7.6926,53.28823,2022/08/06 23:00:00+00,Sun 07 Aug 2022,28,80,0,3859282,3813388,241211,4100493,4054599,80.3982134919824,79.4983715437091,643
-7.6926,53.28823,2022/08/07 23:00:00+00,Mon 08 Aug 2022,11,16,0,3859293,3813404,241211,4100504,4054615,80.3984291685726,79.4986852551131,644
-7.6926,53.28823,2022/08/08 23:00:00+00,Tue 09 Aug 2022,48,41,0,3859341,3813445,241211,4100552,4054656,80.3993703027844,79.4994891405856,645
-7.6926,53.28823,2022/08/09 23:00:00+00,Wed 10 Aug 2022,55,94,1,3859396,3813539,241212,4100608,4054751,80.4004682926982,79.5013518020465,646
-7.6926,53.28823,2022/08/10 23:00:00+00,Thu 11 Aug 2022,45,42,0,3859441,3813581,241212,4100653,4054793,80.4013506060218,79.5021752944819,647
-7.6926,53.28823,2022/08/11 23:00:00+00,Fri 12 Aug 2022,69,75,0,3859510,3813656,241212,4100722,4054868,80.4027034864513,79.5036458166878,648
-7.6926,53.28823,2022/08/12 23:00:00+00,Sat 13 Aug 2022,103,151,0,3859613,3813807,241212,4100825,4055019,80.4047230036142,79.5066064680625,649
-7.6926,53.28823,2022/08/13 23:00:00+00,Sun 14 Aug 2022,17,26,0,3859630,3813833,241212,4100842,4055045,80.4050563219808,79.5071162490939,650
-7.6926,53.28823,2022/08/14 23:00:00+00,Mon 15 Aug 2022,7,11,0,3859637,3813844,241212,4100849,4055056,80.4051935707201,79.5073319256841,651
-7.6926,53.28823,2022/08/15 23:00:00+00,Tue 16 Aug 2022,41,28,0,3859678,3813872,241212,4100890,4055084,80.4059974561927,79.507880920641,652
-7.6926,53.28823,2022/08/16 23:00:00+00,Wed 17 Aug 2022,51,58,0,3859729,3813930,241212,4100941,4055142,80.4069974112927,79.5090181244803,653
-7.6926,53.28823,2022/08/17 23:00:00+00,Thu 18 Aug 2022,55,40,0,3859784,3813970,241212,4100996,4055182,80.4080757942437,79.5098024029901,654
-7.6926,53.28823,2022/08/18 23:00:00+00,Fri 19 Aug 2022,74,56,0,3859858,3814026,241212,4101070,4055238,80.409526709487,79.5109003929039,655
-7.6926,53.28823,2022/08/19 23:00:00+00,Sat 20 Aug 2022,109,127,0,3859967,3814153,241212,4101179,4055365,80.4116638684263,79.5133904771727,656
-7.6926,53.28823,2022/08/20 23:00:00+00,Sun 21 Aug 2022,39,36,0,3860006,3814189,241212,4101218,4055401,80.4124285399734,79.5140963278316,657
-7.6926,53.28823,2022/08/21 23:00:00+00,Mon 22 Aug 2022,12,13,0,3860018,3814202,241212,4101230,4055414,80.4126638235264,79.5143512183473,658
-7.6926,53.28823,2022/08/22 23:00:00+00,Tue 23 Aug 2022,78,72,0,3860096,3814274,241212,4101308,4055486,80.4141931666206,79.515762919665,659
-7.6926,53.28823,2022/08/23 23:00:00+00,Wed 24 Aug 2022,53,56,0,3860149,3814330,241212,4101361,4055542,80.4152323356461,79.5168609095788,660
-7.6926,53.28823,2022/08/24 23:00:00+00,Thu 25 Aug 2022,40,49,0,3860189,3814379,241212,4101401,4055591,80.416016614156,79.5178216507533,661
-7.6926,53.28823,2023/01/06 00:00:00+00,Fri 06 Jan 2023,34,21,0,3864746,3818762,241221,4105967,4059983,80.505542006055,79.6039354311346,662
-7.6926,53.28823,2022/09/22 23:00:00+00,Fri 23 Sep 2022,38,39,0,3861523,3815852,241215,4102738,4057067,80.4422311233476,79.5467615277667,663
-7.6926,53.28823,2023/01/07 00:00:00+00,Sat 07 Jan 2023,136,74,0,3864882,3818836,241221,4106103,4060057,80.5082085529885,79.6053863463778,664
-7.6926,53.28823,2022/09/23 23:00:00+00,Sat 24 Sep 2022,56,104,0,3861579,3815956,241215,4102794,4057171,80.4433291132614,79.5488006518923,665
-7.6926,53.28823,2023/01/08 00:00:00+00,Sun 08 Jan 2023,51,45,0,3864933,3818881,241221,4106154,4060102,80.5092085080886,79.6062686597014,666
-7.6926,53.28823,2022/09/24 23:00:00+00,Sun 25 Sep 2022,42,75,0,3861621,3816031,241215,4102836,4057246,80.4441526056967,79.5502711740983,667
-7.6926,53.28823,2023/01/09 00:00:00+00,Mon 09 Jan 2023,1,1,0,3864934,3818882,241221,4106155,4060103,80.5092281150513,79.6062882666641,668
-7.6926,53.28823,2022/09/25 23:00:00+00,Mon 26 Sep 2022,23,10,0,3861644,3816041,241215,4102859,4057256,80.4446035658399,79.5504672437257,669
-7.6926,53.28823,2023/01/10 00:00:00+00,Tue 10 Jan 2023,42,14,0,3864976,3818896,241221,4106197,4060117,80.5100516074866,79.6065627641426,670
-7.6926,53.28823,2022/09/26 23:00:00+00,Tue 27 Sep 2022,28,34,2,3861672,3816075,241217,4102889,4057292,80.4451917747223,79.5511730943846,671
-7.6926,53.28823,2023/01/11 00:00:00+00,Wed 11 Jan 2023,59,31,0,3865035,3818927,241221,4106256,4060148,80.5112084182887,79.6071705799877,672
-7.6926,53.28823,2022/09/27 23:00:00+00,Wed 28 Sep 2022,28,28,0,3861700,3816103,241217,4102917,4057320,80.4457407696792,79.5517220893415,673
-7.6926,53.28823,2023/01/12 00:00:00+00,Thu 12 Jan 2023,14,12,0,3865049,3818939,241221,4106270,4060160,80.5114829157671,79.6074058635406,674
-7.6926,53.28823,2022/09/28 23:00:00+00,Thu 29 Sep 2022,30,23,0,3861730,3816126,241217,4102947,4057343,80.4463289785616,79.5521730494846,675
-7.6926,53.28823,2022/09/29 23:00:00+00,Fri 30 Sep 2022,37,58,0,3861767,3816184,241217,4102984,4057401,80.4470544361832,79.5533102533239,676
-7.6926,53.28823,2022/09/30 23:00:00+00,Sat 01 Oct 2022,51,108,0,3861818,3816292,241217,4103035,4057509,80.4480543912832,79.5554278053005,677
-7.6926,53.28823,2022/10/01 23:00:00+00,Sun 02 Oct 2022,26,47,0,3861844,3816339,241217,4103061,4057556,80.4485641723146,79.5563493325496,678
-7.6926,53.28823,2022/10/02 23:00:00+00,Mon 03 Oct 2022,10,1,0,3861854,3816340,241217,4103071,4057557,80.4487602419421,79.5563689395123,679
-7.6926,53.28823,2022/10/03 23:00:00+00,Tue 04 Oct 2022,17,17,0,3861871,3816357,241217,4103088,4057574,80.4490935603088,79.556702257879,680
-7.6926,53.28823,2022/10/04 23:00:00+00,Wed 05 Oct 2022,36,37,0,3861907,3816394,241217,4103124,4057611,80.4497994109676,79.5574277155006,681
-7.6926,53.28823,2022/10/05 23:00:00+00,Thu 06 Oct 2022,46,27,0,3861953,3816421,241217,4103170,4057638,80.450701331254,79.5579571034948,682
-7.6926,53.28823,2022/10/06 23:00:00+00,Fri 07 Oct 2022,63,40,0,3862016,3816461,241217,4103233,4057678,80.451936569907,79.5587413820046,683
-7.6926,53.28823,2022/10/07 23:00:00+00,Sat 08 Oct 2022,97,102,0,3862113,3816563,241217,4103330,4057780,80.4538384452933,79.5607412922047,684
-7.6926,53.28823,2022/10/08 23:00:00+00,Sun 09 Oct 2022,37,29,0,3862150,3816592,241217,4103367,4057809,80.4545639029149,79.5613098941244,685
-7.6926,53.28823,2022/10/09 23:00:00+00,Mon 10 Oct 2022,5,3,0,3862155,3816595,241217,4103372,4057812,80.4546619377287,79.5613687150126,686
-7.6926,53.28823,2022/10/10 23:00:00+00,Tue 11 Oct 2022,41,16,0,3862196,3816611,241217,4103413,4057828,80.4554658232013,79.5616824264165,687
-7.6926,53.28823,2022/10/11 23:00:00+00,Wed 12 Oct 2022,38,36,0,3862234,3816647,241217,4103451,4057864,80.4562108877856,79.5623882770754,688
-7.6926,53.28823,2022/10/12 23:00:00+00,Thu 13 Oct 2022,54,29,0,3862288,3816676,241217,4103505,4057893,80.4572696637739,79.562956878995,689
-7.6926,53.28823,2022/10/13 23:00:00+00,Fri 14 Oct 2022,76,21,0,3862364,3816697,241217,4103581,4057914,80.4587597929426,79.5633686252127,690
-7.6926,53.28823,2022/10/14 23:00:00+00,Sat 15 Oct 2022,92,120,0,3862456,3816817,241217,4103673,4058034,80.4605636335153,79.5657214607423,691
-7.6926,53.28823,2022/10/15 23:00:00+00,Sun 16 Oct 2022,26,37,1,3862482,3816854,241218,4103700,4058072,80.4610930215094,79.5664665253266,692
-7.6926,53.28823,2022/10/16 23:00:00+00,Mon 17 Oct 2022,26,3,0,3862508,3816857,241218,4103726,4058075,80.4616028025408,79.5665253462148,693
-7.6926,53.28823,2022/10/17 23:00:00+00,Tue 18 Oct 2022,56,17,0,3862564,3816874,241218,4103782,4058092,80.4627007924546,79.5668586645815,694
-7.6926,53.28823,2022/10/18 23:00:00+00,Wed 19 Oct 2022,51,40,0,3862615,3816914,241218,4103833,4058132,80.4637007475547,79.5676429430914,695
-7.6926,53.28823,2022/10/19 23:00:00+00,Thu 20 Oct 2022,56,10,0,3862671,3816924,241218,4103889,4058142,80.4647987374685,79.5678390127188,696
-7.6926,53.28823,2022/10/20 23:00:00+00,Fri 21 Oct 2022,41,21,0,3862712,3816945,241218,4103930,4058163,80.465602622941,79.5682507589365,697
-7.6926,53.28823,2022/10/21 23:00:00+00,Sat 22 Oct 2022,88,58,0,3862800,3817003,241218,4104018,4058221,80.4673280356627,79.5693879627758,698
-7.6926,53.28823,2022/10/22 23:00:00+00,Sun 23 Oct 2022,79,48,0,3862879,3817051,241218,4104097,4058269,80.4688769857197,79.5703290969876,699
-7.6926,53.28823,2022/10/23 23:00:00+00,Mon 24 Oct 2022,27,4,0,3862906,3817055,241218,4104124,4058273,80.4694063737138,79.5704075248386,700
-7.6926,53.28823,2022/10/24 23:00:00+00,Tue 25 Oct 2022,36,22,0,3862942,3817077,241218,4104160,4058295,80.4701122243727,79.570838878019,701
-7.6926,53.28823,2022/10/25 23:00:00+00,Wed 26 Oct 2022,24,23,0,3862966,3817100,241218,4104184,4058318,80.4705827914786,79.5712898381622,702
-7.6926,53.28823,2022/10/26 23:00:00+00,Thu 27 Oct 2022,50,35,0,3863016,3817135,241218,4104234,4058353,80.4715631396159,79.5719760818583,703
-7.6926,53.28823,2022/10/27 23:00:00+00,Fri 28 Oct 2022,22,19,0,3863038,3817154,241218,4104256,4058372,80.4719944927963,79.5723486141505,704
-7.6926,53.28823,2022/10/28 23:00:00+00,Sat 29 Oct 2022,87,64,0,3863125,3817218,241218,4104343,4058436,80.4737002985552,79.5736034597662,705
-7.6926,53.28823,2022/10/29 23:00:00+00,Sun 30 Oct 2022,11,6,0,3863136,3817224,241218,4104354,4058442,80.4739159751454,79.5737211015427,706
-7.6926,53.28823,2022/10/31 00:00:00+00,Mon 31 Oct 2022,1,1,0,3863137,3817225,241218,4104355,4058443,80.4739355821082,79.5737407085055,707
-7.6926,53.28823,2022/11/01 00:00:00+00,Tue 01 Nov 2022,44,25,0,3863181,3817250,241218,4104399,4058468,80.474798288469,79.5742308825741,708
-7.6926,53.28823,2022/11/02 00:00:00+00,Wed 02 Nov 2022,62,13,0,3863243,3817263,241218,4104461,4058481,80.4760139201593,79.5744857730898,709
-7.6926,53.28823,2022/11/03 00:00:00+00,Thu 03 Nov 2022,45,28,0,3863288,3817291,241218,4104506,4058509,80.4768962334828,79.5750347680467,710
-7.6926,53.28823,2022/11/04 00:00:00+00,Fri 04 Nov 2022,33,22,0,3863321,3817313,241218,4104539,4058531,80.4775432632535,79.5754661212271,711
-7.6926,53.28823,2022/11/05 00:00:00+00,Sat 05 Nov 2022,35,54,0,3863356,3817367,241218,4104574,4058585,80.4782295069496,79.5765248972154,712
-7.6926,53.28823,2022/11/06 00:00:00+00,Sun 06 Nov 2022,56,78,0,3863412,3817445,241218,4104630,4058663,80.4793274968634,79.5780542403096,713
-7.6926,53.28823,2022/11/07 00:00:00+00,Mon 07 Nov 2022,17,3,0,3863429,3817448,241218,4104647,4058666,80.4796608152301,79.5781130611978,714
-7.6926,53.28823,2022/11/08 00:00:00+00,Tue 08 Nov 2022,17,32,0,3863446,3817480,241218,4104664,4058698,80.4799941335967,79.5787404840057,715
-7.6926,53.28823,2022/11/09 00:00:00+00,Wed 09 Nov 2022,36,32,0,3863482,3817512,241218,4104700,4058730,80.4806999842556,79.5793679068136,716
-7.6926,53.28823,2022/11/10 00:00:00+00,Thu 10 Nov 2022,25,15,0,3863507,3817527,241218,4104725,4058745,80.4811901583243,79.5796620112548,717
-7.6926,53.28823,2022/11/11 00:00:00+00,Fri 11 Nov 2022,25,15,0,3863532,3817542,241218,4104750,4058760,80.4816803323929,79.579956115696,718
-7.6926,53.28823,2022/11/12 00:00:00+00,Sat 12 Nov 2022,70,87,0,3863602,3817629,241218,4104820,4058847,80.4830528197851,79.5816619214549,719
-7.6926,53.28823,2022/11/13 00:00:00+00,Sun 13 Nov 2022,40,62,1,3863642,3817691,241219,4104861,4058910,80.4838567052577,79.5828971601079,720
-7.6926,53.28823,2022/11/14 00:00:00+00,Mon 14 Nov 2022,4,2,0,3863646,3817693,241219,4104865,4058912,80.4839351331087,79.5829363740334,721
-7.6926,53.28823,2022/11/15 00:00:00+00,Tue 15 Nov 2022,18,8,0,3863664,3817701,241219,4104883,4058920,80.4842880584382,79.5830932297354,722
-7.6926,53.28823,2022/11/16 00:00:00+00,Wed 16 Nov 2022,28,20,0,3863692,3817721,241219,4104911,4058940,80.4848370533951,79.5834853689903,723
-7.6926,53.28823,2022/11/17 00:00:00+00,Thu 17 Nov 2022,29,9,1,3863721,3817730,241220,4104941,4058950,80.4854252622774,79.5836814386178,724
-7.6926,53.28823,2022/11/18 00:00:00+00,Fri 18 Nov 2022,16,22,0,3863737,3817752,241220,4104957,4058972,80.4857389736814,79.5841127917982,725
-7.6926,53.28823,2022/11/19 00:00:00+00,Sat 19 Nov 2022,52,57,0,3863789,3817809,241220,4105009,4059029,80.4867585357442,79.5852303886747,726
-7.6926,53.28823,2022/11/20 00:00:00+00,Sun 20 Nov 2022,39,56,0,3863828,3817865,241220,4105048,4059085,80.4875232072913,79.5863283785885,727
-7.6926,53.28823,2022/11/21 00:00:00+00,Mon 21 Nov 2022,6,3,0,3863834,3817868,241220,4105054,4059088,80.4876408490678,79.5863871994767,728
-7.6926,53.28823,2022/11/22 00:00:00+00,Tue 22 Nov 2022,34,22,0,3863868,3817890,241220,4105088,4059110,80.4883074858011,79.5868185526571,729
-7.6926,53.28823,2022/11/23 00:00:00+00,Wed 23 Nov 2022,13,16,0,3863881,3817906,241220,4105101,4059126,80.4885623763168,79.5871322640611,730
-7.6926,53.28823,2022/11/24 00:00:00+00,Thu 24 Nov 2022,16,18,0,3863897,3817924,241220,4105117,4059144,80.4888760877208,79.5874851893905,731
-7.6926,53.28823,2022/11/25 00:00:00+00,Fri 25 Nov 2022,6,11,0,3863903,3817935,241220,4105123,4059155,80.4889937294973,79.5877008659807,732
-7.6926,53.28823,2022/11/26 00:00:00+00,Sat 26 Nov 2022,64,63,0,3863967,3817998,241220,4105187,4059218,80.490248575113,79.5889361046337,733
-7.6926,53.28823,2022/11/27 00:00:00+00,Sun 27 Nov 2022,36,42,0,3864003,3818040,241220,4105223,4059260,80.4909544257719,79.5897595970691,734
-7.6926,53.28823,2022/11/28 00:00:00+00,Mon 28 Nov 2022,5,1,0,3864008,3818041,241220,4105228,4059261,80.4910524605856,79.5897792040318,735
-7.6926,53.28823,2022/11/29 00:00:00+00,Tue 29 Nov 2022,26,18,0,3864034,3818059,241220,4105254,4059279,80.491562241617,79.5901321293613,736
-7.6926,53.28823,2022/11/30 00:00:00+00,Wed 30 Nov 2022,29,14,0,3864063,3818073,241220,4105283,4059293,80.4921308435366,79.5904066268397,737
-7.6926,53.28823,2022/12/01 00:00:00+00,Thu 01 Dec 2022,16,11,0,3864079,3818084,241220,4105299,4059304,80.4924445549406,79.5906223034299,738
-7.6926,53.28823,2022/12/02 00:00:00+00,Fri 02 Dec 2022,8,18,0,3864087,3818102,241220,4105307,4059322,80.4926014106425,79.5909752287593,739
-7.6926,53.28823,2022/12/03 00:00:00+00,Sat 03 Dec 2022,40,71,0,3864127,3818173,241220,4105347,4059393,80.4933856891524,79.5923673231143,740
-7.6926,53.28823,2022/12/04 00:00:00+00,Sun 04 Dec 2022,41,47,0,3864168,3818220,241220,4105388,4059440,80.494189574625,79.5932888503634,741
-7.6926,53.28823,2023/01/13 00:00:00+00,Fri 13 Jan 2023,27,12,0,3865076,3818951,241221,4106297,4060172,80.5120123037613,79.6076411470936,742
-7.6926,53.28823,2023/01/14 00:00:00+00,Sat 14 Jan 2023,72,40,0,3865148,3818991,241221,4106369,4060212,80.513424005079,79.6084254256034,743
-7.6926,53.28823,2023/01/15 00:00:00+00,Sun 15 Jan 2023,60,30,0,3865208,3819021,241221,4106429,4060242,80.5146004228438,79.6090136344858,744
-7.6926,53.28823,2023/01/16 00:00:00+00,Mon 16 Jan 2023,6,2,0,3865214,3819023,241221,4106435,4060244,80.5147180646202,79.6090528484113,745
-7.6926,53.28823,2023/01/17 00:00:00+00,Tue 17 Jan 2023,14,19,0,3865228,3819042,241221,4106449,4060263,80.5149925620987,79.6094253807035,746
-7.6926,53.28823,2023/01/18 00:00:00+00,Wed 18 Jan 2023,34,14,0,3865262,3819056,241221,4106483,4060277,80.5156591988321,79.6096998781819,747
-7.6926,53.28823,2023/01/19 00:00:00+00,Thu 19 Jan 2023,15,7,0,3865277,3819063,241221,4106498,4060284,80.5159533032732,79.6098371269212,748
-7.6926,53.28823,2023/01/20 00:00:00+00,Fri 20 Jan 2023,16,8,0,3865293,3819071,241221,4106514,4060292,80.5162670146772,79.6099939826231,749
-7.6926,53.28823,2023/01/21 00:00:00+00,Sat 21 Jan 2023,74,26,0,3865367,3819097,241221,4106588,4060318,80.5177179299204,79.6105037636545,750
-7.6926,53.28823,2023/01/22 00:00:00+00,Sun 22 Jan 2023,21,13,0,3865388,3819110,241221,4106609,4060331,80.5181296761381,79.6107586541702,751
-7.6926,53.28823,2023/01/23 00:00:00+00,Mon 23 Jan 2023,4,1,0,3865392,3819111,241221,4106613,4060332,80.5182081039891,79.610778261133,752
-7.6926,53.28823,2023/01/24 00:00:00+00,Tue 24 Jan 2023,16,13,0,3865408,3819124,241221,4106629,4060345,80.518521815393,79.6110331516487,753
-7.6926,53.28823,2023/01/25 00:00:00+00,Wed 25 Jan 2023,24,17,0,3865432,3819141,241221,4106653,4060362,80.5189923824989,79.6113664700154,754
-7.6926,53.28823,2023/01/26 00:00:00+00,Thu 26 Jan 2023,12,12,0,3865444,3819153,241221,4106665,4060374,80.5192276660519,79.6116017535683,755
-7.6926,53.28823,2023/01/27 00:00:00+00,Fri 27 Jan 2023,12,8,0,3865456,3819161,241221,4106677,4060382,80.5194629496048,79.6117586092703,756
-7.6926,53.28823,2023/01/28 00:00:00+00,Sat 28 Jan 2023,25,57,0,3865481,3819218,241221,4106702,4060439,80.5199531236735,79.6128762061468,757
-7.6926,53.28823,2023/01/29 00:00:00+00,Sun 29 Jan 2023,29,28,0,3865510,3819246,241221,4106731,4060467,80.5205217255931,79.6134252011037,758
-7.6926,53.28823,2023/01/30 00:00:00+00,Mon 30 Jan 2023,4,2,0,3865514,3819248,241221,4106735,4060469,80.5206001534441,79.6134644150292,759
-7.6926,53.28823,2023/01/31 00:00:00+00,Tue 31 Jan 2023,23,15,0,3865537,3819263,241221,4106758,4060484,80.5210511135872,79.6137585194704,760
-7.6926,53.28823,2023/02/01 00:00:00+00,Wed 01 Feb 2023,14,37,0,3865551,3819300,241221,4106772,4060521,80.5213256110657,79.614483977092,761
-7.6926,53.28823,2023/02/02 00:00:00+00,Thu 02 Feb 2023,13,12,0,3865564,3819312,241221,4106785,4060533,80.5215805015814,79.614719260645,762
-7.6926,53.28823,2023/02/03 00:00:00+00,Fri 03 Feb 2023,14,10,0,3865578,3819322,241221,4106799,4060543,80.5218549990599,79.6149153302724,763
-7.6926,53.28823,2023/02/04 00:00:00+00,Sat 04 Feb 2023,38,44,0,3865616,3819366,241221,4106837,4060587,80.5226000636442,79.6157780366333,764
-7.6926,53.28823,2023/02/05 00:00:00+00,Sun 05 Feb 2023,29,22,0,3865645,3819388,241221,4106866,4060609,80.5231686655638,79.6162093898137,765
-7.6926,53.28823,2023/02/06 00:00:00+00,Mon 06 Feb 2023,12,7,0,3865657,3819395,241221,4106878,4060616,80.5234039491168,79.6163466385529,766
-7.6926,53.28823,2023/02/07 00:00:00+00,Tue 07 Feb 2023,20,13,0,3865677,3819408,241221,4106898,4060629,80.5237960883717,79.6166015290686,767
-7.6926,53.28823,2023/02/08 00:00:00+00,Wed 08 Feb 2023,23,30,0,3865700,3819438,241221,4106921,4060659,80.5242470485149,79.617189737951,768
-7.6926,53.28823,2023/02/09 00:00:00+00,Thu 09 Feb 2023,6,15,0,3865706,3819453,241221,4106927,4060674,80.5243646902914,79.6174838423922,769
-7.6926,53.28823,2023/02/10 00:00:00+00,Fri 10 Feb 2023,5,14,0,3865711,3819467,241221,4106932,4060688,80.5244627251051,79.6177583398706,770
-7.6926,53.28823,2023/02/11 00:00:00+00,Sat 11 Feb 2023,34,47,0,3865745,3819514,241221,4106966,4060735,80.5251293618385,79.6186798671197,771
-7.6926,53.28823,2023/02/12 00:00:00+00,Sun 12 Feb 2023,17,36,0,3865762,3819550,241221,4106983,4060771,80.5254626802051,79.6193857177786,772
-7.6926,53.28823,2023/02/13 00:00:00+00,Mon 13 Feb 2023,1,1,0,3865763,3819551,241221,4106984,4060772,80.5254822871679,79.6194053247413,773
-7.6926,53.28823,2023/02/14 00:00:00+00,Tue 14 Feb 2023,12,22,0,3865775,3819573,241221,4106996,4060794,80.5257175707208,79.6198366779217,774
-7.6926,53.28823,2023/02/15 00:00:00+00,Wed 15 Feb 2023,15,13,0,3865790,3819586,241221,4107011,4060807,80.526011675162,79.6200915684374,775
-7.6926,53.28823,2023/02/16 00:00:00+00,Thu 16 Feb 2023,13,11,0,3865803,3819597,241221,4107024,4060818,80.5262665656777,79.6203072450276,776
-7.6926,53.28823,2023/02/17 00:00:00+00,Fri 17 Feb 2023,5,12,0,3865808,3819609,241221,4107029,4060830,80.5263646004915,79.6205425285806,777
-7.6926,53.28823,2023/02/18 00:00:00+00,Sat 18 Feb 2023,21,43,0,3865829,3819652,241221,4107050,4060873,80.5267763467091,79.6213856279787,778
-7.6926,53.28823,2023/02/19 00:00:00+00,Sun 19 Feb 2023,22,31,0,3865851,3819683,241221,4107072,4060904,80.5272076998896,79.6219934438238,779
-7.6926,53.28823,2023/02/20 00:00:00+00,Mon 20 Feb 2023,3,0,0,3865854,3819683,241221,4107075,4060904,80.5272665207778,79.6219934438238,780
-7.6926,53.28823,2023/02/21 00:00:00+00,Tue 21 Feb 2023,52,16,0,3865906,3819699,241221,4107127,4060920,80.5282860828406,79.6223071552277,781
-7.6926,53.28823,2023/02/22 00:00:00+00,Wed 22 Feb 2023,21,16,0,3865927,3819715,241221,4107148,4060936,80.5286978290583,79.6226208666317,782
-7.6926,53.28823,2023/02/23 00:00:00+00,Thu 23 Feb 2023,44,11,1,3865971,3819726,241222,4107193,4060948,80.5295801423818,79.6228561501846,783
-7.6926,53.28823,2023/02/24 00:00:00+00,Fri 24 Feb 2023,13,19,0,3865984,3819745,241222,4107206,4060967,80.5298350328976,79.6232286824768,784
-7.6926,53.28823,2023/02/25 00:00:00+00,Sat 25 Feb 2023,49,19,0,3866033,3819764,241222,4107255,4060986,80.5307957740721,79.623601214769,785
-7.6926,53.28823,2023/02/26 00:00:00+00,Sun 26 Feb 2023,78,41,0,3866111,3819805,241222,4107333,4061027,80.5323251171663,79.6244051002416,786
-7.6926,53.28823,2023/02/27 00:00:00+00,Mon 27 Feb 2023,1,2,0,3866112,3819807,241222,4107334,4061029,80.5323447241291,79.6244443141671,787
-7.6926,53.28823,2023/02/28 00:00:00+00,Tue 28 Feb 2023,32,11,0,3866144,3819818,241222,4107366,4061040,80.5329721469369,79.6246599907573,788
-7.6926,53.28823,2023/03/01 00:00:00+00,Wed 01 Mar 2023,21,18,0,3866165,3819836,241222,4107387,4061058,80.5333838931546,79.6250129160867,789
-7.6926,53.28823,2023/03/02 00:00:00+00,Thu 02 Mar 2023,20,14,0,3866185,3819850,241222,4107407,4061072,80.5337760324095,79.6252874135652,790
-7.6926,53.28823,2023/03/03 00:00:00+00,Fri 03 Mar 2023,10,13,0,3866195,3819863,241222,4107417,4061085,80.533972102037,79.6255423040809,791
-7.6926,53.28823,2023/03/04 00:00:00+00,Sat 04 Mar 2023,37,24,0,3866232,3819887,241222,4107454,4061109,80.5346975596586,79.6260128711868,792
-7.6926,53.28823,2023/03/05 00:00:00+00,Sun 05 Mar 2023,27,19,0,3866259,3819906,241222,4107481,4061128,80.5352269476527,79.6263854034789,793
-7.6926,53.28823,2023/03/06 00:00:00+00,Mon 06 Mar 2023,2,1,0,3866261,3819907,241222,4107483,4061129,80.5352661615782,79.6264050104417,794
-7.6926,53.28823,2023/03/07 00:00:00+00,Tue 07 Mar 2023,13,13,0,3866274,3819920,241222,4107496,4061142,80.5355210520939,79.6266599009574,795
-7.6926,53.28823,2023/03/08 00:00:00+00,Wed 08 Mar 2023,28,27,0,3866302,3819947,241222,4107524,4061169,80.5360700470508,79.6271892889515,796
-7.6926,53.28823,2023/03/09 00:00:00+00,Thu 09 Mar 2023,19,8,0,3866321,3819955,241222,4107543,4061177,80.536442579343,79.6273461446535,797
-7.6926,53.28823,2023/03/10 00:00:00+00,Fri 10 Mar 2023,10,3,0,3866331,3819958,241222,4107553,4061180,80.5366386489705,79.6274049655417,798
-7.6926,53.28823,2023/03/11 00:00:00+00,Sat 11 Mar 2023,28,23,0,3866359,3819981,241222,4107581,4061203,80.5371876439274,79.6278559256849,799
-7.6926,53.28823,2023/03/12 00:00:00+00,Sun 12 Mar 2023,16,13,0,3866375,3819994,241222,4107597,4061216,80.5375013553313,79.6281108162006,800
-7.6926,53.28823,2023/03/13 00:00:00+00,Mon 13 Mar 2023,2,1,0,3866377,3819995,241222,4107599,4061217,80.5375405692568,79.6281304231634,801
-7.6926,53.28823,2023/03/14 00:00:00+00,Tue 14 Mar 2023,13,14,0,3866390,3820009,241222,4107612,4061231,80.5377954597725,79.6284049206418,802
